PokerStars Hand #5000000001: Tournament #1, Apr5_2017-at-16_31_33 Hold'em No Limit ($50/$100 USD) - 2017/04/05 18:31:33 ET
Table 'ACPC Match' 2-max Seat #2 is the button
Seat 1: DeepStack ($20000 in chips)
Seat 2: Adam_@PokercastAdam ($20000 in chips)
Adam_@PokercastAdam: posts small blind $50
DeepStack: posts big blind $100
*** HOLE CARDS ***
Dealt to DeepStack [9c 6c]
Dealt to Adam_@PokercastAdam [As Ts]
Adam_@PokercastAdam: raises $100 to $200
DeepStack: raises $400 to $600
Adam_@PokercastAdam: raises $1000 to $1600
DeepStack: folds
Uncalled bet ($1000) returned to Adam_@PokercastAdam
Adam_@PokercastAdam collected $1200 from the pot
*** SUMMARY ***
Total pot $1200 | Rake $0
Seat 1: DeepStack (big blind) folded before the Flop
Seat 2: Adam_@PokercastAdam (button) (small blind) collected ($1200)

PokerStars Hand #5000000002: Tournament #1, Apr5_2017-at-16_31_33 Hold'em No Limit ($50/$100 USD) - 2017/04/05 18:31:34 ET
Table 'ACPC Match' 2-max Seat #1 is the button
Seat 1: DeepStack ($19400 in chips)
Seat 2: Adam_@PokercastAdam ($20600 in chips)
DeepStack: posts small blind $50
Adam_@PokercastAdam: posts big blind $100
*** HOLE CARDS ***
Dealt to DeepStack [8d Ac]
Dealt to Adam_@PokercastAdam [6h Js]
DeepStack: calls $50
Adam_@PokercastAdam: checks
*** FLOP **** [2d 3c 3h]
Adam_@PokercastAdam: bets $100
DeepStack: calls $100
*** TURN **** [6c]
Adam_@PokercastAdam: bets $200
DeepStack: folds
Uncalled bet ($200) returned to Adam_@PokercastAdam
Adam_@PokercastAdam collected $400 from the pot
*** SUMMARY ***
Total pot $400 | Rake $0
Board [2d 3c 3h 6c]
Seat 1: DeepStack (button) (small blind) folded on the Turn
Seat 2: Adam_@PokercastAdam (big blind) collected ($400)

PokerStars Hand #5000000003: Tournament #1, Apr5_2017-at-16_31_33 Hold'em No Limit ($50/$100 USD) - 2017/04/05 18:31:35 ET
Table 'ACPC Match' 2-max Seat #2 is the button
Seat 1: DeepStack ($19200 in chips)
Seat 2: Adam_@PokercastAdam ($20800 in chips)
Adam_@PokercastAdam: posts small blind $50
DeepStack: posts big blind $100
*** HOLE CARDS ***
Dealt to DeepStack [Qd 4c]
Dealt to Adam_@PokercastAdam [Tc As]
Adam_@PokercastAdam: raises $100 to $200
DeepStack: calls $100
*** FLOP **** [4d Th 6s]
DeepStack: checks
Adam_@PokercastAdam: raises $500 to $500
DeepStack: calls $500
*** TURN **** [2s]
DeepStack: checks
Adam_@PokercastAdam: raises $1000 to $1000
DeepStack: folds
Uncalled bet ($1000) returned to Adam_@PokercastAdam
Adam_@PokercastAdam collected $1400 from the pot
*** SUMMARY ***
Total pot $1400 | Rake $0
Board [4d Th 6s 2s]
Seat 1: DeepStack (big blind) folded on the Turn
Seat 2: Adam_@PokercastAdam (button) (small blind) collected ($1400)

PokerStars Hand #5000000004: Tournament #1, Apr5_2017-at-16_31_33 Hold'em No Limit ($50/$100 USD) - 2017/04/05 18:31:36 ET
Table 'ACPC Match' 2-max Seat #1 is the button
Seat 1: DeepStack ($18500 in chips)
Seat 2: Adam_@PokercastAdam ($21500 in chips)
DeepStack: posts small blind $50
Adam_@PokercastAdam: posts big blind $100
*** HOLE CARDS ***
Dealt to DeepStack [2c 9s]
Dealt to Adam_@PokercastAdam [6s 8c]
DeepStack: folds
Uncalled bet ($50) returned to Adam_@PokercastAdam
Adam_@PokercastAdam collected $100 from the pot
*** SUMMARY ***
Total pot $100 | Rake $0
Seat 1: DeepStack (button) (small blind) folded before the Flop
Seat 2: Adam_@PokercastAdam (big blind) collected ($100)

PokerStars Hand #5000000005: Tournament #1, Apr5_2017-at-16_31_33 Hold'em No Limit ($50/$100 USD) - 2017/04/05 18:31:37 ET
Table 'ACPC Match' 2-max Seat #2 is the button
Seat 1: DeepStack ($18450 in chips)
Seat 2: Adam_@PokercastAdam ($21550 in chips)
Adam_@PokercastAdam: posts small blind $50
DeepStack: posts big blind $100
*** HOLE CARDS ***
Dealt to DeepStack [Kc 3h]
Dealt to Adam_@PokercastAdam [7d 9h]
Adam_@PokercastAdam: raises $100 to $200
DeepStack: calls $100
*** FLOP **** [3s Th 3d]
DeepStack: checks
Adam_@PokercastAdam: raises $100 to $100
DeepStack: raises $300 to $400
Adam_@PokercastAdam: folds
Uncalled bet ($300) returned to DeepStack
DeepStack collected $600 from the pot
*** SUMMARY ***
Total pot $600 | Rake $0
Board [3s Th 3d]
Seat 1: DeepStack (big blind) collected ($600)
Seat 2: Adam_@PokercastAdam (button) (small blind) folded on the Flop

PokerStars Hand #5000000006: Tournament #1, Apr5_2017-at-16_31_33 Hold'em No Limit ($50/$100 USD) - 2017/04/05 18:31:38 ET
Table 'ACPC Match' 2-max Seat #1 is the button
Seat 1: DeepStack ($18750 in chips)
Seat 2: Adam_@PokercastAdam ($21250 in chips)
DeepStack: posts small blind $50
Adam_@PokercastAdam: posts big blind $100
*** HOLE CARDS ***
Dealt to DeepStack [Kc 6h]
Dealt to Adam_@PokercastAdam [Js 6d]
DeepStack: raises $100 to $200
Adam_@PokercastAdam: folds
Uncalled bet ($100) returned to DeepStack
DeepStack collected $200 from the pot
*** SUMMARY ***
Total pot $200 | Rake $0
Seat 1: DeepStack (button) (small blind) collected ($200)
Seat 2: Adam_@PokercastAdam (big blind) folded before the Flop

PokerStars Hand #5000000007: Tournament #1, Apr5_2017-at-16_31_33 Hold'em No Limit ($50/$100 USD) - 2017/04/05 18:31:39 ET
Table 'ACPC Match' 2-max Seat #2 is the button
Seat 1: DeepStack ($18850 in chips)
Seat 2: Adam_@PokercastAdam ($21150 in chips)
Adam_@PokercastAdam: posts small blind $50
DeepStack: posts big blind $100
*** HOLE CARDS ***
Dealt to DeepStack [5d 9c]
Dealt to Adam_@PokercastAdam [Qc 5s]
Adam_@PokercastAdam: raises $100 to $200
DeepStack: calls $100
*** FLOP **** [6s Kh Th]
DeepStack: checks
Adam_@PokercastAdam: raises $200 to $200
DeepStack: folds
Uncalled bet ($200) returned to Adam_@PokercastAdam
Adam_@PokercastAdam collected $400 from the pot
*** SUMMARY ***
Total pot $400 | Rake $0
Board [6s Kh Th]
Seat 1: DeepStack (big blind) folded on the Flop
Seat 2: Adam_@PokercastAdam (button) (small blind) collected ($400)

PokerStars Hand #5000000008: Tournament #1, Apr5_2017-at-16_31_33 Hold'em No Limit ($50/$100 USD) - 2017/04/05 18:31:40 ET
Table 'ACPC Match' 2-max Seat #1 is the button
Seat 1: DeepStack ($18650 in chips)
Seat 2: Adam_@PokercastAdam ($21350 in chips)
DeepStack: posts small blind $50
Adam_@PokercastAdam: posts big blind $100
*** HOLE CARDS ***
Dealt to DeepStack [Ac 7s]
Dealt to Adam_@PokercastAdam [8s 6s]
DeepStack: raises $100 to $200
Adam_@PokercastAdam: calls $100
*** FLOP **** [9s Ad 2d]
Adam_@PokercastAdam: checks
DeepStack: checks
*** TURN **** [9h]
Adam_@PokercastAdam: bets $500
DeepStack: calls $500
*** RIVER **** [5d]
Adam_@PokercastAdam: checks
DeepStack: checks
*** SHOW DOWN ***
Adam_@PokercastAdam: shows [8s 6s] (a pair of Nines)
DeepStack: shows [Ac 7s] (two pair, Aces and Nines)
DeepStack collected $1400 from pot
*** SUMMARY ***
Total pot $1400 | Rake $0
Board [9s Ad 2d 9h 5d]
Seat 1: DeepStack (button) (small blind) showed [Ac 7s] and won ($1400) with two pair, Aces and Nines
Seat 2: Adam_@PokercastAdam (big blind) showed [8s 6s] and lost with a pair of Nines

PokerStars Hand #5000000009: Tournament #1, Apr5_2017-at-16_31_33 Hold'em No Limit ($50/$100 USD) - 2017/04/05 18:31:41 ET
Table 'ACPC Match' 2-max Seat #2 is the button
Seat 1: DeepStack ($19350 in chips)
Seat 2: Adam_@PokercastAdam ($20650 in chips)
Adam_@PokercastAdam: posts small blind $50
DeepStack: posts big blind $100
*** HOLE CARDS ***
Dealt to DeepStack [4c Ah]
Dealt to Adam_@PokercastAdam [5c 2d]
Adam_@PokercastAdam: folds
Uncalled bet ($50) returned to DeepStack
DeepStack collected $100 from the pot
*** SUMMARY ***
Total pot $100 | Rake $0
Seat 1: DeepStack (big blind) collected ($100)
Seat 2: Adam_@PokercastAdam (button) (small blind) folded before the Flop

PokerStars Hand #5000000010: Tournament #1, Apr5_2017-at-16_31_33 Hold'em No Limit ($50/$100 USD) - 2017/04/05 18:31:42 ET
Table 'ACPC Match' 2-max Seat #1 is the button
Seat 1: DeepStack ($19400 in chips)
Seat 2: Adam_@PokercastAdam ($20600 in chips)
DeepStack: posts small blind $50
Adam_@PokercastAdam: posts big blind $100
*** HOLE CARDS ***
Dealt to DeepStack [Kc 6d]
Dealt to Adam_@PokercastAdam [2h 9s]
DeepStack: calls $50
Adam_@PokercastAdam: checks
*** FLOP **** [2d 5d 6c]
Adam_@PokercastAdam: bets $100
DeepStack: calls $100
*** TURN **** [8d]
Adam_@PokercastAdam: checks
DeepStack: raises $200 to $200
Adam_@PokercastAdam: folds
Uncalled bet ($200) returned to DeepStack
DeepStack collected $400 from the pot
*** SUMMARY ***
Total pot $400 | Rake $0
Board [2d 5d 6c 8d]
Seat 1: DeepStack (button) (small blind) collected ($400)
Seat 2: Adam_@PokercastAdam (big blind) folded on the Turn

PokerStars Hand #5000000011: Tournament #1, Apr5_2017-at-16_31_33 Hold'em No Limit ($75/$150 USD) - 2017/04/05 18:31:43 ET
Table 'ACPC Match' 2-max Seat #2 is the button
Seat 1: DeepStack ($19600 in chips)
Seat 2: Adam_@PokercastAdam ($20400 in chips)
Adam_@PokercastAdam: posts small blind $75
DeepStack: posts big blind $150
*** HOLE CARDS ***
Dealt to DeepStack [6c 2d]
Dealt to Adam_@PokercastAdam [7d 3d]
Adam_@PokercastAdam: raises $150 to $300
DeepStack: folds
Uncalled bet ($150) returned to Adam_@PokercastAdam
Adam_@PokercastAdam collected $300 from the pot
*** SUMMARY ***
Total pot $300 | Rake $0
Seat 1: DeepStack (big blind) folded before the Flop
Seat 2: Adam_@PokercastAdam (button) (small blind) collected ($300)

PokerStars Hand #5000000012: Tournament #1, Apr5_2017-at-16_31_33 Hold'em No Limit ($75/$150 USD) - 2017/04/05 18:31:44 ET
Table 'ACPC Match' 2-max Seat #1 is the button
Seat 1: DeepStack ($19450 in chips)
Seat 2: Adam_@PokercastAdam ($20550 in chips)
DeepStack: posts small blind $75
Adam_@PokercastAdam: posts big blind $150
*** HOLE CARDS ***
Dealt to DeepStack [Jd Ah]
Dealt to Adam_@PokercastAdam [Tc 3s]
DeepStack: raises $300 to $450
Adam_@PokercastAdam: folds
Uncalled bet ($300) returned to DeepStack
DeepStack collected $300 from the pot
*** SUMMARY ***
Total pot $300 | Rake $0
Seat 1: DeepStack (button) (small blind) collected ($300)
Seat 2: Adam_@PokercastAdam (big blind) folded before the Flop

PokerStars Hand #5000000013: Tournament #1, Apr5_2017-at-16_31_33 Hold'em No Limit ($75/$150 USD) - 2017/04/05 18:31:45 ET
Table 'ACPC Match' 2-max Seat #2 is the button
Seat 1: DeepStack ($19600 in chips)
Seat 2: Adam_@PokercastAdam ($20400 in chips)
Adam_@PokercastAdam: posts small blind $75
DeepStack: posts big blind $150
*** HOLE CARDS ***
Dealt to DeepStack [9s 4d]
Dealt to Adam_@PokercastAdam [8s Kd]
Adam_@PokercastAdam: raises $150 to $300
DeepStack: folds
Uncalled bet ($150) returned to Adam_@PokercastAdam
Adam_@PokercastAdam collected $300 from the pot
*** SUMMARY ***
Total pot $300 | Rake $0
Seat 1: DeepStack (big blind) folded before the Flop
Seat 2: Adam_@PokercastAdam (button) (small blind) collected ($300)

PokerStars Hand #5000000014: Tournament #1, Apr5_2017-at-16_31_33 Hold'em No Limit ($75/$150 USD) - 2017/04/05 18:31:46 ET
Table 'ACPC Match' 2-max Seat #1 is the button
Seat 1: DeepStack ($19450 in chips)
Seat 2: Adam_@PokercastAdam ($20550 in chips)
DeepStack: posts small blind $75
Adam_@PokercastAdam: posts big blind $150
*** HOLE CARDS ***
Dealt to DeepStack [8h Js]
Dealt to Adam_@PokercastAdam [3d 4h]
DeepStack: raises $300 to $450
Adam_@PokercastAdam: folds
Uncalled bet ($300) returned to DeepStack
DeepStack collected $300 from the pot
*** SUMMARY ***
Total pot $300 | Rake $0
Seat 1: DeepStack (button) (small blind) collected ($300)
Seat 2: Adam_@PokercastAdam (big blind) folded before the Flop

PokerStars Hand #5000000015: Tournament #1, Apr5_2017-at-16_31_33 Hold'em No Limit ($75/$150 USD) - 2017/04/05 18:31:47 ET
Table 'ACPC Match' 2-max Seat #2 is the button
Seat 1: DeepStack ($19600 in chips)
Seat 2: Adam_@PokercastAdam ($20400 in chips)
Adam_@PokercastAdam: posts small blind $75
DeepStack: posts big blind $150
*** HOLE CARDS ***
Dealt to DeepStack [9c 9s]
Dealt to Adam_@PokercastAdam [3c Jc]
Adam_@PokercastAdam: raises $150 to $300
DeepStack: raises $600 to $900
Adam_@PokercastAdam: folds
Uncalled bet ($600) returned to DeepStack
DeepStack collected $600 from the pot
*** SUMMARY ***
Total pot $600 | Rake $0
Seat 1: DeepStack (big blind) collected ($600)
Seat 2: Adam_@PokercastAdam (button) (small blind) folded before the Flop

PokerStars Hand #5000000016: Tournament #1, Apr5_2017-at-16_31_33 Hold'em No Limit ($75/$150 USD) - 2017/04/05 18:31:48 ET
Table 'ACPC Match' 2-max Seat #1 is the button
Seat 1: DeepStack ($19900 in chips)
Seat 2: Adam_@PokercastAdam ($20100 in chips)
DeepStack: posts small blind $75
Adam_@PokercastAdam: posts big blind $150
*** HOLE CARDS ***
Dealt to DeepStack [Jh Js]
Dealt to Adam_@PokercastAdam [As Ks]
DeepStack: calls $75
Adam_@PokercastAdam: raises $300 to $450
DeepStack: raises $900 to $1350
Adam_@PokercastAdam: raises $3150 to $4500
DeepStack: calls $3150
*** FLOP **** [8c 9h 6h]
Adam_@PokercastAdam: bets $150
DeepStack: calls $150
*** TURN **** [8s]
Adam_@PokercastAdam: bets $150
DeepStack: calls $150
*** RIVER **** [2h]
Adam_@PokercastAdam: bets $150
DeepStack: raises $9900 to $10050
Adam_@PokercastAdam: folds
Uncalled bet ($9900) returned to DeepStack
DeepStack collected $9900 from the pot
*** SUMMARY ***
Total pot $9900 | Rake $0
Board [8c 9h 6h 8s 2h]
Seat 1: DeepStack (button) (small blind) collected ($9900)
Seat 2: Adam_@PokercastAdam (big blind) folded on the River

PokerStars Hand #5000000017: Tournament #1, Apr5_2017-at-16_31_33 Hold'em No Limit ($75/$150 USD) - 2017/04/05 18:31:49 ET
Table 'ACPC Match' 2-max Seat #2 is the button
Seat 1: DeepStack ($24850 in chips)
Seat 2: Adam_@PokercastAdam ($15150 in chips)
Adam_@PokercastAdam: posts small blind $75
DeepStack: posts big blind $150
*** HOLE CARDS ***
Dealt to DeepStack [Ah Ac]
Dealt to Adam_@PokercastAdam [9c 2d]
Adam_@PokercastAdam: folds
Uncalled bet ($75) returned to DeepStack
DeepStack collected $150 from the pot
*** SUMMARY ***
Total pot $150 | Rake $0
Seat 1: DeepStack (big blind) collected ($150)
Seat 2: Adam_@PokercastAdam (button) (small blind) folded before the Flop

PokerStars Hand #5000000018: Tournament #1, Apr5_2017-at-16_31_33 Hold'em No Limit ($75/$150 USD) - 2017/04/05 18:31:50 ET
Table 'ACPC Match' 2-max Seat #1 is the button
Seat 1: DeepStack ($24925 in chips)
Seat 2: Adam_@PokercastAdam ($15075 in chips)
DeepStack: posts small blind $75
Adam_@PokercastAdam: posts big blind $150
*** HOLE CARDS ***
Dealt to DeepStack [6s 9s]
Dealt to Adam_@PokercastAdam [2s 5d]
DeepStack: raises $150 to $300
Adam_@PokercastAdam: folds
Uncalled bet ($150) returned to DeepStack
DeepStack collected $300 from the pot
*** SUMMARY ***
Total pot $300 | Rake $0
Seat 1: DeepStack (button) (small blind) collected ($300)
Seat 2: Adam_@PokercastAdam (big blind) folded before the Flop

PokerStars Hand #5000000019: Tournament #1, Apr5_2017-at-16_31_33 Hold'em No Limit ($75/$150 USD) - 2017/04/05 18:31:51 ET
Table 'ACPC Match' 2-max Seat #2 is the button
Seat 1: DeepStack ($25075 in chips)
Seat 2: Adam_@PokercastAdam ($14925 in chips)
Adam_@PokercastAdam: posts small blind $75
DeepStack: posts big blind $150
*** HOLE CARDS ***
Dealt to DeepStack [5c Kc]
Dealt to Adam_@PokercastAdam [Tc Th]
Adam_@PokercastAdam: raises $150 to $300
DeepStack: calls $150
*** FLOP **** [4d 3d 7s]
DeepStack: checks
Adam_@PokercastAdam: raises $750 to $750
DeepStack: folds
Uncalled bet ($750) returned to Adam_@PokercastAdam
Adam_@PokercastAdam collected $600 from the pot
*** SUMMARY ***
Total pot $600 | Rake $0
Board [4d 3d 7s]
Seat 1: DeepStack (big blind) folded on the Flop
Seat 2: Adam_@PokercastAdam (button) (small blind) collected ($600)

PokerStars Hand #5000000020: Tournament #1, Apr5_2017-at-16_31_33 Hold'em No Limit ($75/$150 USD) - 2017/04/05 18:31:52 ET
Table 'ACPC Match' 2-max Seat #1 is the button
Seat 1: DeepStack ($24775 in chips)
Seat 2: Adam_@PokercastAdam ($15225 in chips)
DeepStack: posts small blind $75
Adam_@PokercastAdam: posts big blind $150
*** HOLE CARDS ***
Dealt to DeepStack [8d 9h]
Dealt to Adam_@PokercastAdam [Kc 2c]
DeepStack: raises $150 to $300
Adam_@PokercastAdam: calls $150
*** FLOP **** [7d Jc Th]
Adam_@PokercastAdam: checks
DeepStack: raises $300 to $300
Adam_@PokercastAdam: folds
Uncalled bet ($300) returned to DeepStack
DeepStack collected $600 from the pot
*** SUMMARY ***
Total pot $600 | Rake $0
Board [7d Jc Th]
Seat 1: DeepStack (button) (small blind) collected ($600)
Seat 2: Adam_@PokercastAdam (big blind) folded on the Flop

PokerStars Hand #5000000021: Tournament #1, Apr5_2017-at-16_31_33 Hold'em No Limit ($100/$200 USD) - 2017/04/05 18:31:53 ET
Table 'ACPC Match' 2-max Seat #2 is the button
Seat 1: DeepStack ($25075 in chips)
Seat 2: Adam_@PokercastAdam ($14925 in chips)
Adam_@PokercastAdam: posts small blind $100
DeepStack: posts big blind $200
*** HOLE CARDS ***
Dealt to DeepStack [Ad 3s]
Dealt to Adam_@PokercastAdam [2d Th]
Adam_@PokercastAdam: folds
Uncalled bet ($100) returned to DeepStack
DeepStack collected $200 from the pot
*** SUMMARY ***
Total pot $200 | Rake $0
Seat 1: DeepStack (big blind) collected ($200)
Seat 2: Adam_@PokercastAdam (button) (small blind) folded before the Flop

PokerStars Hand #5000000022: Tournament #1, Apr5_2017-at-16_31_33 Hold'em No Limit ($100/$200 USD) - 2017/04/05 18:31:54 ET
Table 'ACPC Match' 2-max Seat #1 is the button
Seat 1: DeepStack ($25175 in chips)
Seat 2: Adam_@PokercastAdam ($14825 in chips)
DeepStack: posts small blind $100
Adam_@PokercastAdam: posts big blind $200
*** HOLE CARDS ***
Dealt to DeepStack [Tc 3c]
Dealt to Adam_@PokercastAdam [Td Jc]
DeepStack: raises $200 to $400
Adam_@PokercastAdam: calls $200
*** FLOP **** [5d Ad 8d]
Adam_@PokercastAdam: checks
DeepStack: checks
*** TURN **** [As]
Adam_@PokercastAdam: bets $800
DeepStack: folds
Uncalled bet ($800) returned to Adam_@PokercastAdam
Adam_@PokercastAdam collected $800 from the pot
*** SUMMARY ***
Total pot $800 | Rake $0
Board [5d Ad 8d As]
Seat 1: DeepStack (button) (small blind) folded on the Turn
Seat 2: Adam_@PokercastAdam (big blind) collected ($800)

PokerStars Hand #5000000023: Tournament #1, Apr5_2017-at-16_31_33 Hold'em No Limit ($100/$200 USD) - 2017/04/05 18:31:55 ET
Table 'ACPC Match' 2-max Seat #2 is the button
Seat 1: DeepStack ($24775 in chips)
Seat 2: Adam_@PokercastAdam ($15225 in chips)
Adam_@PokercastAdam: posts small blind $100
DeepStack: posts big blind $200
*** HOLE CARDS ***
Dealt to DeepStack [2d Th]
Dealt to Adam_@PokercastAdam [Qh Ks]
Adam_@PokercastAdam: raises $200 to $400
DeepStack: folds
Uncalled bet ($200) returned to Adam_@PokercastAdam
Adam_@PokercastAdam collected $400 from the pot
*** SUMMARY ***
Total pot $400 | Rake $0
Seat 1: DeepStack (big blind) folded before the Flop
Seat 2: Adam_@PokercastAdam (button) (small blind) collected ($400)

PokerStars Hand #5000000024: Tournament #1, Apr5_2017-at-16_31_33 Hold'em No Limit ($100/$200 USD) - 2017/04/05 18:31:56 ET
Table 'ACPC Match' 2-max Seat #1 is the button
Seat 1: DeepStack ($24575 in chips)
Seat 2: Adam_@PokercastAdam ($15425 in chips)
DeepStack: posts small blind $100
Adam_@PokercastAdam: posts big blind $200
*** HOLE CARDS ***
Dealt to DeepStack [9s 7c]
Dealt to Adam_@PokercastAdam [9d 4d]
DeepStack: raises $200 to $400
Adam_@PokercastAdam: calls $200
*** FLOP **** [Qc As 7h]
Adam_@PokercastAdam: checks
DeepStack: raises $400 to $400
Adam_@PokercastAdam: folds
Uncalled bet ($400) returned to DeepStack
DeepStack collected $800 from the pot
*** SUMMARY ***
Total pot $800 | Rake $0
Board [Qc As 7h]
Seat 1: DeepStack (button) (small blind) collected ($800)
Seat 2: Adam_@PokercastAdam (big blind) folded on the Flop

PokerStars Hand #5000000025: Tournament #1, Apr5_2017-at-16_31_33 Hold'em No Limit ($100/$200 USD) - 2017/04/05 18:31:57 ET
Table 'ACPC Match' 2-max Seat #2 is the button
Seat 1: DeepStack ($24975 in chips)
Seat 2: Adam_@PokercastAdam ($15025 in chips)
Adam_@PokercastAdam: posts small blind $100
DeepStack: posts big blind $200
*** HOLE CARDS ***
Dealt to DeepStack [Qs As]
Dealt to Adam_@PokercastAdam [2h 2d]
Adam_@PokercastAdam: raises $200 to $400
DeepStack: raises $800 to $1200
Adam_@PokercastAdam: calls $800
*** FLOP **** [3h Jd 4c]
DeepStack: checks
Adam_@PokercastAdam: raises $200 to $200
DeepStack: calls $200
*** TURN **** [Ah]
DeepStack: checks
Adam_@PokercastAdam: checks
*** RIVER **** [5h]
DeepStack: checks
Adam_@PokercastAdam: raises $2200 to $2200
DeepStack: calls $2200
*** SHOW DOWN ***
Adam_@PokercastAdam: shows [2h 2d] (straight, Five high)
DeepStack: shows [Qs As] (a pair of Aces)
Adam_@PokercastAdam collected $7200 from pot
*** SUMMARY ***
Total pot $7200 | Rake $0
Board [3h Jd 4c Ah 5h]
Seat 1: DeepStack (big blind) showed [Qs As] and lost with a pair of Aces
Seat 2: Adam_@PokercastAdam (button) (small blind) showed [2h 2d] and won ($7200) with straight, Five high

PokerStars Hand #5000000026: Tournament #1, Apr5_2017-at-16_31_33 Hold'em No Limit ($100/$200 USD) - 2017/04/05 18:31:58 ET
Table 'ACPC Match' 2-max Seat #1 is the button
Seat 1: DeepStack ($21375 in chips)
Seat 2: Adam_@PokercastAdam ($18625 in chips)
DeepStack: posts small blind $100
Adam_@PokercastAdam: posts big blind $200
*** HOLE CARDS ***
Dealt to DeepStack [Qc 4h]
Dealt to Adam_@PokercastAdam [5d Jc]
DeepStack: calls $100
Adam_@PokercastAdam: checks
*** FLOP **** [2d Qh Tc]
Adam_@PokercastAdam: checks
DeepStack: raises $200 to $200
Adam_@PokercastAdam: folds
Uncalled bet ($200) returned to DeepStack
DeepStack collected $400 from the pot
*** SUMMARY ***
Total pot $400 | Rake $0
Board [2d Qh Tc]
Seat 1: DeepStack (button) (small blind) collected ($400)
Seat 2: Adam_@PokercastAdam (big blind) folded on the Flop

PokerStars Hand #5000000027: Tournament #1, Apr5_2017-at-16_31_33 Hold'em No Limit ($100/$200 USD) - 2017/04/05 18:31:59 ET
Table 'ACPC Match' 2-max Seat #2 is the button
Seat 1: DeepStack ($21575 in chips)
Seat 2: Adam_@PokercastAdam ($18425 in chips)
Adam_@PokercastAdam: posts small blind $100
DeepStack: posts big blind $200
*** HOLE CARDS ***
Dealt to DeepStack [7s 4h]
Dealt to Adam_@PokercastAdam [Qd 9d]
Adam_@PokercastAdam: raises $200 to $400
DeepStack: calls $200
*** FLOP **** [8h Jh 7h]
DeepStack: checks
Adam_@PokercastAdam: raises $600 to $600
DeepStack: calls $600
*** TURN **** [2h]
DeepStack: checks
Adam_@PokercastAdam: raises $1200 to $1200
DeepStack: calls $1200
*** RIVER **** [Qs]
DeepStack: checks
Adam_@PokercastAdam: checks
*** SHOW DOWN ***
DeepStack: shows [7s 4h] (flush, Jack high)
Adam_@PokercastAdam: shows [Qd 9d] (a pair of Queens)
DeepStack collected $4400 from pot
*** SUMMARY ***
Total pot $4400 | Rake $0
Board [8h Jh 7h 2h Qs]
Seat 1: DeepStack (big blind) showed [7s 4h] and won ($4400) with flush, Jack high
Seat 2: Adam_@PokercastAdam (button) (small blind) showed [Qd 9d] and lost with a pair of Queens

PokerStars Hand #5000000028: Tournament #1, Apr5_2017-at-16_31_33 Hold'em No Limit ($100/$200 USD) - 2017/04/05 18:32:00 ET
Table 'ACPC Match' 2-max Seat #1 is the button
Seat 1: DeepStack ($23775 in chips)
Seat 2: Adam_@PokercastAdam ($16225 in chips)
DeepStack: posts small blind $100
Adam_@PokercastAdam: posts big blind $200
*** HOLE CARDS ***
Dealt to DeepStack [Ad Ks]
Dealt to Adam_@PokercastAdam [Td 9s]
DeepStack: raises $400 to $600
Adam_@PokercastAdam: calls $400
*** FLOP **** [8d 6d 9c]
Adam_@PokercastAdam: bets $1000
DeepStack: raises $1600 to $2600
Adam_@PokercastAdam: calls $1600
*** TURN **** [Ac]
Adam_@PokercastAdam: checks
DeepStack: checks
*** RIVER **** [Qd]
Adam_@PokercastAdam: checks
DeepStack: checks
*** SHOW DOWN ***
Adam_@PokercastAdam: shows [Td 9s] (a pair of Nines)
DeepStack: shows [Ad Ks] (a pair of Aces)
DeepStack collected $6400 from pot
*** SUMMARY ***
Total pot $6400 | Rake $0
Board [8d 6d 9c Ac Qd]
Seat 1: DeepStack (button) (small blind) showed [Ad Ks] and won ($6400) with a pair of Aces
Seat 2: Adam_@PokercastAdam (big blind) showed [Td 9s] and lost with a pair of Nines

PokerStars Hand #5000000029: Tournament #1, Apr5_2017-at-16_31_33 Hold'em No Limit ($100/$200 USD) - 2017/04/05 18:32:01 ET
Table 'ACPC Match' 2-max Seat #2 is the button
Seat 1: DeepStack ($26975 in chips)
Seat 2: Adam_@PokercastAdam ($13025 in chips)
Adam_@PokercastAdam: posts small blind $100
DeepStack: posts big blind $200
*** HOLE CARDS ***
Dealt to DeepStack [Ad Qd]
Dealt to Adam_@PokercastAdam [Ah 8s]
Adam_@PokercastAdam: raises $200 to $400
DeepStack: raises $800 to $1200
Adam_@PokercastAdam: raises $11825 to $13025 and is all-in
DeepStack: calls $11825
*** FLOP **** [4h 3d 6s]
*** TURN **** [Js]
*** RIVER **** [7c]
*** SHOW DOWN ***
Adam_@PokercastAdam: shows [Ah 8s] (Ace high)
DeepStack: shows [Ad Qd] (Ace high)
DeepStack collected $26050 from pot
*** SUMMARY ***
Total pot $26050 | Rake $0
Board [4h 3d 6s Js 7c]
Seat 1: DeepStack (big blind) showed [Ad Qd] and won ($26050) with Ace high
Seat 2: Adam_@PokercastAdam (button) (small blind) showed [Ah 8s] and lost with Ace high
