PokerStars Hand #5000100001: Tournament #2, Apr5_2017-at-16_46_43 Hold'em No Limit ($50/$100 USD) - 2017/04/05 18:46:43 ET
Table 'ACPC Match' 2-max Seat #2 is the button
Seat 1: DeepStack ($20000 in chips)
Seat 2: Adam_@PokercastAdam ($20000 in chips)
Adam_@PokercastAdam: posts small blind $50
DeepStack: posts big blind $100
*** HOLE CARDS ***
Dealt to DeepStack [Jh 8s]
Dealt to Adam_@PokercastAdam [Ks Ad]
Adam_@PokercastAdam: raises $100 to $200
DeepStack: calls $100
*** FLOP **** [8c 3s 5c]
DeepStack: checks
Adam_@PokercastAdam: raises $200 to $200
DeepStack: calls $200
*** TURN **** [5s]
DeepStack: checks
Adam_@PokercastAdam: raises $200 to $200
DeepStack: calls $200
*** RIVER **** [7s]
DeepStack: checks
Adam_@PokercastAdam: checks
*** SHOW DOWN ***
DeepStack: shows [Jh 8s] (two pair, Eights and Fives)
Adam_@PokercastAdam: shows [Ks Ad] (a pair of Fives)
DeepStack collected $1200 from pot
*** SUMMARY ***
Total pot $1200 | Rake $0
Board [8c 3s 5c 5s 7s]
Seat 1: DeepStack (big blind) showed [Jh 8s] and won ($1200) with two pair, Eights and Fives
Seat 2: Adam_@PokercastAdam (button) (small blind) showed [Ks Ad] and lost with a pair of Fives

PokerStars Hand #5000100002: Tournament #2, Apr5_2017-at-16_46_43 Hold'em No Limit ($50/$100 USD) - 2017/04/05 18:46:44 ET
Table 'ACPC Match' 2-max Seat #1 is the button
Seat 1: DeepStack ($20600 in chips)
Seat 2: Adam_@PokercastAdam ($19400 in chips)
DeepStack: posts small blind $50
Adam_@PokercastAdam: posts big blind $100
*** HOLE CARDS ***
Dealt to DeepStack [As 8d]
Dealt to Adam_@PokercastAdam [4c 7d]
DeepStack: raises $200 to $300
Adam_@PokercastAdam: folds
Uncalled bet ($200) returned to DeepStack
DeepStack collected $200 from the pot
*** SUMMARY ***
Total pot $200 | Rake $0
Seat 1: DeepStack (button) (small blind) collected ($200)
Seat 2: Adam_@PokercastAdam (big blind) folded before the Flop

PokerStars Hand #5000100003: Tournament #2, Apr5_2017-at-16_46_43 Hold'em No Limit ($50/$100 USD) - 2017/04/05 18:46:45 ET
Table 'ACPC Match' 2-max Seat #2 is the button
Seat 1: DeepStack ($20700 in chips)
Seat 2: Adam_@PokercastAdam ($19300 in chips)
Adam_@PokercastAdam: posts small blind $50
DeepStack: posts big blind $100
*** HOLE CARDS ***
Dealt to DeepStack [9c 9h]
Dealt to Adam_@PokercastAdam [Ac 3c]
Adam_@PokercastAdam: raises $100 to $200
DeepStack: raises $400 to $600
Adam_@PokercastAdam: calls $400
*** FLOP **** [Qh Td 8s]
DeepStack: checks
Adam_@PokercastAdam: checks
*** TURN **** [7d]
DeepStack: checks
Adam_@PokercastAdam: raises $800 to $800
DeepStack: calls $800
*** RIVER **** [Th]
DeepStack: checks
Adam_@PokercastAdam: raises $2800 to $2800
DeepStack: calls $2800
*** SHOW DOWN ***
Adam_@PokercastAdam: shows [Ac 3c] (a pair of Tens)
DeepStack: shows [9c 9h] (two pair, Tens and Nines)
DeepStack collected $8400 from pot
*** SUMMARY ***
Total pot $8400 | Rake $0
Board [Qh Td 8s 7d Th]
Seat 1: DeepStack (big blind) showed [9c 9h] and won ($8400) with two pair, Tens and Nines
Seat 2: Adam_@PokercastAdam (button) (small blind) showed [Ac 3c] and lost with a pair of Tens

PokerStars Hand #5000100004: Tournament #2, Apr5_2017-at-16_46_43 Hold'em No Limit ($50/$100 USD) - 2017/04/05 18:46:46 ET
Table 'ACPC Match' 2-max Seat #1 is the button
Seat 1: DeepStack ($24900 in chips)
Seat 2: Adam_@PokercastAdam ($15100 in chips)
DeepStack: posts small blind $50
Adam_@PokercastAdam: posts big blind $100
*** HOLE CARDS ***
Dealt to DeepStack [Qs 7c]
Dealt to Adam_@PokercastAdam [As Jd]
DeepStack: raises $200 to $300
Adam_@PokercastAdam: raises $700 to $1000
DeepStack: folds
Uncalled bet ($700) returned to Adam_@PokercastAdam
Adam_@PokercastAdam collected $600 from the pot
*** SUMMARY ***
Total pot $600 | Rake $0
Seat 1: DeepStack (button) (small blind) folded before the Flop
Seat 2: Adam_@PokercastAdam (big blind) collected ($600)

PokerStars Hand #5000100005: Tournament #2, Apr5_2017-at-16_46_43 Hold'em No Limit ($50/$100 USD) - 2017/04/05 18:46:47 ET
Table 'ACPC Match' 2-max Seat #2 is the button
Seat 1: DeepStack ($24600 in chips)
Seat 2: Adam_@PokercastAdam ($15400 in chips)
Adam_@PokercastAdam: posts small blind $50
DeepStack: posts big blind $100
*** HOLE CARDS ***
Dealt to DeepStack [6h 7s]
Dealt to Adam_@PokercastAdam [5d Qc]
Adam_@PokercastAdam: raises $100 to $200
DeepStack: calls $100
*** FLOP **** [Ts 4c 9h]
DeepStack: checks
Adam_@PokercastAdam: checks
*** TURN **** [Qs]
DeepStack: checks
Adam_@PokercastAdam: raises $300 to $300
DeepStack: folds
Uncalled bet ($300) returned to Adam_@PokercastAdam
Adam_@PokercastAdam collected $400 from the pot
*** SUMMARY ***
Total pot $400 | Rake $0
Board [Ts 4c 9h Qs]
Seat 1: DeepStack (big blind) folded on the Turn
Seat 2: Adam_@PokercastAdam (button) (small blind) collected ($400)

PokerStars Hand #5000100006: Tournament #2, Apr5_2017-at-16_46_43 Hold'em No Limit ($50/$100 USD) - 2017/04/05 18:46:48 ET
Table 'ACPC Match' 2-max Seat #1 is the button
Seat 1: DeepStack ($24400 in chips)
Seat 2: Adam_@PokercastAdam ($15600 in chips)
DeepStack: posts small blind $50
Adam_@PokercastAdam: posts big blind $100
*** HOLE CARDS ***
Dealt to DeepStack [Kc 7d]
Dealt to Adam_@PokercastAdam [8s Kh]
DeepStack: raises $100 to $200
Adam_@PokercastAdam: calls $100
*** FLOP **** [8h 2h 6s]
Adam_@PokercastAdam: bets $300
DeepStack: folds
Uncalled bet ($300) returned to Adam_@PokercastAdam
Adam_@PokercastAdam collected $400 from the pot
*** SUMMARY ***
Total pot $400 | Rake $0
Board [8h 2h 6s]
Seat 1: DeepStack (button) (small blind) folded on the Flop
Seat 2: Adam_@PokercastAdam (big blind) collected ($400)

PokerStars Hand #5000100007: Tournament #2, Apr5_2017-at-16_46_43 Hold'em No Limit ($50/$100 USD) - 2017/04/05 18:46:49 ET
Table 'ACPC Match' 2-max Seat #2 is the button
Seat 1: DeepStack ($24200 in chips)
Seat 2: Adam_@PokercastAdam ($15800 in chips)
Adam_@PokercastAdam: posts small blind $50
DeepStack: posts big blind $100
*** HOLE CARDS ***
Dealt to DeepStack [6s 2s]
Dealt to Adam_@PokercastAdam [6c 7d]
Adam_@PokercastAdam: raises $200 to $300
DeepStack: folds
Uncalled bet ($200) returned to Adam_@PokercastAdam
Adam_@PokercastAdam collected $200 from the pot
*** SUMMARY ***
Total pot $200 | Rake $0
Seat 1: DeepStack (big blind) folded before the Flop
Seat 2: Adam_@PokercastAdam (button) (small blind) collected ($200)

PokerStars Hand #5000100008: Tournament #2, Apr5_2017-at-16_46_43 Hold'em No Limit ($50/$100 USD) - 2017/04/05 18:46:50 ET
Table 'ACPC Match' 2-max Seat #1 is the button
Seat 1: DeepStack ($24100 in chips)
Seat 2: Adam_@PokercastAdam ($15900 in chips)
DeepStack: posts small blind $50
Adam_@PokercastAdam: posts big blind $100
*** HOLE CARDS ***
Dealt to DeepStack [5d 9h]
Dealt to Adam_@PokercastAdam [2s 2c]
DeepStack: calls $50
Adam_@PokercastAdam: raises $200 to $300
DeepStack: folds
Uncalled bet ($200) returned to Adam_@PokercastAdam
Adam_@PokercastAdam collected $200 from the pot
*** SUMMARY ***
Total pot $200 | Rake $0
Seat 1: DeepStack (button) (small blind) folded before the Flop
Seat 2: Adam_@PokercastAdam (big blind) collected ($200)

PokerStars Hand #5000100009: Tournament #2, Apr5_2017-at-16_46_43 Hold'em No Limit ($50/$100 USD) - 2017/04/05 18:46:51 ET
Table 'ACPC Match' 2-max Seat #2 is the button
Seat 1: DeepStack ($24000 in chips)
Seat 2: Adam_@PokercastAdam ($16000 in chips)
Adam_@PokercastAdam: posts small blind $50
DeepStack: posts big blind $100
*** HOLE CARDS ***
Dealt to DeepStack [5c Jc]
Dealt to Adam_@PokercastAdam [9h Qh]
Adam_@PokercastAdam: raises $200 to $300
DeepStack: calls $200
*** FLOP **** [Ad 2d Ah]
DeepStack: checks
Adam_@PokercastAdam: checks
*** TURN **** [5s]
DeepStack: checks
Adam_@PokercastAdam: checks
*** RIVER **** [Ac]
DeepStack: checks
Adam_@PokercastAdam: checks
*** SHOW DOWN ***
DeepStack: shows [5c Jc] (full house, Aces and Fives)
Adam_@PokercastAdam: shows [9h Qh] (three of a kind, Aces)
DeepStack collected $600 from pot
*** SUMMARY ***
Total pot $600 | Rake $0
Board [Ad 2d Ah 5s Ac]
Seat 1: DeepStack (big blind) showed [5c Jc] and won ($600) with full house, Aces and Fives
Seat 2: Adam_@PokercastAdam (button) (small blind) showed [9h Qh] and lost with three of a kind, Aces

PokerStars Hand #5000100010: Tournament #2, Apr5_2017-at-16_46_43 Hold'em No Limit ($50/$100 USD) - 2017/04/05 18:46:52 ET
Table 'ACPC Match' 2-max Seat #1 is the button
Seat 1: DeepStack ($24300 in chips)
Seat 2: Adam_@PokercastAdam ($15700 in chips)
DeepStack: posts small blind $50
Adam_@PokercastAdam: posts big blind $100
*** HOLE CARDS ***
Dealt to DeepStack [3s Qs]
Dealt to Adam_@PokercastAdam [Ah 6d]
DeepStack: calls $50
Adam_@PokercastAdam: raises $200 to $300
DeepStack: calls $200
*** FLOP **** [4c 4s Jd]
Adam_@PokercastAdam: bets $100
DeepStack: calls $100
*** TURN **** [Jc]
Adam_@PokercastAdam: bets $100
DeepStack: folds
Uncalled bet ($100) returned to Adam_@PokercastAdam
Adam_@PokercastAdam collected $800 from the pot
*** SUMMARY ***
Total pot $800 | Rake $0
Board [4c 4s Jd Jc]
Seat 1: DeepStack (button) (small blind) folded on the Turn
Seat 2: Adam_@PokercastAdam (big blind) collected ($800)

PokerStars Hand #5000100011: Tournament #2, Apr5_2017-at-16_46_43 Hold'em No Limit ($75/$150 USD) - 2017/04/05 18:46:53 ET
Table 'ACPC Match' 2-max Seat #2 is the button
Seat 1: DeepStack ($23900 in chips)
Seat 2: Adam_@PokercastAdam ($16100 in chips)
Adam_@PokercastAdam: posts small blind $75
DeepStack: posts big blind $150
*** HOLE CARDS ***
Dealt to DeepStack [3d 2s]
Dealt to Adam_@PokercastAdam [4s Td]
Adam_@PokercastAdam: folds
Uncalled bet ($75) returned to DeepStack
DeepStack collected $150 from the pot
*** SUMMARY ***
Total pot $150 | Rake $0
Seat 1: DeepStack (big blind) collected ($150)
Seat 2: Adam_@PokercastAdam (button) (small blind) folded before the Flop

PokerStars Hand #5000100012: Tournament #2, Apr5_2017-at-16_46_43 Hold'em No Limit ($75/$150 USD) - 2017/04/05 18:46:54 ET
Table 'ACPC Match' 2-max Seat #1 is the button
Seat 1: DeepStack ($23975 in chips)
Seat 2: Adam_@PokercastAdam ($16025 in chips)
DeepStack: posts small blind $75
Adam_@PokercastAdam: posts big blind $150
*** HOLE CARDS ***
Dealt to DeepStack [7d Jh]
Dealt to Adam_@PokercastAdam [3c Qh]
DeepStack: raises $150 to $300
Adam_@PokercastAdam: calls $150
*** FLOP **** [6c 4c Qs]
Adam_@PokercastAdam: checks
DeepStack: checks
*** TURN **** [9d]
Adam_@PokercastAdam: bets $600
DeepStack: folds
Uncalled bet ($600) returned to Adam_@PokercastAdam
Adam_@PokercastAdam collected $600 from the pot
*** SUMMARY ***
Total pot $600 | Rake $0
Board [6c 4c Qs 9d]
Seat 1: DeepStack (button) (small blind) folded on the Turn
Seat 2: Adam_@PokercastAdam (big blind) collected ($600)

PokerStars Hand #5000100013: Tournament #2, Apr5_2017-at-16_46_43 Hold'em No Limit ($75/$150 USD) - 2017/04/05 18:46:55 ET
Table 'ACPC Match' 2-max Seat #2 is the button
Seat 1: DeepStack ($23675 in chips)
Seat 2: Adam_@PokercastAdam ($16325 in chips)
Adam_@PokercastAdam: posts small blind $75
DeepStack: posts big blind $150
*** HOLE CARDS ***
Dealt to DeepStack [2h 8d]
Dealt to Adam_@PokercastAdam [Qd 8s]
Adam_@PokercastAdam: raises $150 to $300
DeepStack: folds
Uncalled bet ($150) returned to Adam_@PokercastAdam
Adam_@PokercastAdam collected $300 from the pot
*** SUMMARY ***
Total pot $300 | Rake $0
Seat 1: DeepStack (big blind) folded before the Flop
Seat 2: Adam_@PokercastAdam (button) (small blind) collected ($300)

PokerStars Hand #5000100014: Tournament #2, Apr5_2017-at-16_46_43 Hold'em No Limit ($75/$150 USD) - 2017/04/05 18:46:56 ET
Table 'ACPC Match' 2-max Seat #1 is the button
Seat 1: DeepStack ($23525 in chips)
Seat 2: Adam_@PokercastAdam ($16475 in chips)
DeepStack: posts small blind $75
Adam_@PokercastAdam: posts big blind $150
*** HOLE CARDS ***
Dealt to DeepStack [Qd 9h]
Dealt to Adam_@PokercastAdam [5s 7s]
DeepStack: raises $150 to $300
Adam_@PokercastAdam: calls $150
*** FLOP **** [Jc Td 9c]
Adam_@PokercastAdam: checks
DeepStack: raises $300 to $300
Adam_@PokercastAdam: folds
Uncalled bet ($300) returned to DeepStack
DeepStack collected $600 from the pot
*** SUMMARY ***
Total pot $600 | Rake $0
Board [Jc Td 9c]
Seat 1: DeepStack (button) (small blind) collected ($600)
Seat 2: Adam_@PokercastAdam (big blind) folded on the Flop

PokerStars Hand #5000100015: Tournament #2, Apr5_2017-at-16_46_43 Hold'em No Limit ($75/$150 USD) - 2017/04/05 18:46:57 ET
Table 'ACPC Match' 2-max Seat #2 is the button
Seat 1: DeepStack ($23825 in chips)
Seat 2: Adam_@PokercastAdam ($16175 in chips)
Adam_@PokercastAdam: posts small blind $75
DeepStack: posts big blind $150
*** HOLE CARDS ***
Dealt to DeepStack [7d 5h]
Dealt to Adam_@PokercastAdam [8h 8c]
Adam_@PokercastAdam: raises $300 to $450
DeepStack: folds
Uncalled bet ($300) returned to Adam_@PokercastAdam
Adam_@PokercastAdam collected $300 from the pot
*** SUMMARY ***
Total pot $300 | Rake $0
Seat 1: DeepStack (big blind) folded before the Flop
Seat 2: Adam_@PokercastAdam (button) (small blind) collected ($300)

PokerStars Hand #5000100016: Tournament #2, Apr5_2017-at-16_46_43 Hold'em No Limit ($75/$150 USD) - 2017/04/05 18:46:58 ET
Table 'ACPC Match' 2-max Seat #1 is the button
Seat 1: DeepStack ($23675 in chips)
Seat 2: Adam_@PokercastAdam ($16325 in chips)
DeepStack: posts small blind $75
Adam_@PokercastAdam: posts big blind $150
*** HOLE CARDS ***
Dealt to DeepStack [7c 2d]
Dealt to Adam_@PokercastAdam [Ks 2c]
DeepStack: folds
Uncalled bet ($75) returned to Adam_@PokercastAdam
Adam_@PokercastAdam collected $150 from the pot
*** SUMMARY ***
Total pot $150 | Rake $0
Seat 1: DeepStack (button) (small blind) folded before the Flop
Seat 2: Adam_@PokercastAdam (big blind) collected ($150)

PokerStars Hand #5000100017: Tournament #2, Apr5_2017-at-16_46_43 Hold'em No Limit ($75/$150 USD) - 2017/04/05 18:46:59 ET
Table 'ACPC Match' 2-max Seat #2 is the button
Seat 1: DeepStack ($23600 in chips)
Seat 2: Adam_@PokercastAdam ($16400 in chips)
Adam_@PokercastAdam: posts small blind $75
DeepStack: posts big blind $150
*** HOLE CARDS ***
Dealt to DeepStack [Ah Qd]
Dealt to Adam_@PokercastAdam [7c 3h]
Adam_@PokercastAdam: folds
Uncalled bet ($75) returned to DeepStack
DeepStack collected $150 from the pot
*** SUMMARY ***
Total pot $150 | Rake $0
Seat 1: DeepStack (big blind) collected ($150)
Seat 2: Adam_@PokercastAdam (button) (small blind) folded before the Flop

PokerStars Hand #5000100018: Tournament #2, Apr5_2017-at-16_46_43 Hold'em No Limit ($75/$150 USD) - 2017/04/05 18:47:00 ET
Table 'ACPC Match' 2-max Seat #1 is the button
Seat 1: DeepStack ($23675 in chips)
Seat 2: Adam_@PokercastAdam ($16325 in chips)
DeepStack: posts small blind $75
Adam_@PokercastAdam: posts big blind $150
*** HOLE CARDS ***
Dealt to DeepStack [4h Qh]
Dealt to Adam_@PokercastAdam [4d 5d]
DeepStack: calls $75
Adam_@PokercastAdam: checks
*** FLOP **** [As Ts 5h]
Adam_@PokercastAdam: checks
DeepStack: checks
*** TURN **** [Jc]
Adam_@PokercastAdam: checks
DeepStack: checks
*** RIVER **** [6c]
Adam_@PokercastAdam: checks
DeepStack: checks
*** SHOW DOWN ***
Adam_@PokercastAdam: shows [4d 5d] (a pair of Fives)
DeepStack: shows [4h Qh] (Ace high)
Adam_@PokercastAdam collected $300 from pot
*** SUMMARY ***
Total pot $300 | Rake $0
Board [As Ts 5h Jc 6c]
Seat 1: DeepStack (button) (small blind) showed [4h Qh] and lost with Ace high
Seat 2: Adam_@PokercastAdam (big blind) showed [4d 5d] and won ($300) with a pair of Fives

PokerStars Hand #5000100019: Tournament #2, Apr5_2017-at-16_46_43 Hold'em No Limit ($75/$150 USD) - 2017/04/05 18:47:01 ET
Table 'ACPC Match' 2-max Seat #2 is the button
Seat 1: DeepStack ($23525 in chips)
Seat 2: Adam_@PokercastAdam ($16475 in chips)
Adam_@PokercastAdam: posts small blind $75
DeepStack: posts big blind $150
*** HOLE CARDS ***
Dealt to DeepStack [Ac 7s]
Dealt to Adam_@PokercastAdam [3s Qs]
Adam_@PokercastAdam: raises $150 to $300
DeepStack: calls $150
*** FLOP **** [7h Tc 8s]
DeepStack: checks
Adam_@PokercastAdam: checks
*** TURN **** [6d]
DeepStack: checks
Adam_@PokercastAdam: checks
*** RIVER **** [3h]
DeepStack: checks
Adam_@PokercastAdam: checks
*** SHOW DOWN ***
DeepStack: shows [Ac 7s] (a pair of Sevens)
Adam_@PokercastAdam: shows [3s Qs] (a pair of Threes)
DeepStack collected $600 from pot
*** SUMMARY ***
Total pot $600 | Rake $0
Board [7h Tc 8s 6d 3h]
Seat 1: DeepStack (big blind) showed [Ac 7s] and won ($600) with a pair of Sevens
Seat 2: Adam_@PokercastAdam (button) (small blind) showed [3s Qs] and lost with a pair of Threes

PokerStars Hand #5000100020: Tournament #2, Apr5_2017-at-16_46_43 Hold'em No Limit ($75/$150 USD) - 2017/04/05 18:47:02 ET
Table 'ACPC Match' 2-max Seat #1 is the button
Seat 1: DeepStack ($23825 in chips)
Seat 2: Adam_@PokercastAdam ($16175 in chips)
DeepStack: posts small blind $75
Adam_@PokercastAdam: posts big blind $150
*** HOLE CARDS ***
Dealt to DeepStack [3d Kd]
Dealt to Adam_@PokercastAdam [9c 8h]
DeepStack: raises $300 to $450
Adam_@PokercastAdam: calls $300
*** FLOP **** [7s Kh 9h]
Adam_@PokercastAdam: checks
DeepStack: checks
*** TURN **** [As]
Adam_@PokercastAdam: bets $300
DeepStack: calls $300
*** RIVER **** [6d]
Adam_@PokercastAdam: checks
DeepStack: checks
*** SHOW DOWN ***
Adam_@PokercastAdam: shows [9c 8h] (a pair of Nines)
DeepStack: shows [3d Kd] (a pair of Kings)
DeepStack collected $1500 from pot
*** SUMMARY ***
Total pot $1500 | Rake $0
Board [7s Kh 9h As 6d]
Seat 1: DeepStack (button) (small blind) showed [3d Kd] and won ($1500) with a pair of Kings
Seat 2: Adam_@PokercastAdam (big blind) showed [9c 8h] and lost with a pair of Nines

PokerStars Hand #5000100021: Tournament #2, Apr5_2017-at-16_46_43 Hold'em No Limit ($100/$200 USD) - 2017/04/05 18:47:03 ET
Table 'ACPC Match' 2-max Seat #2 is the button
Seat 1: DeepStack ($24575 in chips)
Seat 2: Adam_@PokercastAdam ($15425 in chips)
Adam_@PokercastAdam: posts small blind $100
DeepStack: posts big blind $200
*** HOLE CARDS ***
Dealt to DeepStack [Ad Th]
Dealt to Adam_@PokercastAdam [8d 6s]
Adam_@PokercastAdam: raises $200 to $400
DeepStack: raises $800 to $1200
Adam_@PokercastAdam: folds
Uncalled bet ($800) returned to DeepStack
DeepStack collected $800 from the pot
*** SUMMARY ***
Total pot $800 | Rake $0
Seat 1: DeepStack (big blind) collected ($800)
Seat 2: Adam_@PokercastAdam (button) (small blind) folded before the Flop

PokerStars Hand #5000100022: Tournament #2, Apr5_2017-at-16_46_43 Hold'em No Limit ($100/$200 USD) - 2017/04/05 18:47:04 ET
Table 'ACPC Match' 2-max Seat #1 is the button
Seat 1: DeepStack ($24975 in chips)
Seat 2: Adam_@PokercastAdam ($15025 in chips)
DeepStack: posts small blind $100
Adam_@PokercastAdam: posts big blind $200
*** HOLE CARDS ***
Dealt to DeepStack [7d 5c]
Dealt to Adam_@PokercastAdam [3h Qc]
DeepStack: raises $400 to $600
Adam_@PokercastAdam: folds
Uncalled bet ($400) returned to DeepStack
DeepStack collected $400 from the pot
*** SUMMARY ***
Total pot $400 | Rake $0
Seat 1: DeepStack (button) (small blind) collected ($400)
Seat 2: Adam_@PokercastAdam (big blind) folded before the Flop

PokerStars Hand #5000100023: Tournament #2, Apr5_2017-at-16_46_43 Hold'em No Limit ($100/$200 USD) - 2017/04/05 18:47:05 ET
Table 'ACPC Match' 2-max Seat #2 is the button
Seat 1: DeepStack ($25175 in chips)
Seat 2: Adam_@PokercastAdam ($14825 in chips)
Adam_@PokercastAdam: posts small blind $100
DeepStack: posts big blind $200
*** HOLE CARDS ***
Dealt to DeepStack [6d Kd]
Dealt to Adam_@PokercastAdam [3d 2d]
Adam_@PokercastAdam: folds
Uncalled bet ($100) returned to DeepStack
DeepStack collected $200 from the pot
*** SUMMARY ***
Total pot $200 | Rake $0
Seat 1: DeepStack (big blind) collected ($200)
Seat 2: Adam_@PokercastAdam (button) (small blind) folded before the Flop

PokerStars Hand #5000100024: Tournament #2, Apr5_2017-at-16_46_43 Hold'em No Limit ($100/$200 USD) - 2017/04/05 18:47:06 ET
Table 'ACPC Match' 2-max Seat #1 is the button
Seat 1: DeepStack ($25275 in chips)
Seat 2: Adam_@PokercastAdam ($14725 in chips)
DeepStack: posts small blind $100
Adam_@PokercastAdam: posts big blind $200
*** HOLE CARDS ***
Dealt to DeepStack [4d 5d]
Dealt to Adam_@PokercastAdam [8c Kc]
DeepStack: raises $400 to $600
Adam_@PokercastAdam: calls $400
*** FLOP **** [Jd 2s 5s]
Adam_@PokercastAdam: checks
DeepStack: raises $600 to $600
Adam_@PokercastAdam: folds
Uncalled bet ($600) returned to DeepStack
DeepStack collected $1200 from the pot
*** SUMMARY ***
Total pot $1200 | Rake $0
Board [Jd 2s 5s]
Seat 1: DeepStack (button) (small blind) collected ($1200)
Seat 2: Adam_@PokercastAdam (big blind) folded on the Flop

PokerStars Hand #5000100025: Tournament #2, Apr5_2017-at-16_46_43 Hold'em No Limit ($100/$200 USD) - 2017/04/05 18:47:07 ET
Table 'ACPC Match' 2-max Seat #2 is the button
Seat 1: DeepStack ($25875 in chips)
Seat 2: Adam_@PokercastAdam ($14125 in chips)
Adam_@PokercastAdam: posts small blind $100
DeepStack: posts big blind $200
*** HOLE CARDS ***
Dealt to DeepStack [7c Jc]
Dealt to Adam_@PokercastAdam [Qc Ac]
Adam_@PokercastAdam: raises $400 to $600
DeepStack: raises $1200 to $1800
Adam_@PokercastAdam: raises $3000 to $4800
DeepStack: folds
Uncalled bet ($3000) returned to Adam_@PokercastAdam
Adam_@PokercastAdam collected $3600 from the pot
*** SUMMARY ***
Total pot $3600 | Rake $0
Seat 1: DeepStack (big blind) folded before the Flop
Seat 2: Adam_@PokercastAdam (button) (small blind) collected ($3600)

PokerStars Hand #5000100026: Tournament #2, Apr5_2017-at-16_46_43 Hold'em No Limit ($100/$200 USD) - 2017/04/05 18:47:08 ET
Table 'ACPC Match' 2-max Seat #1 is the button
Seat 1: DeepStack ($24075 in chips)
Seat 2: Adam_@PokercastAdam ($15925 in chips)
DeepStack: posts small blind $100
Adam_@PokercastAdam: posts big blind $200
*** HOLE CARDS ***
Dealt to DeepStack [3h 5c]
Dealt to Adam_@PokercastAdam [7h Jd]
DeepStack: raises $200 to $400
Adam_@PokercastAdam: calls $200
*** FLOP **** [3c Ad 4d]
Adam_@PokercastAdam: checks
DeepStack: checks
*** TURN **** [6d]
Adam_@PokercastAdam: bets $800
DeepStack: calls $800
*** RIVER **** [8h]
Adam_@PokercastAdam: bets $1600
DeepStack: raises $13125 to $14725
Adam_@PokercastAdam: folds
Uncalled bet ($13125) returned to DeepStack
DeepStack collected $5600 from the pot
*** SUMMARY ***
Total pot $5600 | Rake $0
Board [3c Ad 4d 6d 8h]
Seat 1: DeepStack (button) (small blind) collected ($5600)
Seat 2: Adam_@PokercastAdam (big blind) folded on the River

PokerStars Hand #5000100027: Tournament #2, Apr5_2017-at-16_46_43 Hold'em No Limit ($100/$200 USD) - 2017/04/05 18:47:09 ET
Table 'ACPC Match' 2-max Seat #2 is the button
Seat 1: DeepStack ($26875 in chips)
Seat 2: Adam_@PokercastAdam ($13125 in chips)
Adam_@PokercastAdam: posts small blind $100
DeepStack: posts big blind $200
*** HOLE CARDS ***
Dealt to DeepStack [2d 7s]
Dealt to Adam_@PokercastAdam [2h 9d]
Adam_@PokercastAdam: folds
Uncalled bet ($100) returned to DeepStack
DeepStack collected $200 from the pot
*** SUMMARY ***
Total pot $200 | Rake $0
Seat 1: DeepStack (big blind) collected ($200)
Seat 2: Adam_@PokercastAdam (button) (small blind) folded before the Flop

PokerStars Hand #5000100028: Tournament #2, Apr5_2017-at-16_46_43 Hold'em No Limit ($100/$200 USD) - 2017/04/05 18:47:10 ET
Table 'ACPC Match' 2-max Seat #1 is the button
Seat 1: DeepStack ($26975 in chips)
Seat 2: Adam_@PokercastAdam ($13025 in chips)
DeepStack: posts small blind $100
Adam_@PokercastAdam: posts big blind $200
*** HOLE CARDS ***
Dealt to DeepStack [Ad Td]
Dealt to Adam_@PokercastAdam [Tc Ts]
DeepStack: raises $400 to $600
Adam_@PokercastAdam: raises $1400 to $2000
DeepStack: calls $1400
*** FLOP **** [8d 7s 4d]
Adam_@PokercastAdam: bets $3200
DeepStack: raises $7825 to $11025
Adam_@PokercastAdam: calls $7825 and is all-in
*** TURN **** [9d]
*** RIVER **** [3h]
*** SHOW DOWN ***
DeepStack: shows [Ad Td] (flush, Ace high)
Adam_@PokercastAdam: shows [Tc Ts] (a pair of Tens)
DeepStack collected $26050 from pot
*** SUMMARY ***
Total pot $26050 | Rake $0
Board [8d 7s 4d 9d 3h]
Seat 1: DeepStack (button) (small blind) showed [Ad Td] and won ($26050) with flush, Ace high
Seat 2: Adam_@PokercastAdam (big blind) showed [Tc Ts] and lost with a pair of Tens
