PokerStars Hand #11000000001: Tournament #1, Apr29_2017-at-11_0_39 Hold'em No Limit ($50/$100 USD) - 2017/04/29 13:00:39 ET
Table 'ACPC Match' 2-max Seat #2 is the button
Seat 1: DeepStack ($20000 in chips)
Seat 2: Mike_McDonald_@MikeMcDonald89 ($20000 in chips)
Mike_McDonald_@MikeMcDonald89: posts small blind $50
DeepStack: posts big blind $100
*** HOLE CARDS ***
Dealt to DeepStack [Ks 6d]
Dealt to Mike_McDonald_@MikeMcDonald89 [Qh 9s]
Mike_McDonald_@MikeMcDonald89: raises $150 to $250
DeepStack: calls $150
*** FLOP **** [Qs 6s 8c]
DeepStack: checks
Mike_McDonald_@MikeMcDonald89: raises $250 to $250
DeepStack: calls $250
*** TURN **** [8d]
DeepStack: checks
Mike_McDonald_@MikeMcDonald89: checks
*** RIVER **** [Ts]
DeepStack: checks
Mike_McDonald_@MikeMcDonald89: raises $500 to $500
DeepStack: folds
Uncalled bet ($500) returned to Mike_McDonald_@MikeMcDonald89
Mike_McDonald_@MikeMcDonald89 collected $1000 from the pot
*** SUMMARY ***
Total pot $1000 | Rake $0
Board [Qs 6s 8c 8d Ts]
Seat 1: DeepStack (big blind) folded on the River
Seat 2: Mike_McDonald_@MikeMcDonald89 (button) (small blind) collected ($1000)

PokerStars Hand #11000000002: Tournament #1, Apr29_2017-at-11_0_39 Hold'em No Limit ($50/$100 USD) - 2017/04/29 13:00:40 ET
Table 'ACPC Match' 2-max Seat #1 is the button
Seat 1: DeepStack ($19500 in chips)
Seat 2: Mike_McDonald_@MikeMcDonald89 ($20500 in chips)
DeepStack: posts small blind $50
Mike_McDonald_@MikeMcDonald89: posts big blind $100
*** HOLE CARDS ***
Dealt to DeepStack [Qs 6s]
Dealt to Mike_McDonald_@MikeMcDonald89 [8c 2c]
DeepStack: raises $200 to $300
Mike_McDonald_@MikeMcDonald89: folds
Uncalled bet ($200) returned to DeepStack
DeepStack collected $200 from the pot
*** SUMMARY ***
Total pot $200 | Rake $0
Seat 1: DeepStack (button) (small blind) collected ($200)
Seat 2: Mike_McDonald_@MikeMcDonald89 (big blind) folded before the Flop

PokerStars Hand #11000000003: Tournament #1, Apr29_2017-at-11_0_39 Hold'em No Limit ($50/$100 USD) - 2017/04/29 13:00:41 ET
Table 'ACPC Match' 2-max Seat #2 is the button
Seat 1: DeepStack ($19600 in chips)
Seat 2: Mike_McDonald_@MikeMcDonald89 ($20400 in chips)
Mike_McDonald_@MikeMcDonald89: posts small blind $50
DeepStack: posts big blind $100
*** HOLE CARDS ***
Dealt to DeepStack [Th 2h]
Dealt to Mike_McDonald_@MikeMcDonald89 [7s Tc]
Mike_McDonald_@MikeMcDonald89: raises $150 to $250
DeepStack: calls $150
*** FLOP **** [9d 4c 6c]
DeepStack: checks
Mike_McDonald_@MikeMcDonald89: raises $250 to $250
DeepStack: folds
Uncalled bet ($250) returned to Mike_McDonald_@MikeMcDonald89
Mike_McDonald_@MikeMcDonald89 collected $500 from the pot
*** SUMMARY ***
Total pot $500 | Rake $0
Board [9d 4c 6c]
Seat 1: DeepStack (big blind) folded on the Flop
Seat 2: Mike_McDonald_@MikeMcDonald89 (button) (small blind) collected ($500)

PokerStars Hand #11000000004: Tournament #1, Apr29_2017-at-11_0_39 Hold'em No Limit ($50/$100 USD) - 2017/04/29 13:00:42 ET
Table 'ACPC Match' 2-max Seat #1 is the button
Seat 1: DeepStack ($19350 in chips)
Seat 2: Mike_McDonald_@MikeMcDonald89 ($20650 in chips)
DeepStack: posts small blind $50
Mike_McDonald_@MikeMcDonald89: posts big blind $100
*** HOLE CARDS ***
Dealt to DeepStack [Kd Ts]
Dealt to Mike_McDonald_@MikeMcDonald89 [5c Tc]
DeepStack: raises $100 to $200
Mike_McDonald_@MikeMcDonald89: calls $100
*** FLOP **** [Kh 7c Td]
Mike_McDonald_@MikeMcDonald89: checks
DeepStack: raises $400 to $400
Mike_McDonald_@MikeMcDonald89: calls $400
*** TURN **** [As]
Mike_McDonald_@MikeMcDonald89: checks
DeepStack: raises $1200 to $1200
Mike_McDonald_@MikeMcDonald89: folds
Uncalled bet ($1200) returned to DeepStack
DeepStack collected $1200 from the pot
*** SUMMARY ***
Total pot $1200 | Rake $0
Board [Kh 7c Td As]
Seat 1: DeepStack (button) (small blind) collected ($1200)
Seat 2: Mike_McDonald_@MikeMcDonald89 (big blind) folded on the Turn

PokerStars Hand #11000000005: Tournament #1, Apr29_2017-at-11_0_39 Hold'em No Limit ($50/$100 USD) - 2017/04/29 13:00:43 ET
Table 'ACPC Match' 2-max Seat #2 is the button
Seat 1: DeepStack ($19950 in chips)
Seat 2: Mike_McDonald_@MikeMcDonald89 ($20050 in chips)
Mike_McDonald_@MikeMcDonald89: posts small blind $50
DeepStack: posts big blind $100
*** HOLE CARDS ***
Dealt to DeepStack [8d 7s]
Dealt to Mike_McDonald_@MikeMcDonald89 [5c 9h]
Mike_McDonald_@MikeMcDonald89: raises $150 to $250
DeepStack: calls $150
*** FLOP **** [2d Qs 7d]
DeepStack: checks
Mike_McDonald_@MikeMcDonald89: checks
*** TURN **** [Ah]
DeepStack: checks
Mike_McDonald_@MikeMcDonald89: raises $250 to $250
DeepStack: calls $250
*** RIVER **** [Jd]
DeepStack: checks
Mike_McDonald_@MikeMcDonald89: raises $750 to $750
DeepStack: calls $750
*** SHOW DOWN ***
Mike_McDonald_@MikeMcDonald89: shows [5c 9h] (Ace high)
DeepStack: shows [8d 7s] (a pair of Sevens)
DeepStack collected $2500 from pot
*** SUMMARY ***
Total pot $2500 | Rake $0
Board [2d Qs 7d Ah Jd]
Seat 1: DeepStack (big blind) showed [8d 7s] and won ($2500) with a pair of Sevens
Seat 2: Mike_McDonald_@MikeMcDonald89 (button) (small blind) showed [5c 9h] and lost with Ace high

PokerStars Hand #11000000006: Tournament #1, Apr29_2017-at-11_0_39 Hold'em No Limit ($50/$100 USD) - 2017/04/29 13:00:44 ET
Table 'ACPC Match' 2-max Seat #1 is the button
Seat 1: DeepStack ($21200 in chips)
Seat 2: Mike_McDonald_@MikeMcDonald89 ($18800 in chips)
DeepStack: posts small blind $50
Mike_McDonald_@MikeMcDonald89: posts big blind $100
*** HOLE CARDS ***
Dealt to DeepStack [9c Js]
Dealt to Mike_McDonald_@MikeMcDonald89 [7d 2h]
DeepStack: raises $200 to $300
Mike_McDonald_@MikeMcDonald89: folds
Uncalled bet ($200) returned to DeepStack
DeepStack collected $200 from the pot
*** SUMMARY ***
Total pot $200 | Rake $0
Seat 1: DeepStack (button) (small blind) collected ($200)
Seat 2: Mike_McDonald_@MikeMcDonald89 (big blind) folded before the Flop

PokerStars Hand #11000000007: Tournament #1, Apr29_2017-at-11_0_39 Hold'em No Limit ($50/$100 USD) - 2017/04/29 13:00:45 ET
Table 'ACPC Match' 2-max Seat #2 is the button
Seat 1: DeepStack ($21300 in chips)
Seat 2: Mike_McDonald_@MikeMcDonald89 ($18700 in chips)
Mike_McDonald_@MikeMcDonald89: posts small blind $50
DeepStack: posts big blind $100
*** HOLE CARDS ***
Dealt to DeepStack [Qd 6d]
Dealt to Mike_McDonald_@MikeMcDonald89 [5c 6s]
Mike_McDonald_@MikeMcDonald89: raises $150 to $250
DeepStack: calls $150
*** FLOP **** [Qc Jc Tc]
DeepStack: checks
Mike_McDonald_@MikeMcDonald89: checks
*** TURN **** [Js]
DeepStack: checks
Mike_McDonald_@MikeMcDonald89: raises $250 to $250
DeepStack: calls $250
*** RIVER **** [9c]
DeepStack: checks
Mike_McDonald_@MikeMcDonald89: checks
*** SHOW DOWN ***
DeepStack: shows [Qd 6d] (two pair, Queens and Jacks)
Mike_McDonald_@MikeMcDonald89: shows [5c 6s] (flush, Queen high)
Mike_McDonald_@MikeMcDonald89 collected $1000 from pot
*** SUMMARY ***
Total pot $1000 | Rake $0
Board [Qc Jc Tc Js 9c]
Seat 1: DeepStack (big blind) showed [Qd 6d] and lost with two pair, Queens and Jacks
Seat 2: Mike_McDonald_@MikeMcDonald89 (button) (small blind) showed [5c 6s] and won ($1000) with flush, Queen high

PokerStars Hand #11000000008: Tournament #1, Apr29_2017-at-11_0_39 Hold'em No Limit ($50/$100 USD) - 2017/04/29 13:00:46 ET
Table 'ACPC Match' 2-max Seat #1 is the button
Seat 1: DeepStack ($20800 in chips)
Seat 2: Mike_McDonald_@MikeMcDonald89 ($19200 in chips)
DeepStack: posts small blind $50
Mike_McDonald_@MikeMcDonald89: posts big blind $100
*** HOLE CARDS ***
Dealt to DeepStack [8d Js]
Dealt to Mike_McDonald_@MikeMcDonald89 [Ad Ts]
DeepStack: raises $100 to $200
Mike_McDonald_@MikeMcDonald89: calls $100
*** FLOP **** [4h 8s 7s]
Mike_McDonald_@MikeMcDonald89: checks
DeepStack: checks
*** TURN **** [Kc]
Mike_McDonald_@MikeMcDonald89: checks
DeepStack: checks
*** RIVER **** [Td]
Mike_McDonald_@MikeMcDonald89: bets $300
DeepStack: calls $300
*** SHOW DOWN ***
Mike_McDonald_@MikeMcDonald89: shows [Ad Ts] (a pair of Tens)
DeepStack: shows [8d Js] (a pair of Eights)
Mike_McDonald_@MikeMcDonald89 collected $1000 from pot
*** SUMMARY ***
Total pot $1000 | Rake $0
Board [4h 8s 7s Kc Td]
Seat 1: DeepStack (button) (small blind) showed [8d Js] and lost with a pair of Eights
Seat 2: Mike_McDonald_@MikeMcDonald89 (big blind) showed [Ad Ts] and won ($1000) with a pair of Tens

PokerStars Hand #11000000009: Tournament #1, Apr29_2017-at-11_0_39 Hold'em No Limit ($50/$100 USD) - 2017/04/29 13:00:47 ET
Table 'ACPC Match' 2-max Seat #2 is the button
Seat 1: DeepStack ($20300 in chips)
Seat 2: Mike_McDonald_@MikeMcDonald89 ($19700 in chips)
Mike_McDonald_@MikeMcDonald89: posts small blind $50
DeepStack: posts big blind $100
*** HOLE CARDS ***
Dealt to DeepStack [9c 6h]
Dealt to Mike_McDonald_@MikeMcDonald89 [Jc 2d]
Mike_McDonald_@MikeMcDonald89: folds
Uncalled bet ($50) returned to DeepStack
DeepStack collected $100 from the pot
*** SUMMARY ***
Total pot $100 | Rake $0
Seat 1: DeepStack (big blind) collected ($100)
Seat 2: Mike_McDonald_@MikeMcDonald89 (button) (small blind) folded before the Flop

PokerStars Hand #11000000010: Tournament #1, Apr29_2017-at-11_0_39 Hold'em No Limit ($50/$100 USD) - 2017/04/29 13:00:48 ET
Table 'ACPC Match' 2-max Seat #1 is the button
Seat 1: DeepStack ($20350 in chips)
Seat 2: Mike_McDonald_@MikeMcDonald89 ($19650 in chips)
DeepStack: posts small blind $50
Mike_McDonald_@MikeMcDonald89: posts big blind $100
*** HOLE CARDS ***
Dealt to DeepStack [Qs 8s]
Dealt to Mike_McDonald_@MikeMcDonald89 [Th Ts]
DeepStack: calls $50
Mike_McDonald_@MikeMcDonald89: raises $300 to $400
DeepStack: calls $300
*** FLOP **** [Ad Jd Ah]
Mike_McDonald_@MikeMcDonald89: checks
DeepStack: checks
*** TURN **** [8d]
Mike_McDonald_@MikeMcDonald89: checks
DeepStack: checks
*** RIVER **** [5d]
Mike_McDonald_@MikeMcDonald89: checks
DeepStack: checks
*** SHOW DOWN ***
Mike_McDonald_@MikeMcDonald89: shows [Th Ts] (two pair, Aces and Tens)
DeepStack: shows [Qs 8s] (two pair, Aces and Eights)
Mike_McDonald_@MikeMcDonald89 collected $800 from pot
*** SUMMARY ***
Total pot $800 | Rake $0
Board [Ad Jd Ah 8d 5d]
Seat 1: DeepStack (button) (small blind) showed [Qs 8s] and lost with two pair, Aces and Eights
Seat 2: Mike_McDonald_@MikeMcDonald89 (big blind) showed [Th Ts] and won ($800) with two pair, Aces and Tens

PokerStars Hand #11000000011: Tournament #1, Apr29_2017-at-11_0_39 Hold'em No Limit ($75/$150 USD) - 2017/04/29 13:00:49 ET
Table 'ACPC Match' 2-max Seat #2 is the button
Seat 1: DeepStack ($19950 in chips)
Seat 2: Mike_McDonald_@MikeMcDonald89 ($20050 in chips)
Mike_McDonald_@MikeMcDonald89: posts small blind $75
DeepStack: posts big blind $150
*** HOLE CARDS ***
Dealt to DeepStack [7s 4s]
Dealt to Mike_McDonald_@MikeMcDonald89 [5h 8c]
Mike_McDonald_@MikeMcDonald89: raises $225 to $375
DeepStack: calls $225
*** FLOP **** [9h 9s Qc]
DeepStack: checks
Mike_McDonald_@MikeMcDonald89: raises $250 to $250
DeepStack: folds
Uncalled bet ($250) returned to Mike_McDonald_@MikeMcDonald89
Mike_McDonald_@MikeMcDonald89 collected $750 from the pot
*** SUMMARY ***
Total pot $750 | Rake $0
Board [9h 9s Qc]
Seat 1: DeepStack (big blind) folded on the Flop
Seat 2: Mike_McDonald_@MikeMcDonald89 (button) (small blind) collected ($750)

PokerStars Hand #11000000012: Tournament #1, Apr29_2017-at-11_0_39 Hold'em No Limit ($75/$150 USD) - 2017/04/29 13:00:50 ET
Table 'ACPC Match' 2-max Seat #1 is the button
Seat 1: DeepStack ($19575 in chips)
Seat 2: Mike_McDonald_@MikeMcDonald89 ($20425 in chips)
DeepStack: posts small blind $75
Mike_McDonald_@MikeMcDonald89: posts big blind $150
*** HOLE CARDS ***
Dealt to DeepStack [Kd 5h]
Dealt to Mike_McDonald_@MikeMcDonald89 [Qc 8c]
DeepStack: raises $150 to $300
Mike_McDonald_@MikeMcDonald89: calls $150
*** FLOP **** [Jc Th Js]
Mike_McDonald_@MikeMcDonald89: checks
DeepStack: checks
*** TURN **** [7c]
Mike_McDonald_@MikeMcDonald89: bets $300
DeepStack: calls $300
*** RIVER **** [Qd]
Mike_McDonald_@MikeMcDonald89: bets $600
DeepStack: raises $1200 to $1800
Mike_McDonald_@MikeMcDonald89: folds
Uncalled bet ($1200) returned to DeepStack
DeepStack collected $2400 from the pot
*** SUMMARY ***
Total pot $2400 | Rake $0
Board [Jc Th Js 7c Qd]
Seat 1: DeepStack (button) (small blind) collected ($2400)
Seat 2: Mike_McDonald_@MikeMcDonald89 (big blind) folded on the River

PokerStars Hand #11000000013: Tournament #1, Apr29_2017-at-11_0_39 Hold'em No Limit ($75/$150 USD) - 2017/04/29 13:00:51 ET
Table 'ACPC Match' 2-max Seat #2 is the button
Seat 1: DeepStack ($20775 in chips)
Seat 2: Mike_McDonald_@MikeMcDonald89 ($19225 in chips)
Mike_McDonald_@MikeMcDonald89: posts small blind $75
DeepStack: posts big blind $150
*** HOLE CARDS ***
Dealt to DeepStack [5c Kd]
Dealt to Mike_McDonald_@MikeMcDonald89 [Th Qs]
Mike_McDonald_@MikeMcDonald89: raises $225 to $375
DeepStack: calls $225
*** FLOP **** [5s Ah 6h]
DeepStack: checks
Mike_McDonald_@MikeMcDonald89: raises $375 to $375
DeepStack: calls $375
*** TURN **** [Qh]
DeepStack: checks
Mike_McDonald_@MikeMcDonald89: checks
*** RIVER **** [Kc]
DeepStack: bets $750
Mike_McDonald_@MikeMcDonald89: calls $750
*** SHOW DOWN ***
DeepStack: shows [5c Kd] (two pair, Kings and Fives)
Mike_McDonald_@MikeMcDonald89: shows [Th Qs] (a pair of Queens)
DeepStack collected $3000 from pot
*** SUMMARY ***
Total pot $3000 | Rake $0
Board [5s Ah 6h Qh Kc]
Seat 1: DeepStack (big blind) showed [5c Kd] and won ($3000) with two pair, Kings and Fives
Seat 2: Mike_McDonald_@MikeMcDonald89 (button) (small blind) showed [Th Qs] and lost with a pair of Queens

PokerStars Hand #11000000014: Tournament #1, Apr29_2017-at-11_0_39 Hold'em No Limit ($75/$150 USD) - 2017/04/29 13:00:52 ET
Table 'ACPC Match' 2-max Seat #1 is the button
Seat 1: DeepStack ($22275 in chips)
Seat 2: Mike_McDonald_@MikeMcDonald89 ($17725 in chips)
DeepStack: posts small blind $75
Mike_McDonald_@MikeMcDonald89: posts big blind $150
*** HOLE CARDS ***
Dealt to DeepStack [2h Th]
Dealt to Mike_McDonald_@MikeMcDonald89 [2c 6d]
DeepStack: raises $150 to $300
Mike_McDonald_@MikeMcDonald89: folds
Uncalled bet ($150) returned to DeepStack
DeepStack collected $300 from the pot
*** SUMMARY ***
Total pot $300 | Rake $0
Seat 1: DeepStack (button) (small blind) collected ($300)
Seat 2: Mike_McDonald_@MikeMcDonald89 (big blind) folded before the Flop

PokerStars Hand #11000000015: Tournament #1, Apr29_2017-at-11_0_39 Hold'em No Limit ($75/$150 USD) - 2017/04/29 13:00:53 ET
Table 'ACPC Match' 2-max Seat #2 is the button
Seat 1: DeepStack ($22425 in chips)
Seat 2: Mike_McDonald_@MikeMcDonald89 ($17575 in chips)
Mike_McDonald_@MikeMcDonald89: posts small blind $75
DeepStack: posts big blind $150
*** HOLE CARDS ***
Dealt to DeepStack [3s 3h]
Dealt to Mike_McDonald_@MikeMcDonald89 [4d Ad]
Mike_McDonald_@MikeMcDonald89: raises $225 to $375
DeepStack: raises $750 to $1125
Mike_McDonald_@MikeMcDonald89: calls $750
*** FLOP **** [4h 3c 7d]
DeepStack: bets $2250
Mike_McDonald_@MikeMcDonald89: calls $2250
*** TURN **** [8c]
DeepStack: checks
Mike_McDonald_@MikeMcDonald89: checks
*** RIVER **** [Qd]
DeepStack: checks
Mike_McDonald_@MikeMcDonald89: checks
*** SHOW DOWN ***
DeepStack: shows [3s 3h] (three of a kind, Threes)
Mike_McDonald_@MikeMcDonald89: shows [4d Ad] (a pair of Fours)
DeepStack collected $6750 from pot
*** SUMMARY ***
Total pot $6750 | Rake $0
Board [4h 3c 7d 8c Qd]
Seat 1: DeepStack (big blind) showed [3s 3h] and won ($6750) with three of a kind, Threes
Seat 2: Mike_McDonald_@MikeMcDonald89 (button) (small blind) showed [4d Ad] and lost with a pair of Fours

PokerStars Hand #11000000016: Tournament #1, Apr29_2017-at-11_0_39 Hold'em No Limit ($75/$150 USD) - 2017/04/29 13:00:54 ET
Table 'ACPC Match' 2-max Seat #1 is the button
Seat 1: DeepStack ($25800 in chips)
Seat 2: Mike_McDonald_@MikeMcDonald89 ($14200 in chips)
DeepStack: posts small blind $75
Mike_McDonald_@MikeMcDonald89: posts big blind $150
*** HOLE CARDS ***
Dealt to DeepStack [6d 9s]
Dealt to Mike_McDonald_@MikeMcDonald89 [Kh Jd]
DeepStack: raises $300 to $450
Mike_McDonald_@MikeMcDonald89: calls $300
*** FLOP **** [3d Td 8c]
Mike_McDonald_@MikeMcDonald89: checks
DeepStack: raises $900 to $900
Mike_McDonald_@MikeMcDonald89: folds
Uncalled bet ($900) returned to DeepStack
DeepStack collected $900 from the pot
*** SUMMARY ***
Total pot $900 | Rake $0
Board [3d Td 8c]
Seat 1: DeepStack (button) (small blind) collected ($900)
Seat 2: Mike_McDonald_@MikeMcDonald89 (big blind) folded on the Flop

PokerStars Hand #11000000017: Tournament #1, Apr29_2017-at-11_0_39 Hold'em No Limit ($75/$150 USD) - 2017/04/29 13:00:55 ET
Table 'ACPC Match' 2-max Seat #2 is the button
Seat 1: DeepStack ($26250 in chips)
Seat 2: Mike_McDonald_@MikeMcDonald89 ($13750 in chips)
Mike_McDonald_@MikeMcDonald89: posts small blind $75
DeepStack: posts big blind $150
*** HOLE CARDS ***
Dealt to DeepStack [Jc 3s]
Dealt to Mike_McDonald_@MikeMcDonald89 [Th Js]
Mike_McDonald_@MikeMcDonald89: raises $225 to $375
DeepStack: folds
Uncalled bet ($225) returned to Mike_McDonald_@MikeMcDonald89
Mike_McDonald_@MikeMcDonald89 collected $300 from the pot
*** SUMMARY ***
Total pot $300 | Rake $0
Seat 1: DeepStack (big blind) folded before the Flop
Seat 2: Mike_McDonald_@MikeMcDonald89 (button) (small blind) collected ($300)

PokerStars Hand #11000000018: Tournament #1, Apr29_2017-at-11_0_39 Hold'em No Limit ($75/$150 USD) - 2017/04/29 13:00:56 ET
Table 'ACPC Match' 2-max Seat #1 is the button
Seat 1: DeepStack ($26100 in chips)
Seat 2: Mike_McDonald_@MikeMcDonald89 ($13900 in chips)
DeepStack: posts small blind $75
Mike_McDonald_@MikeMcDonald89: posts big blind $150
*** HOLE CARDS ***
Dealt to DeepStack [5s 9d]
Dealt to Mike_McDonald_@MikeMcDonald89 [5h 4d]
DeepStack: calls $75
Mike_McDonald_@MikeMcDonald89: checks
*** FLOP **** [3d 7s Qs]
Mike_McDonald_@MikeMcDonald89: checks
DeepStack: raises $300 to $300
Mike_McDonald_@MikeMcDonald89: folds
Uncalled bet ($300) returned to DeepStack
DeepStack collected $300 from the pot
*** SUMMARY ***
Total pot $300 | Rake $0
Board [3d 7s Qs]
Seat 1: DeepStack (button) (small blind) collected ($300)
Seat 2: Mike_McDonald_@MikeMcDonald89 (big blind) folded on the Flop

PokerStars Hand #11000000019: Tournament #1, Apr29_2017-at-11_0_39 Hold'em No Limit ($75/$150 USD) - 2017/04/29 13:00:57 ET
Table 'ACPC Match' 2-max Seat #2 is the button
Seat 1: DeepStack ($26250 in chips)
Seat 2: Mike_McDonald_@MikeMcDonald89 ($13750 in chips)
Mike_McDonald_@MikeMcDonald89: posts small blind $75
DeepStack: posts big blind $150
*** HOLE CARDS ***
Dealt to DeepStack [Kc Ts]
Dealt to Mike_McDonald_@MikeMcDonald89 [Kd Td]
Mike_McDonald_@MikeMcDonald89: raises $225 to $375
DeepStack: raises $750 to $1125
Mike_McDonald_@MikeMcDonald89: calls $750
*** FLOP **** [7s 9s Ks]
DeepStack: checks
Mike_McDonald_@MikeMcDonald89: checks
*** TURN **** [3s]
DeepStack: checks
Mike_McDonald_@MikeMcDonald89: checks
*** RIVER **** [Ad]
DeepStack: checks
Mike_McDonald_@MikeMcDonald89: checks
*** SHOW DOWN ***
DeepStack: shows [Kc Ts] (flush, King high)
Mike_McDonald_@MikeMcDonald89: shows [Kd Td] (a pair of Kings)
DeepStack collected $2250 from pot
*** SUMMARY ***
Total pot $2250 | Rake $0
Board [7s 9s Ks 3s Ad]
Seat 1: DeepStack (big blind) showed [Kc Ts] and won ($2250) with flush, King high
Seat 2: Mike_McDonald_@MikeMcDonald89 (button) (small blind) showed [Kd Td] and lost with a pair of Kings

PokerStars Hand #11000000020: Tournament #1, Apr29_2017-at-11_0_39 Hold'em No Limit ($75/$150 USD) - 2017/04/29 13:00:58 ET
Table 'ACPC Match' 2-max Seat #1 is the button
Seat 1: DeepStack ($27375 in chips)
Seat 2: Mike_McDonald_@MikeMcDonald89 ($12625 in chips)
DeepStack: posts small blind $75
Mike_McDonald_@MikeMcDonald89: posts big blind $150
*** HOLE CARDS ***
Dealt to DeepStack [Qs 4s]
Dealt to Mike_McDonald_@MikeMcDonald89 [5h Jc]
DeepStack: calls $75
Mike_McDonald_@MikeMcDonald89: checks
*** FLOP **** [6s 7c Kc]
Mike_McDonald_@MikeMcDonald89: checks
DeepStack: checks
*** TURN **** [2c]
Mike_McDonald_@MikeMcDonald89: bets $225
DeepStack: folds
Uncalled bet ($225) returned to Mike_McDonald_@MikeMcDonald89
Mike_McDonald_@MikeMcDonald89 collected $300 from the pot
*** SUMMARY ***
Total pot $300 | Rake $0
Board [6s 7c Kc 2c]
Seat 1: DeepStack (button) (small blind) folded on the Turn
Seat 2: Mike_McDonald_@MikeMcDonald89 (big blind) collected ($300)

PokerStars Hand #11000000021: Tournament #1, Apr29_2017-at-11_0_39 Hold'em No Limit ($100/$200 USD) - 2017/04/29 13:00:59 ET
Table 'ACPC Match' 2-max Seat #2 is the button
Seat 1: DeepStack ($27225 in chips)
Seat 2: Mike_McDonald_@MikeMcDonald89 ($12775 in chips)
Mike_McDonald_@MikeMcDonald89: posts small blind $100
DeepStack: posts big blind $200
*** HOLE CARDS ***
Dealt to DeepStack [Kh 7s]
Dealt to Mike_McDonald_@MikeMcDonald89 [9d Jd]
Mike_McDonald_@MikeMcDonald89: raises $300 to $500
DeepStack: raises $1000 to $1500
Mike_McDonald_@MikeMcDonald89: calls $1000
*** FLOP **** [3d 6h Th]
DeepStack: bets $1499
Mike_McDonald_@MikeMcDonald89: folds
Uncalled bet ($1499) returned to DeepStack
DeepStack collected $3000 from the pot
*** SUMMARY ***
Total pot $3000 | Rake $0
Board [3d 6h Th]
Seat 1: DeepStack (big blind) collected ($3000)
Seat 2: Mike_McDonald_@MikeMcDonald89 (button) (small blind) folded on the Flop

PokerStars Hand #11000000022: Tournament #1, Apr29_2017-at-11_0_39 Hold'em No Limit ($100/$200 USD) - 2017/04/29 13:01:00 ET
Table 'ACPC Match' 2-max Seat #1 is the button
Seat 1: DeepStack ($28725 in chips)
Seat 2: Mike_McDonald_@MikeMcDonald89 ($11275 in chips)
DeepStack: posts small blind $100
Mike_McDonald_@MikeMcDonald89: posts big blind $200
*** HOLE CARDS ***
Dealt to DeepStack [3c 6h]
Dealt to Mike_McDonald_@MikeMcDonald89 [Jh Js]
DeepStack: calls $100
Mike_McDonald_@MikeMcDonald89: raises $500 to $700
DeepStack: folds
Uncalled bet ($500) returned to Mike_McDonald_@MikeMcDonald89
Mike_McDonald_@MikeMcDonald89 collected $400 from the pot
*** SUMMARY ***
Total pot $400 | Rake $0
Seat 1: DeepStack (button) (small blind) folded before the Flop
Seat 2: Mike_McDonald_@MikeMcDonald89 (big blind) collected ($400)

PokerStars Hand #11000000023: Tournament #1, Apr29_2017-at-11_0_39 Hold'em No Limit ($100/$200 USD) - 2017/04/29 13:01:01 ET
Table 'ACPC Match' 2-max Seat #2 is the button
Seat 1: DeepStack ($28525 in chips)
Seat 2: Mike_McDonald_@MikeMcDonald89 ($11475 in chips)
Mike_McDonald_@MikeMcDonald89: posts small blind $100
DeepStack: posts big blind $200
*** HOLE CARDS ***
Dealt to DeepStack [Ac 8d]
Dealt to Mike_McDonald_@MikeMcDonald89 [2c 9h]
Mike_McDonald_@MikeMcDonald89: folds
Uncalled bet ($100) returned to DeepStack
DeepStack collected $200 from the pot
*** SUMMARY ***
Total pot $200 | Rake $0
Seat 1: DeepStack (big blind) collected ($200)
Seat 2: Mike_McDonald_@MikeMcDonald89 (button) (small blind) folded before the Flop

PokerStars Hand #11000000024: Tournament #1, Apr29_2017-at-11_0_39 Hold'em No Limit ($100/$200 USD) - 2017/04/29 13:01:02 ET
Table 'ACPC Match' 2-max Seat #1 is the button
Seat 1: DeepStack ($28625 in chips)
Seat 2: Mike_McDonald_@MikeMcDonald89 ($11375 in chips)
DeepStack: posts small blind $100
Mike_McDonald_@MikeMcDonald89: posts big blind $200
*** HOLE CARDS ***
Dealt to DeepStack [Kh 8c]
Dealt to Mike_McDonald_@MikeMcDonald89 [6h 9c]
DeepStack: raises $400 to $600
Mike_McDonald_@MikeMcDonald89: folds
Uncalled bet ($400) returned to DeepStack
DeepStack collected $400 from the pot
*** SUMMARY ***
Total pot $400 | Rake $0
Seat 1: DeepStack (button) (small blind) collected ($400)
Seat 2: Mike_McDonald_@MikeMcDonald89 (big blind) folded before the Flop

PokerStars Hand #11000000025: Tournament #1, Apr29_2017-at-11_0_39 Hold'em No Limit ($100/$200 USD) - 2017/04/29 13:01:03 ET
Table 'ACPC Match' 2-max Seat #2 is the button
Seat 1: DeepStack ($28825 in chips)
Seat 2: Mike_McDonald_@MikeMcDonald89 ($11175 in chips)
Mike_McDonald_@MikeMcDonald89: posts small blind $100
DeepStack: posts big blind $200
*** HOLE CARDS ***
Dealt to DeepStack [4c 3s]
Dealt to Mike_McDonald_@MikeMcDonald89 [6d Qh]
Mike_McDonald_@MikeMcDonald89: raises $300 to $500
DeepStack: folds
Uncalled bet ($300) returned to Mike_McDonald_@MikeMcDonald89
Mike_McDonald_@MikeMcDonald89 collected $400 from the pot
*** SUMMARY ***
Total pot $400 | Rake $0
Seat 1: DeepStack (big blind) folded before the Flop
Seat 2: Mike_McDonald_@MikeMcDonald89 (button) (small blind) collected ($400)

PokerStars Hand #11000000026: Tournament #1, Apr29_2017-at-11_0_39 Hold'em No Limit ($100/$200 USD) - 2017/04/29 13:01:04 ET
Table 'ACPC Match' 2-max Seat #1 is the button
Seat 1: DeepStack ($28625 in chips)
Seat 2: Mike_McDonald_@MikeMcDonald89 ($11375 in chips)
DeepStack: posts small blind $100
Mike_McDonald_@MikeMcDonald89: posts big blind $200
*** HOLE CARDS ***
Dealt to DeepStack [7h 4d]
Dealt to Mike_McDonald_@MikeMcDonald89 [Ts 9h]
DeepStack: calls $100
Mike_McDonald_@MikeMcDonald89: checks
*** FLOP **** [Tc 7c 9s]
Mike_McDonald_@MikeMcDonald89: checks
DeepStack: checks
*** TURN **** [Jh]
Mike_McDonald_@MikeMcDonald89: checks
DeepStack: checks
*** RIVER **** [6h]
Mike_McDonald_@MikeMcDonald89: bets $600
DeepStack: folds
Uncalled bet ($600) returned to Mike_McDonald_@MikeMcDonald89
Mike_McDonald_@MikeMcDonald89 collected $400 from the pot
*** SUMMARY ***
Total pot $400 | Rake $0
Board [Tc 7c 9s Jh 6h]
Seat 1: DeepStack (button) (small blind) folded on the River
Seat 2: Mike_McDonald_@MikeMcDonald89 (big blind) collected ($400)

PokerStars Hand #11000000027: Tournament #1, Apr29_2017-at-11_0_39 Hold'em No Limit ($100/$200 USD) - 2017/04/29 13:01:05 ET
Table 'ACPC Match' 2-max Seat #2 is the button
Seat 1: DeepStack ($28425 in chips)
Seat 2: Mike_McDonald_@MikeMcDonald89 ($11575 in chips)
Mike_McDonald_@MikeMcDonald89: posts small blind $100
DeepStack: posts big blind $200
*** HOLE CARDS ***
Dealt to DeepStack [4c 9h]
Dealt to Mike_McDonald_@MikeMcDonald89 [7h Kd]
Mike_McDonald_@MikeMcDonald89: raises $300 to $500
DeepStack: folds
Uncalled bet ($300) returned to Mike_McDonald_@MikeMcDonald89
Mike_McDonald_@MikeMcDonald89 collected $400 from the pot
*** SUMMARY ***
Total pot $400 | Rake $0
Seat 1: DeepStack (big blind) folded before the Flop
Seat 2: Mike_McDonald_@MikeMcDonald89 (button) (small blind) collected ($400)

PokerStars Hand #11000000028: Tournament #1, Apr29_2017-at-11_0_39 Hold'em No Limit ($100/$200 USD) - 2017/04/29 13:01:06 ET
Table 'ACPC Match' 2-max Seat #1 is the button
Seat 1: DeepStack ($28225 in chips)
Seat 2: Mike_McDonald_@MikeMcDonald89 ($11775 in chips)
DeepStack: posts small blind $100
Mike_McDonald_@MikeMcDonald89: posts big blind $200
*** HOLE CARDS ***
Dealt to DeepStack [3h 3c]
Dealt to Mike_McDonald_@MikeMcDonald89 [Ah 4s]
DeepStack: raises $200 to $400
Mike_McDonald_@MikeMcDonald89: calls $200
*** FLOP **** [9c 2s Qd]
Mike_McDonald_@MikeMcDonald89: checks
DeepStack: raises $400 to $400
Mike_McDonald_@MikeMcDonald89: calls $400
*** TURN **** [7c]
Mike_McDonald_@MikeMcDonald89: checks
DeepStack: checks
*** RIVER **** [Ac]
Mike_McDonald_@MikeMcDonald89: checks
DeepStack: checks
*** SHOW DOWN ***
Mike_McDonald_@MikeMcDonald89: shows [Ah 4s] (a pair of Aces)
DeepStack: shows [3h 3c] (a pair of Threes)
Mike_McDonald_@MikeMcDonald89 collected $1600 from pot
*** SUMMARY ***
Total pot $1600 | Rake $0
Board [9c 2s Qd 7c Ac]
Seat 1: DeepStack (button) (small blind) showed [3h 3c] and lost with a pair of Threes
Seat 2: Mike_McDonald_@MikeMcDonald89 (big blind) showed [Ah 4s] and won ($1600) with a pair of Aces

PokerStars Hand #11000000029: Tournament #1, Apr29_2017-at-11_0_39 Hold'em No Limit ($100/$200 USD) - 2017/04/29 13:01:07 ET
Table 'ACPC Match' 2-max Seat #2 is the button
Seat 1: DeepStack ($27425 in chips)
Seat 2: Mike_McDonald_@MikeMcDonald89 ($12575 in chips)
Mike_McDonald_@MikeMcDonald89: posts small blind $100
DeepStack: posts big blind $200
*** HOLE CARDS ***
Dealt to DeepStack [9h 2d]
Dealt to Mike_McDonald_@MikeMcDonald89 [7h 8c]
Mike_McDonald_@MikeMcDonald89: raises $300 to $500
DeepStack: folds
Uncalled bet ($300) returned to Mike_McDonald_@MikeMcDonald89
Mike_McDonald_@MikeMcDonald89 collected $400 from the pot
*** SUMMARY ***
Total pot $400 | Rake $0
Seat 1: DeepStack (big blind) folded before the Flop
Seat 2: Mike_McDonald_@MikeMcDonald89 (button) (small blind) collected ($400)

PokerStars Hand #11000000030: Tournament #1, Apr29_2017-at-11_0_39 Hold'em No Limit ($100/$200 USD) - 2017/04/29 13:01:08 ET
Table 'ACPC Match' 2-max Seat #1 is the button
Seat 1: DeepStack ($27225 in chips)
Seat 2: Mike_McDonald_@MikeMcDonald89 ($12775 in chips)
DeepStack: posts small blind $100
Mike_McDonald_@MikeMcDonald89: posts big blind $200
*** HOLE CARDS ***
Dealt to DeepStack [7c Th]
Dealt to Mike_McDonald_@MikeMcDonald89 [7h Kc]
DeepStack: raises $200 to $400
Mike_McDonald_@MikeMcDonald89: calls $200
*** FLOP **** [8h Jd 2d]
Mike_McDonald_@MikeMcDonald89: checks
DeepStack: checks
*** TURN **** [3d]
Mike_McDonald_@MikeMcDonald89: checks
DeepStack: raises $400 to $400
Mike_McDonald_@MikeMcDonald89: folds
Uncalled bet ($400) returned to DeepStack
DeepStack collected $800 from the pot
*** SUMMARY ***
Total pot $800 | Rake $0
Board [8h Jd 2d 3d]
Seat 1: DeepStack (button) (small blind) collected ($800)
Seat 2: Mike_McDonald_@MikeMcDonald89 (big blind) folded on the Turn

PokerStars Hand #11000000031: Tournament #1, Apr29_2017-at-11_0_39 Hold'em No Limit ($150/$300 USD) - 2017/04/29 13:01:09 ET
Table 'ACPC Match' 2-max Seat #2 is the button
Seat 1: DeepStack ($27625 in chips)
Seat 2: Mike_McDonald_@MikeMcDonald89 ($12375 in chips)
Mike_McDonald_@MikeMcDonald89: posts small blind $150
DeepStack: posts big blind $300
*** HOLE CARDS ***
Dealt to DeepStack [Kc Jc]
Dealt to Mike_McDonald_@MikeMcDonald89 [5c 8d]
Mike_McDonald_@MikeMcDonald89: raises $450 to $750
DeepStack: raises $750 to $1500
Mike_McDonald_@MikeMcDonald89: folds
Uncalled bet ($750) returned to DeepStack
DeepStack collected $1500 from the pot
*** SUMMARY ***
Total pot $1500 | Rake $0
Seat 1: DeepStack (big blind) collected ($1500)
Seat 2: Mike_McDonald_@MikeMcDonald89 (button) (small blind) folded before the Flop

PokerStars Hand #11000000032: Tournament #1, Apr29_2017-at-11_0_39 Hold'em No Limit ($150/$300 USD) - 2017/04/29 13:01:10 ET
Table 'ACPC Match' 2-max Seat #1 is the button
Seat 1: DeepStack ($28375 in chips)
Seat 2: Mike_McDonald_@MikeMcDonald89 ($11625 in chips)
DeepStack: posts small blind $150
Mike_McDonald_@MikeMcDonald89: posts big blind $300
*** HOLE CARDS ***
Dealt to DeepStack [Kd 2d]
Dealt to Mike_McDonald_@MikeMcDonald89 [Qc 9c]
DeepStack: raises $300 to $600
Mike_McDonald_@MikeMcDonald89: calls $300
*** FLOP **** [8c Js 8d]
Mike_McDonald_@MikeMcDonald89: checks
DeepStack: raises $600 to $600
Mike_McDonald_@MikeMcDonald89: calls $600
*** TURN **** [Ad]
Mike_McDonald_@MikeMcDonald89: checks
DeepStack: raises $2400 to $2400
Mike_McDonald_@MikeMcDonald89: folds
Uncalled bet ($2400) returned to DeepStack
DeepStack collected $2400 from the pot
*** SUMMARY ***
Total pot $2400 | Rake $0
Board [8c Js 8d Ad]
Seat 1: DeepStack (button) (small blind) collected ($2400)
Seat 2: Mike_McDonald_@MikeMcDonald89 (big blind) folded on the Turn

PokerStars Hand #11000000033: Tournament #1, Apr29_2017-at-11_0_39 Hold'em No Limit ($150/$300 USD) - 2017/04/29 13:01:11 ET
Table 'ACPC Match' 2-max Seat #2 is the button
Seat 1: DeepStack ($29575 in chips)
Seat 2: Mike_McDonald_@MikeMcDonald89 ($10425 in chips)
Mike_McDonald_@MikeMcDonald89: posts small blind $150
DeepStack: posts big blind $300
*** HOLE CARDS ***
Dealt to DeepStack [8h 2h]
Dealt to Mike_McDonald_@MikeMcDonald89 [6h Kc]
Mike_McDonald_@MikeMcDonald89: raises $450 to $750
DeepStack: calls $450
*** FLOP **** [6d Kd Kh]
DeepStack: checks
Mike_McDonald_@MikeMcDonald89: checks
*** TURN **** [2s]
DeepStack: bets $750
Mike_McDonald_@MikeMcDonald89: calls $750
*** RIVER **** [4s]
DeepStack: checks
Mike_McDonald_@MikeMcDonald89: raises $1500 to $1500
DeepStack: folds
Uncalled bet ($1500) returned to Mike_McDonald_@MikeMcDonald89
Mike_McDonald_@MikeMcDonald89 collected $3000 from the pot
*** SUMMARY ***
Total pot $3000 | Rake $0
Board [6d Kd Kh 2s 4s]
Seat 1: DeepStack (big blind) folded on the River
Seat 2: Mike_McDonald_@MikeMcDonald89 (button) (small blind) collected ($3000)

PokerStars Hand #11000000034: Tournament #1, Apr29_2017-at-11_0_39 Hold'em No Limit ($150/$300 USD) - 2017/04/29 13:01:12 ET
Table 'ACPC Match' 2-max Seat #1 is the button
Seat 1: DeepStack ($28075 in chips)
Seat 2: Mike_McDonald_@MikeMcDonald89 ($11925 in chips)
DeepStack: posts small blind $150
Mike_McDonald_@MikeMcDonald89: posts big blind $300
*** HOLE CARDS ***
Dealt to DeepStack [Tc 3s]
Dealt to Mike_McDonald_@MikeMcDonald89 [Ac Jc]
DeepStack: calls $150
Mike_McDonald_@MikeMcDonald89: raises $500 to $800
DeepStack: folds
Uncalled bet ($500) returned to Mike_McDonald_@MikeMcDonald89
Mike_McDonald_@MikeMcDonald89 collected $600 from the pot
*** SUMMARY ***
Total pot $600 | Rake $0
Seat 1: DeepStack (button) (small blind) folded before the Flop
Seat 2: Mike_McDonald_@MikeMcDonald89 (big blind) collected ($600)

PokerStars Hand #11000000035: Tournament #1, Apr29_2017-at-11_0_39 Hold'em No Limit ($150/$300 USD) - 2017/04/29 13:01:13 ET
Table 'ACPC Match' 2-max Seat #2 is the button
Seat 1: DeepStack ($27775 in chips)
Seat 2: Mike_McDonald_@MikeMcDonald89 ($12225 in chips)
Mike_McDonald_@MikeMcDonald89: posts small blind $150
DeepStack: posts big blind $300
*** HOLE CARDS ***
Dealt to DeepStack [Qs Th]
Dealt to Mike_McDonald_@MikeMcDonald89 [Tc Ks]
Mike_McDonald_@MikeMcDonald89: raises $450 to $750
DeepStack: calls $450
*** FLOP **** [6s Td Ac]
DeepStack: checks
Mike_McDonald_@MikeMcDonald89: checks
*** TURN **** [3d]
DeepStack: checks
Mike_McDonald_@MikeMcDonald89: raises $750 to $750
DeepStack: calls $750
*** RIVER **** [9c]
DeepStack: checks
Mike_McDonald_@MikeMcDonald89: raises $1500 to $1500
DeepStack: calls $1500
*** SHOW DOWN ***
Mike_McDonald_@MikeMcDonald89: shows [Tc Ks] (a pair of Tens)
DeepStack: shows [Qs Th] (a pair of Tens)
Mike_McDonald_@MikeMcDonald89 collected $6000 from pot
*** SUMMARY ***
Total pot $6000 | Rake $0
Board [6s Td Ac 3d 9c]
Seat 1: DeepStack (big blind) showed [Qs Th] and lost with a pair of Tens
Seat 2: Mike_McDonald_@MikeMcDonald89 (button) (small blind) showed [Tc Ks] and won ($6000) with a pair of Tens

PokerStars Hand #11000000036: Tournament #1, Apr29_2017-at-11_0_39 Hold'em No Limit ($150/$300 USD) - 2017/04/29 13:01:14 ET
Table 'ACPC Match' 2-max Seat #1 is the button
Seat 1: DeepStack ($24775 in chips)
Seat 2: Mike_McDonald_@MikeMcDonald89 ($15225 in chips)
DeepStack: posts small blind $150
Mike_McDonald_@MikeMcDonald89: posts big blind $300
*** HOLE CARDS ***
Dealt to DeepStack [9c Kh]
Dealt to Mike_McDonald_@MikeMcDonald89 [5d Js]
DeepStack: raises $300 to $600
Mike_McDonald_@MikeMcDonald89: calls $300
*** FLOP **** [5h 3c 5c]
Mike_McDonald_@MikeMcDonald89: checks
DeepStack: checks
*** TURN **** [Qc]
Mike_McDonald_@MikeMcDonald89: bets $600
DeepStack: calls $600
*** RIVER **** [2h]
Mike_McDonald_@MikeMcDonald89: bets $1800
DeepStack: folds
Uncalled bet ($1800) returned to Mike_McDonald_@MikeMcDonald89
Mike_McDonald_@MikeMcDonald89 collected $2400 from the pot
*** SUMMARY ***
Total pot $2400 | Rake $0
Board [5h 3c 5c Qc 2h]
Seat 1: DeepStack (button) (small blind) folded on the River
Seat 2: Mike_McDonald_@MikeMcDonald89 (big blind) collected ($2400)

PokerStars Hand #11000000037: Tournament #1, Apr29_2017-at-11_0_39 Hold'em No Limit ($150/$300 USD) - 2017/04/29 13:01:15 ET
Table 'ACPC Match' 2-max Seat #2 is the button
Seat 1: DeepStack ($23575 in chips)
Seat 2: Mike_McDonald_@MikeMcDonald89 ($16425 in chips)
Mike_McDonald_@MikeMcDonald89: posts small blind $150
DeepStack: posts big blind $300
*** HOLE CARDS ***
Dealt to DeepStack [2s 6d]
Dealt to Mike_McDonald_@MikeMcDonald89 [Kh 9s]
Mike_McDonald_@MikeMcDonald89: raises $450 to $750
DeepStack: folds
Uncalled bet ($450) returned to Mike_McDonald_@MikeMcDonald89
Mike_McDonald_@MikeMcDonald89 collected $600 from the pot
*** SUMMARY ***
Total pot $600 | Rake $0
Seat 1: DeepStack (big blind) folded before the Flop
Seat 2: Mike_McDonald_@MikeMcDonald89 (button) (small blind) collected ($600)

PokerStars Hand #11000000038: Tournament #1, Apr29_2017-at-11_0_39 Hold'em No Limit ($150/$300 USD) - 2017/04/29 13:01:16 ET
Table 'ACPC Match' 2-max Seat #1 is the button
Seat 1: DeepStack ($23275 in chips)
Seat 2: Mike_McDonald_@MikeMcDonald89 ($16725 in chips)
DeepStack: posts small blind $150
Mike_McDonald_@MikeMcDonald89: posts big blind $300
*** HOLE CARDS ***
Dealt to DeepStack [7c Ad]
Dealt to Mike_McDonald_@MikeMcDonald89 [8s 3d]
DeepStack: calls $150
Mike_McDonald_@MikeMcDonald89: raises $500 to $800
DeepStack: calls $500
*** FLOP **** [9s 5d 8h]
Mike_McDonald_@MikeMcDonald89: checks
DeepStack: raises $1600 to $1600
Mike_McDonald_@MikeMcDonald89: calls $1600
*** TURN **** [Qh]
Mike_McDonald_@MikeMcDonald89: checks
DeepStack: checks
*** RIVER **** [Kd]
Mike_McDonald_@MikeMcDonald89: checks
DeepStack: checks
*** SHOW DOWN ***
Mike_McDonald_@MikeMcDonald89: shows [8s 3d] (a pair of Eights)
DeepStack: shows [7c Ad] (Ace high)
Mike_McDonald_@MikeMcDonald89 collected $4800 from pot
*** SUMMARY ***
Total pot $4800 | Rake $0
Board [9s 5d 8h Qh Kd]
Seat 1: DeepStack (button) (small blind) showed [7c Ad] and lost with Ace high
Seat 2: Mike_McDonald_@MikeMcDonald89 (big blind) showed [8s 3d] and won ($4800) with a pair of Eights

PokerStars Hand #11000000039: Tournament #1, Apr29_2017-at-11_0_39 Hold'em No Limit ($150/$300 USD) - 2017/04/29 13:01:17 ET
Table 'ACPC Match' 2-max Seat #2 is the button
Seat 1: DeepStack ($20875 in chips)
Seat 2: Mike_McDonald_@MikeMcDonald89 ($19125 in chips)
Mike_McDonald_@MikeMcDonald89: posts small blind $150
DeepStack: posts big blind $300
*** HOLE CARDS ***
Dealt to DeepStack [7c Ts]
Dealt to Mike_McDonald_@MikeMcDonald89 [6c 7d]
Mike_McDonald_@MikeMcDonald89: raises $450 to $750
DeepStack: calls $450
*** FLOP **** [Qc 8s 5d]
DeepStack: checks
Mike_McDonald_@MikeMcDonald89: raises $750 to $750
DeepStack: folds
Uncalled bet ($750) returned to Mike_McDonald_@MikeMcDonald89
Mike_McDonald_@MikeMcDonald89 collected $1500 from the pot
*** SUMMARY ***
Total pot $1500 | Rake $0
Board [Qc 8s 5d]
Seat 1: DeepStack (big blind) folded on the Flop
Seat 2: Mike_McDonald_@MikeMcDonald89 (button) (small blind) collected ($1500)

PokerStars Hand #11000000040: Tournament #1, Apr29_2017-at-11_0_39 Hold'em No Limit ($150/$300 USD) - 2017/04/29 13:01:18 ET
Table 'ACPC Match' 2-max Seat #1 is the button
Seat 1: DeepStack ($20125 in chips)
Seat 2: Mike_McDonald_@MikeMcDonald89 ($19875 in chips)
DeepStack: posts small blind $150
Mike_McDonald_@MikeMcDonald89: posts big blind $300
*** HOLE CARDS ***
Dealt to DeepStack [Qh 2h]
Dealt to Mike_McDonald_@MikeMcDonald89 [2c 5d]
DeepStack: raises $300 to $600
Mike_McDonald_@MikeMcDonald89: folds
Uncalled bet ($300) returned to DeepStack
DeepStack collected $600 from the pot
*** SUMMARY ***
Total pot $600 | Rake $0
Seat 1: DeepStack (button) (small blind) collected ($600)
Seat 2: Mike_McDonald_@MikeMcDonald89 (big blind) folded before the Flop

PokerStars Hand #11000000041: Tournament #1, Apr29_2017-at-11_0_39 Hold'em No Limit ($200/$400 USD) - 2017/04/29 13:01:19 ET
Table 'ACPC Match' 2-max Seat #2 is the button
Seat 1: DeepStack ($20425 in chips)
Seat 2: Mike_McDonald_@MikeMcDonald89 ($19575 in chips)
Mike_McDonald_@MikeMcDonald89: posts small blind $200
DeepStack: posts big blind $400
*** HOLE CARDS ***
Dealt to DeepStack [7d 6s]
Dealt to Mike_McDonald_@MikeMcDonald89 [4d 2h]
Mike_McDonald_@MikeMcDonald89: folds
Uncalled bet ($200) returned to DeepStack
DeepStack collected $400 from the pot
*** SUMMARY ***
Total pot $400 | Rake $0
Seat 1: DeepStack (big blind) collected ($400)
Seat 2: Mike_McDonald_@MikeMcDonald89 (button) (small blind) folded before the Flop

PokerStars Hand #11000000042: Tournament #1, Apr29_2017-at-11_0_39 Hold'em No Limit ($200/$400 USD) - 2017/04/29 13:01:20 ET
Table 'ACPC Match' 2-max Seat #1 is the button
Seat 1: DeepStack ($20625 in chips)
Seat 2: Mike_McDonald_@MikeMcDonald89 ($19375 in chips)
DeepStack: posts small blind $200
Mike_McDonald_@MikeMcDonald89: posts big blind $400
*** HOLE CARDS ***
Dealt to DeepStack [Ts 8d]
Dealt to Mike_McDonald_@MikeMcDonald89 [8h 3d]
DeepStack: raises $400 to $800
Mike_McDonald_@MikeMcDonald89: folds
Uncalled bet ($400) returned to DeepStack
DeepStack collected $800 from the pot
*** SUMMARY ***
Total pot $800 | Rake $0
Seat 1: DeepStack (button) (small blind) collected ($800)
Seat 2: Mike_McDonald_@MikeMcDonald89 (big blind) folded before the Flop

PokerStars Hand #11000000043: Tournament #1, Apr29_2017-at-11_0_39 Hold'em No Limit ($200/$400 USD) - 2017/04/29 13:01:21 ET
Table 'ACPC Match' 2-max Seat #2 is the button
Seat 1: DeepStack ($21025 in chips)
Seat 2: Mike_McDonald_@MikeMcDonald89 ($18975 in chips)
Mike_McDonald_@MikeMcDonald89: posts small blind $200
DeepStack: posts big blind $400
*** HOLE CARDS ***
Dealt to DeepStack [3s Qs]
Dealt to Mike_McDonald_@MikeMcDonald89 [4h 2d]
Mike_McDonald_@MikeMcDonald89: folds
Uncalled bet ($200) returned to DeepStack
DeepStack collected $400 from the pot
*** SUMMARY ***
Total pot $400 | Rake $0
Seat 1: DeepStack (big blind) collected ($400)
Seat 2: Mike_McDonald_@MikeMcDonald89 (button) (small blind) folded before the Flop

PokerStars Hand #11000000044: Tournament #1, Apr29_2017-at-11_0_39 Hold'em No Limit ($200/$400 USD) - 2017/04/29 13:01:22 ET
Table 'ACPC Match' 2-max Seat #1 is the button
Seat 1: DeepStack ($21225 in chips)
Seat 2: Mike_McDonald_@MikeMcDonald89 ($18775 in chips)
DeepStack: posts small blind $200
Mike_McDonald_@MikeMcDonald89: posts big blind $400
*** HOLE CARDS ***
Dealt to DeepStack [3c 8c]
Dealt to Mike_McDonald_@MikeMcDonald89 [Ad Jh]
DeepStack: raises $800 to $1200
Mike_McDonald_@MikeMcDonald89: raises $2400 to $3600
DeepStack: folds
Uncalled bet ($2400) returned to Mike_McDonald_@MikeMcDonald89
Mike_McDonald_@MikeMcDonald89 collected $2400 from the pot
*** SUMMARY ***
Total pot $2400 | Rake $0
Seat 1: DeepStack (button) (small blind) folded before the Flop
Seat 2: Mike_McDonald_@MikeMcDonald89 (big blind) collected ($2400)

PokerStars Hand #11000000045: Tournament #1, Apr29_2017-at-11_0_39 Hold'em No Limit ($200/$400 USD) - 2017/04/29 13:01:23 ET
Table 'ACPC Match' 2-max Seat #2 is the button
Seat 1: DeepStack ($20025 in chips)
Seat 2: Mike_McDonald_@MikeMcDonald89 ($19975 in chips)
Mike_McDonald_@MikeMcDonald89: posts small blind $200
DeepStack: posts big blind $400
*** HOLE CARDS ***
Dealt to DeepStack [Js 2h]
Dealt to Mike_McDonald_@MikeMcDonald89 [4h 5s]
Mike_McDonald_@MikeMcDonald89: raises $600 to $1000
DeepStack: folds
Uncalled bet ($600) returned to Mike_McDonald_@MikeMcDonald89
Mike_McDonald_@MikeMcDonald89 collected $800 from the pot
*** SUMMARY ***
Total pot $800 | Rake $0
Seat 1: DeepStack (big blind) folded before the Flop
Seat 2: Mike_McDonald_@MikeMcDonald89 (button) (small blind) collected ($800)

PokerStars Hand #11000000046: Tournament #1, Apr29_2017-at-11_0_39 Hold'em No Limit ($200/$400 USD) - 2017/04/29 13:01:24 ET
Table 'ACPC Match' 2-max Seat #1 is the button
Seat 1: DeepStack ($19625 in chips)
Seat 2: Mike_McDonald_@MikeMcDonald89 ($20375 in chips)
DeepStack: posts small blind $200
Mike_McDonald_@MikeMcDonald89: posts big blind $400
*** HOLE CARDS ***
Dealt to DeepStack [6h 4d]
Dealt to Mike_McDonald_@MikeMcDonald89 [2h 9h]
DeepStack: raises $400 to $800
Mike_McDonald_@MikeMcDonald89: raises $1600 to $2400
DeepStack: folds
Uncalled bet ($1600) returned to Mike_McDonald_@MikeMcDonald89
Mike_McDonald_@MikeMcDonald89 collected $1600 from the pot
*** SUMMARY ***
Total pot $1600 | Rake $0
Seat 1: DeepStack (button) (small blind) folded before the Flop
Seat 2: Mike_McDonald_@MikeMcDonald89 (big blind) collected ($1600)

PokerStars Hand #11000000047: Tournament #1, Apr29_2017-at-11_0_39 Hold'em No Limit ($200/$400 USD) - 2017/04/29 13:01:25 ET
Table 'ACPC Match' 2-max Seat #2 is the button
Seat 1: DeepStack ($18825 in chips)
Seat 2: Mike_McDonald_@MikeMcDonald89 ($21175 in chips)
Mike_McDonald_@MikeMcDonald89: posts small blind $200
DeepStack: posts big blind $400
*** HOLE CARDS ***
Dealt to DeepStack [7h 7c]
Dealt to Mike_McDonald_@MikeMcDonald89 [2s 4h]
Mike_McDonald_@MikeMcDonald89: folds
Uncalled bet ($200) returned to DeepStack
DeepStack collected $400 from the pot
*** SUMMARY ***
Total pot $400 | Rake $0
Seat 1: DeepStack (big blind) collected ($400)
Seat 2: Mike_McDonald_@MikeMcDonald89 (button) (small blind) folded before the Flop

PokerStars Hand #11000000048: Tournament #1, Apr29_2017-at-11_0_39 Hold'em No Limit ($200/$400 USD) - 2017/04/29 13:01:26 ET
Table 'ACPC Match' 2-max Seat #1 is the button
Seat 1: DeepStack ($19025 in chips)
Seat 2: Mike_McDonald_@MikeMcDonald89 ($20975 in chips)
DeepStack: posts small blind $200
Mike_McDonald_@MikeMcDonald89: posts big blind $400
*** HOLE CARDS ***
Dealt to DeepStack [7c 9d]
Dealt to Mike_McDonald_@MikeMcDonald89 [3h 8c]
DeepStack: raises $400 to $800
Mike_McDonald_@MikeMcDonald89: folds
Uncalled bet ($400) returned to DeepStack
DeepStack collected $800 from the pot
*** SUMMARY ***
Total pot $800 | Rake $0
Seat 1: DeepStack (button) (small blind) collected ($800)
Seat 2: Mike_McDonald_@MikeMcDonald89 (big blind) folded before the Flop

PokerStars Hand #11000000049: Tournament #1, Apr29_2017-at-11_0_39 Hold'em No Limit ($200/$400 USD) - 2017/04/29 13:01:27 ET
Table 'ACPC Match' 2-max Seat #2 is the button
Seat 1: DeepStack ($19425 in chips)
Seat 2: Mike_McDonald_@MikeMcDonald89 ($20575 in chips)
Mike_McDonald_@MikeMcDonald89: posts small blind $200
DeepStack: posts big blind $400
*** HOLE CARDS ***
Dealt to DeepStack [4h 4s]
Dealt to Mike_McDonald_@MikeMcDonald89 [8h As]
Mike_McDonald_@MikeMcDonald89: raises $600 to $1000
DeepStack: calls $600
*** FLOP **** [9d Qc Tc]
DeepStack: checks
Mike_McDonald_@MikeMcDonald89: checks
*** TURN **** [Td]
DeepStack: checks
Mike_McDonald_@MikeMcDonald89: raises $700 to $700
DeepStack: calls $700
*** RIVER **** [7h]
DeepStack: checks
Mike_McDonald_@MikeMcDonald89: checks
*** SHOW DOWN ***
DeepStack: shows [4h 4s] (two pair, Tens and Fours)
Mike_McDonald_@MikeMcDonald89: shows [8h As] (a pair of Tens)
DeepStack collected $3400 from pot
*** SUMMARY ***
Total pot $3400 | Rake $0
Board [9d Qc Tc Td 7h]
Seat 1: DeepStack (big blind) showed [4h 4s] and won ($3400) with two pair, Tens and Fours
Seat 2: Mike_McDonald_@MikeMcDonald89 (button) (small blind) showed [8h As] and lost with a pair of Tens

PokerStars Hand #11000000050: Tournament #1, Apr29_2017-at-11_0_39 Hold'em No Limit ($200/$400 USD) - 2017/04/29 13:01:28 ET
Table 'ACPC Match' 2-max Seat #1 is the button
Seat 1: DeepStack ($21125 in chips)
Seat 2: Mike_McDonald_@MikeMcDonald89 ($18875 in chips)
DeepStack: posts small blind $200
Mike_McDonald_@MikeMcDonald89: posts big blind $400
*** HOLE CARDS ***
Dealt to DeepStack [Qs 5c]
Dealt to Mike_McDonald_@MikeMcDonald89 [Js 6s]
DeepStack: raises $400 to $800
Mike_McDonald_@MikeMcDonald89: calls $400
*** FLOP **** [9c Ad 7h]
Mike_McDonald_@MikeMcDonald89: checks
DeepStack: raises $800 to $800
Mike_McDonald_@MikeMcDonald89: folds
Uncalled bet ($800) returned to DeepStack
DeepStack collected $1600 from the pot
*** SUMMARY ***
Total pot $1600 | Rake $0
Board [9c Ad 7h]
Seat 1: DeepStack (button) (small blind) collected ($1600)
Seat 2: Mike_McDonald_@MikeMcDonald89 (big blind) folded on the Flop

PokerStars Hand #11000000051: Tournament #1, Apr29_2017-at-11_0_39 Hold'em No Limit ($300/$600 USD) - 2017/04/29 13:01:29 ET
Table 'ACPC Match' 2-max Seat #2 is the button
Seat 1: DeepStack ($21925 in chips)
Seat 2: Mike_McDonald_@MikeMcDonald89 ($18075 in chips)
Mike_McDonald_@MikeMcDonald89: posts small blind $300
DeepStack: posts big blind $600
*** HOLE CARDS ***
Dealt to DeepStack [Qd 5c]
Dealt to Mike_McDonald_@MikeMcDonald89 [3s As]
Mike_McDonald_@MikeMcDonald89: raises $800 to $1400
DeepStack: calls $800
*** FLOP **** [6c 4s 2h]
DeepStack: checks
Mike_McDonald_@MikeMcDonald89: checks
*** TURN **** [5h]
DeepStack: bets $1400
Mike_McDonald_@MikeMcDonald89: calls $1400
*** RIVER **** [Ks]
DeepStack: checks
Mike_McDonald_@MikeMcDonald89: raises $4200 to $4200
DeepStack: calls $4200
*** SHOW DOWN ***
Mike_McDonald_@MikeMcDonald89: shows [3s As] (straight, Six high)
DeepStack: shows [Qd 5c] (a pair of Fives)
Mike_McDonald_@MikeMcDonald89 collected $14000 from pot
*** SUMMARY ***
Total pot $14000 | Rake $0
Board [6c 4s 2h 5h Ks]
Seat 1: DeepStack (big blind) showed [Qd 5c] and lost with a pair of Fives
Seat 2: Mike_McDonald_@MikeMcDonald89 (button) (small blind) showed [3s As] and won ($14000) with straight, Six high

PokerStars Hand #11000000052: Tournament #1, Apr29_2017-at-11_0_39 Hold'em No Limit ($300/$600 USD) - 2017/04/29 13:01:30 ET
Table 'ACPC Match' 2-max Seat #1 is the button
Seat 1: DeepStack ($14925 in chips)
Seat 2: Mike_McDonald_@MikeMcDonald89 ($25075 in chips)
DeepStack: posts small blind $300
Mike_McDonald_@MikeMcDonald89: posts big blind $600
*** HOLE CARDS ***
Dealt to DeepStack [5c Jh]
Dealt to Mike_McDonald_@MikeMcDonald89 [Td Js]
DeepStack: raises $600 to $1200
Mike_McDonald_@MikeMcDonald89: calls $600
*** FLOP **** [Kc 2d Ah]
Mike_McDonald_@MikeMcDonald89: checks
DeepStack: raises $1200 to $1200
Mike_McDonald_@MikeMcDonald89: calls $1200
*** TURN **** [9c]
Mike_McDonald_@MikeMcDonald89: checks
DeepStack: checks
*** RIVER **** [9h]
Mike_McDonald_@MikeMcDonald89: bets $2400
DeepStack: folds
Uncalled bet ($2400) returned to Mike_McDonald_@MikeMcDonald89
Mike_McDonald_@MikeMcDonald89 collected $4800 from the pot
*** SUMMARY ***
Total pot $4800 | Rake $0
Board [Kc 2d Ah 9c 9h]
Seat 1: DeepStack (button) (small blind) folded on the River
Seat 2: Mike_McDonald_@MikeMcDonald89 (big blind) collected ($4800)

PokerStars Hand #11000000053: Tournament #1, Apr29_2017-at-11_0_39 Hold'em No Limit ($300/$600 USD) - 2017/04/29 13:01:31 ET
Table 'ACPC Match' 2-max Seat #2 is the button
Seat 1: DeepStack ($12525 in chips)
Seat 2: Mike_McDonald_@MikeMcDonald89 ($27475 in chips)
Mike_McDonald_@MikeMcDonald89: posts small blind $300
DeepStack: posts big blind $600
*** HOLE CARDS ***
Dealt to DeepStack [Th 8h]
Dealt to Mike_McDonald_@MikeMcDonald89 [Qc Kd]
Mike_McDonald_@MikeMcDonald89: raises $600 to $1200
DeepStack: calls $600
*** FLOP **** [8s 4c 6c]
DeepStack: checks
Mike_McDonald_@MikeMcDonald89: checks
*** TURN **** [Ad]
DeepStack: checks
Mike_McDonald_@MikeMcDonald89: checks
*** RIVER **** [Jd]
DeepStack: bets $1200
Mike_McDonald_@MikeMcDonald89: folds
Uncalled bet ($1200) returned to DeepStack
DeepStack collected $2400 from the pot
*** SUMMARY ***
Total pot $2400 | Rake $0
Board [8s 4c 6c Ad Jd]
Seat 1: DeepStack (big blind) collected ($2400)
Seat 2: Mike_McDonald_@MikeMcDonald89 (button) (small blind) folded on the River

PokerStars Hand #11000000054: Tournament #1, Apr29_2017-at-11_0_39 Hold'em No Limit ($300/$600 USD) - 2017/04/29 13:01:32 ET
Table 'ACPC Match' 2-max Seat #1 is the button
Seat 1: DeepStack ($13725 in chips)
Seat 2: Mike_McDonald_@MikeMcDonald89 ($26275 in chips)
DeepStack: posts small blind $300
Mike_McDonald_@MikeMcDonald89: posts big blind $600
*** HOLE CARDS ***
Dealt to DeepStack [9c 8c]
Dealt to Mike_McDonald_@MikeMcDonald89 [4s As]
DeepStack: calls $300
Mike_McDonald_@MikeMcDonald89: raises $25675 to $26275 and is all-in
DeepStack: calls $13125 and is all-in
Uncalled bet ($12550) returned to Mike_McDonald_@MikeMcDonald89
*** FLOP **** [Qc 2h 6h]
*** TURN **** [Kd]
*** RIVER **** [7d]
*** SHOW DOWN ***
Mike_McDonald_@MikeMcDonald89: shows [4s As] (Ace high)
DeepStack: shows [9c 8c] (King high)
Mike_McDonald_@MikeMcDonald89 collected $27450 from pot
*** SUMMARY ***
Total pot $27450 | Rake $0
Board [Qc 2h 6h Kd 7d]
Seat 1: DeepStack (button) (small blind) showed [9c 8c] and lost with King high
Seat 2: Mike_McDonald_@MikeMcDonald89 (big blind) showed [4s As] and won ($27450) with Ace high
