PokerStars Hand #11000200001: Tournament #3, Apr29_2017-at-12_33_17 Hold'em No Limit ($50/$100 USD) - 2017/04/29 14:33:17 ET
Table 'ACPC Match' 2-max Seat #2 is the button
Seat 1: DeepStack ($20000 in chips)
Seat 2: Mike_McDonald_@MikeMcDonald89 ($20000 in chips)
Mike_McDonald_@MikeMcDonald89: posts small blind $50
DeepStack: posts big blind $100
*** HOLE CARDS ***
Dealt to DeepStack [2s 3d]
Dealt to Mike_McDonald_@MikeMcDonald89 [Ts 4c]
Mike_McDonald_@MikeMcDonald89: raises $150 to $250
DeepStack: folds
Uncalled bet ($150) returned to Mike_McDonald_@MikeMcDonald89
Mike_McDonald_@MikeMcDonald89 collected $200 from the pot
*** SUMMARY ***
Total pot $200 | Rake $0
Seat 1: DeepStack (big blind) folded before the Flop
Seat 2: Mike_McDonald_@MikeMcDonald89 (button) (small blind) collected ($200)

PokerStars Hand #11000200002: Tournament #3, Apr29_2017-at-12_33_17 Hold'em No Limit ($50/$100 USD) - 2017/04/29 14:33:18 ET
Table 'ACPC Match' 2-max Seat #1 is the button
Seat 1: DeepStack ($19900 in chips)
Seat 2: Mike_McDonald_@MikeMcDonald89 ($20100 in chips)
DeepStack: posts small blind $50
Mike_McDonald_@MikeMcDonald89: posts big blind $100
*** HOLE CARDS ***
Dealt to DeepStack [2s Jc]
Dealt to Mike_McDonald_@MikeMcDonald89 [Qd 3h]
DeepStack: calls $50
Mike_McDonald_@MikeMcDonald89: checks
*** FLOP **** [5d 5h 2c]
Mike_McDonald_@MikeMcDonald89: checks
DeepStack: checks
*** TURN **** [7d]
Mike_McDonald_@MikeMcDonald89: checks
DeepStack: raises $100 to $100
Mike_McDonald_@MikeMcDonald89: folds
Uncalled bet ($100) returned to DeepStack
DeepStack collected $200 from the pot
*** SUMMARY ***
Total pot $200 | Rake $0
Board [5d 5h 2c 7d]
Seat 1: DeepStack (button) (small blind) collected ($200)
Seat 2: Mike_McDonald_@MikeMcDonald89 (big blind) folded on the Turn

PokerStars Hand #11000200003: Tournament #3, Apr29_2017-at-12_33_17 Hold'em No Limit ($50/$100 USD) - 2017/04/29 14:33:19 ET
Table 'ACPC Match' 2-max Seat #2 is the button
Seat 1: DeepStack ($20000 in chips)
Seat 2: Mike_McDonald_@MikeMcDonald89 ($20000 in chips)
Mike_McDonald_@MikeMcDonald89: posts small blind $50
DeepStack: posts big blind $100
*** HOLE CARDS ***
Dealt to DeepStack [5s 7h]
Dealt to Mike_McDonald_@MikeMcDonald89 [4s Qh]
Mike_McDonald_@MikeMcDonald89: raises $150 to $250
DeepStack: calls $150
*** FLOP **** [3d Tc 6h]
DeepStack: checks
Mike_McDonald_@MikeMcDonald89: raises $250 to $250
DeepStack: calls $250
*** TURN **** [3s]
DeepStack: checks
Mike_McDonald_@MikeMcDonald89: raises $500 to $500
DeepStack: folds
Uncalled bet ($500) returned to Mike_McDonald_@MikeMcDonald89
Mike_McDonald_@MikeMcDonald89 collected $1000 from the pot
*** SUMMARY ***
Total pot $1000 | Rake $0
Board [3d Tc 6h 3s]
Seat 1: DeepStack (big blind) folded on the Turn
Seat 2: Mike_McDonald_@MikeMcDonald89 (button) (small blind) collected ($1000)

PokerStars Hand #11000200004: Tournament #3, Apr29_2017-at-12_33_17 Hold'em No Limit ($50/$100 USD) - 2017/04/29 14:33:20 ET
Table 'ACPC Match' 2-max Seat #1 is the button
Seat 1: DeepStack ($19500 in chips)
Seat 2: Mike_McDonald_@MikeMcDonald89 ($20500 in chips)
DeepStack: posts small blind $50
Mike_McDonald_@MikeMcDonald89: posts big blind $100
*** HOLE CARDS ***
Dealt to DeepStack [2c 7h]
Dealt to Mike_McDonald_@MikeMcDonald89 [5c 8h]
DeepStack: folds
Uncalled bet ($50) returned to Mike_McDonald_@MikeMcDonald89
Mike_McDonald_@MikeMcDonald89 collected $100 from the pot
*** SUMMARY ***
Total pot $100 | Rake $0
Seat 1: DeepStack (button) (small blind) folded before the Flop
Seat 2: Mike_McDonald_@MikeMcDonald89 (big blind) collected ($100)

PokerStars Hand #11000200005: Tournament #3, Apr29_2017-at-12_33_17 Hold'em No Limit ($50/$100 USD) - 2017/04/29 14:33:21 ET
Table 'ACPC Match' 2-max Seat #2 is the button
Seat 1: DeepStack ($19450 in chips)
Seat 2: Mike_McDonald_@MikeMcDonald89 ($20550 in chips)
Mike_McDonald_@MikeMcDonald89: posts small blind $50
DeepStack: posts big blind $100
*** HOLE CARDS ***
Dealt to DeepStack [Td Jh]
Dealt to Mike_McDonald_@MikeMcDonald89 [7d 5h]
Mike_McDonald_@MikeMcDonald89: raises $150 to $250
DeepStack: raises $500 to $750
Mike_McDonald_@MikeMcDonald89: folds
Uncalled bet ($500) returned to DeepStack
DeepStack collected $500 from the pot
*** SUMMARY ***
Total pot $500 | Rake $0
Seat 1: DeepStack (big blind) collected ($500)
Seat 2: Mike_McDonald_@MikeMcDonald89 (button) (small blind) folded before the Flop

PokerStars Hand #11000200006: Tournament #3, Apr29_2017-at-12_33_17 Hold'em No Limit ($50/$100 USD) - 2017/04/29 14:33:22 ET
Table 'ACPC Match' 2-max Seat #1 is the button
Seat 1: DeepStack ($19700 in chips)
Seat 2: Mike_McDonald_@MikeMcDonald89 ($20300 in chips)
DeepStack: posts small blind $50
Mike_McDonald_@MikeMcDonald89: posts big blind $100
*** HOLE CARDS ***
Dealt to DeepStack [3s 9d]
Dealt to Mike_McDonald_@MikeMcDonald89 [7c 2s]
DeepStack: folds
Uncalled bet ($50) returned to Mike_McDonald_@MikeMcDonald89
Mike_McDonald_@MikeMcDonald89 collected $100 from the pot
*** SUMMARY ***
Total pot $100 | Rake $0
Seat 1: DeepStack (button) (small blind) folded before the Flop
Seat 2: Mike_McDonald_@MikeMcDonald89 (big blind) collected ($100)

PokerStars Hand #11000200007: Tournament #3, Apr29_2017-at-12_33_17 Hold'em No Limit ($50/$100 USD) - 2017/04/29 14:33:23 ET
Table 'ACPC Match' 2-max Seat #2 is the button
Seat 1: DeepStack ($19650 in chips)
Seat 2: Mike_McDonald_@MikeMcDonald89 ($20350 in chips)
Mike_McDonald_@MikeMcDonald89: posts small blind $50
DeepStack: posts big blind $100
*** HOLE CARDS ***
Dealt to DeepStack [Jh 9d]
Dealt to Mike_McDonald_@MikeMcDonald89 [8d 5c]
Mike_McDonald_@MikeMcDonald89: raises $150 to $250
DeepStack: calls $150
*** FLOP **** [Qs 7c 4s]
DeepStack: checks
Mike_McDonald_@MikeMcDonald89: raises $250 to $250
DeepStack: folds
Uncalled bet ($250) returned to Mike_McDonald_@MikeMcDonald89
Mike_McDonald_@MikeMcDonald89 collected $500 from the pot
*** SUMMARY ***
Total pot $500 | Rake $0
Board [Qs 7c 4s]
Seat 1: DeepStack (big blind) folded on the Flop
Seat 2: Mike_McDonald_@MikeMcDonald89 (button) (small blind) collected ($500)

PokerStars Hand #11000200008: Tournament #3, Apr29_2017-at-12_33_17 Hold'em No Limit ($50/$100 USD) - 2017/04/29 14:33:24 ET
Table 'ACPC Match' 2-max Seat #1 is the button
Seat 1: DeepStack ($19400 in chips)
Seat 2: Mike_McDonald_@MikeMcDonald89 ($20600 in chips)
DeepStack: posts small blind $50
Mike_McDonald_@MikeMcDonald89: posts big blind $100
*** HOLE CARDS ***
Dealt to DeepStack [Ks 9c]
Dealt to Mike_McDonald_@MikeMcDonald89 [8d 4h]
DeepStack: raises $200 to $300
Mike_McDonald_@MikeMcDonald89: folds
Uncalled bet ($200) returned to DeepStack
DeepStack collected $200 from the pot
*** SUMMARY ***
Total pot $200 | Rake $0
Seat 1: DeepStack (button) (small blind) collected ($200)
Seat 2: Mike_McDonald_@MikeMcDonald89 (big blind) folded before the Flop

PokerStars Hand #11000200009: Tournament #3, Apr29_2017-at-12_33_17 Hold'em No Limit ($50/$100 USD) - 2017/04/29 14:33:25 ET
Table 'ACPC Match' 2-max Seat #2 is the button
Seat 1: DeepStack ($19500 in chips)
Seat 2: Mike_McDonald_@MikeMcDonald89 ($20500 in chips)
Mike_McDonald_@MikeMcDonald89: posts small blind $50
DeepStack: posts big blind $100
*** HOLE CARDS ***
Dealt to DeepStack [8c 3h]
Dealt to Mike_McDonald_@MikeMcDonald89 [6h 9s]
Mike_McDonald_@MikeMcDonald89: raises $150 to $250
DeepStack: folds
Uncalled bet ($150) returned to Mike_McDonald_@MikeMcDonald89
Mike_McDonald_@MikeMcDonald89 collected $200 from the pot
*** SUMMARY ***
Total pot $200 | Rake $0
Seat 1: DeepStack (big blind) folded before the Flop
Seat 2: Mike_McDonald_@MikeMcDonald89 (button) (small blind) collected ($200)

PokerStars Hand #11000200010: Tournament #3, Apr29_2017-at-12_33_17 Hold'em No Limit ($50/$100 USD) - 2017/04/29 14:33:26 ET
Table 'ACPC Match' 2-max Seat #1 is the button
Seat 1: DeepStack ($19400 in chips)
Seat 2: Mike_McDonald_@MikeMcDonald89 ($20600 in chips)
DeepStack: posts small blind $50
Mike_McDonald_@MikeMcDonald89: posts big blind $100
*** HOLE CARDS ***
Dealt to DeepStack [7h 9s]
Dealt to Mike_McDonald_@MikeMcDonald89 [3s Ac]
DeepStack: raises $100 to $200
Mike_McDonald_@MikeMcDonald89: calls $100
*** FLOP **** [Qs Ad 2h]
Mike_McDonald_@MikeMcDonald89: checks
DeepStack: checks
*** TURN **** [4s]
Mike_McDonald_@MikeMcDonald89: checks
DeepStack: raises $400 to $400
Mike_McDonald_@MikeMcDonald89: calls $400
*** RIVER **** [2d]
Mike_McDonald_@MikeMcDonald89: checks
DeepStack: checks
*** SHOW DOWN ***
Mike_McDonald_@MikeMcDonald89: shows [3s Ac] (two pair, Aces and Deuces)
DeepStack: shows [7h 9s] (a pair of Deuces)
Mike_McDonald_@MikeMcDonald89 collected $1200 from pot
*** SUMMARY ***
Total pot $1200 | Rake $0
Board [Qs Ad 2h 4s 2d]
Seat 1: DeepStack (button) (small blind) showed [7h 9s] and lost with a pair of Deuces
Seat 2: Mike_McDonald_@MikeMcDonald89 (big blind) showed [3s Ac] and won ($1200) with two pair, Aces and Deuces

PokerStars Hand #11000200011: Tournament #3, Apr29_2017-at-12_33_17 Hold'em No Limit ($75/$150 USD) - 2017/04/29 14:33:27 ET
Table 'ACPC Match' 2-max Seat #2 is the button
Seat 1: DeepStack ($18800 in chips)
Seat 2: Mike_McDonald_@MikeMcDonald89 ($21200 in chips)
Mike_McDonald_@MikeMcDonald89: posts small blind $75
DeepStack: posts big blind $150
*** HOLE CARDS ***
Dealt to DeepStack [4c 4h]
Dealt to Mike_McDonald_@MikeMcDonald89 [6s Tc]
Mike_McDonald_@MikeMcDonald89: raises $225 to $375
DeepStack: calls $225
*** FLOP **** [5c 5d Ah]
DeepStack: checks
Mike_McDonald_@MikeMcDonald89: raises $250 to $250
DeepStack: calls $250
*** TURN **** [6c]
DeepStack: checks
Mike_McDonald_@MikeMcDonald89: checks
*** RIVER **** [9c]
DeepStack: checks
Mike_McDonald_@MikeMcDonald89: checks
*** SHOW DOWN ***
DeepStack: shows [4c 4h] (two pair, Fives and Fours)
Mike_McDonald_@MikeMcDonald89: shows [6s Tc] (two pair, Sixes and Fives)
Mike_McDonald_@MikeMcDonald89 collected $1250 from pot
*** SUMMARY ***
Total pot $1250 | Rake $0
Board [5c 5d Ah 6c 9c]
Seat 1: DeepStack (big blind) showed [4c 4h] and lost with two pair, Fives and Fours
Seat 2: Mike_McDonald_@MikeMcDonald89 (button) (small blind) showed [6s Tc] and won ($1250) with two pair, Sixes and Fives

PokerStars Hand #11000200012: Tournament #3, Apr29_2017-at-12_33_17 Hold'em No Limit ($75/$150 USD) - 2017/04/29 14:33:28 ET
Table 'ACPC Match' 2-max Seat #1 is the button
Seat 1: DeepStack ($18175 in chips)
Seat 2: Mike_McDonald_@MikeMcDonald89 ($21825 in chips)
DeepStack: posts small blind $75
Mike_McDonald_@MikeMcDonald89: posts big blind $150
*** HOLE CARDS ***
Dealt to DeepStack [3c 4s]
Dealt to Mike_McDonald_@MikeMcDonald89 [9c 6s]
DeepStack: calls $75
Mike_McDonald_@MikeMcDonald89: checks
*** FLOP **** [3d Ah 8c]
Mike_McDonald_@MikeMcDonald89: checks
DeepStack: checks
*** TURN **** [6c]
Mike_McDonald_@MikeMcDonald89: checks
DeepStack: checks
*** RIVER **** [3s]
Mike_McDonald_@MikeMcDonald89: checks
DeepStack: raises $300 to $300
Mike_McDonald_@MikeMcDonald89: calls $300
*** SHOW DOWN ***
DeepStack: shows [3c 4s] (three of a kind, Threes)
Mike_McDonald_@MikeMcDonald89: shows [9c 6s] (two pair, Sixes and Threes)
DeepStack collected $900 from pot
*** SUMMARY ***
Total pot $900 | Rake $0
Board [3d Ah 8c 6c 3s]
Seat 1: DeepStack (button) (small blind) showed [3c 4s] and won ($900) with three of a kind, Threes
Seat 2: Mike_McDonald_@MikeMcDonald89 (big blind) showed [9c 6s] and lost with two pair, Sixes and Threes

PokerStars Hand #11000200013: Tournament #3, Apr29_2017-at-12_33_17 Hold'em No Limit ($75/$150 USD) - 2017/04/29 14:33:29 ET
Table 'ACPC Match' 2-max Seat #2 is the button
Seat 1: DeepStack ($18625 in chips)
Seat 2: Mike_McDonald_@MikeMcDonald89 ($21375 in chips)
Mike_McDonald_@MikeMcDonald89: posts small blind $75
DeepStack: posts big blind $150
*** HOLE CARDS ***
Dealt to DeepStack [9h 5d]
Dealt to Mike_McDonald_@MikeMcDonald89 [Th 4d]
Mike_McDonald_@MikeMcDonald89: raises $225 to $375
DeepStack: folds
Uncalled bet ($225) returned to Mike_McDonald_@MikeMcDonald89
Mike_McDonald_@MikeMcDonald89 collected $300 from the pot
*** SUMMARY ***
Total pot $300 | Rake $0
Seat 1: DeepStack (big blind) folded before the Flop
Seat 2: Mike_McDonald_@MikeMcDonald89 (button) (small blind) collected ($300)

PokerStars Hand #11000200014: Tournament #3, Apr29_2017-at-12_33_17 Hold'em No Limit ($75/$150 USD) - 2017/04/29 14:33:30 ET
Table 'ACPC Match' 2-max Seat #1 is the button
Seat 1: DeepStack ($18475 in chips)
Seat 2: Mike_McDonald_@MikeMcDonald89 ($21525 in chips)
DeepStack: posts small blind $75
Mike_McDonald_@MikeMcDonald89: posts big blind $150
*** HOLE CARDS ***
Dealt to DeepStack [6s Ah]
Dealt to Mike_McDonald_@MikeMcDonald89 [7c 4c]
DeepStack: raises $300 to $450
Mike_McDonald_@MikeMcDonald89: raises $1200 to $1650
DeepStack: folds
Uncalled bet ($1200) returned to Mike_McDonald_@MikeMcDonald89
Mike_McDonald_@MikeMcDonald89 collected $900 from the pot
*** SUMMARY ***
Total pot $900 | Rake $0
Seat 1: DeepStack (button) (small blind) folded before the Flop
Seat 2: Mike_McDonald_@MikeMcDonald89 (big blind) collected ($900)

PokerStars Hand #11000200015: Tournament #3, Apr29_2017-at-12_33_17 Hold'em No Limit ($75/$150 USD) - 2017/04/29 14:33:31 ET
Table 'ACPC Match' 2-max Seat #2 is the button
Seat 1: DeepStack ($18025 in chips)
Seat 2: Mike_McDonald_@MikeMcDonald89 ($21975 in chips)
Mike_McDonald_@MikeMcDonald89: posts small blind $75
DeepStack: posts big blind $150
*** HOLE CARDS ***
Dealt to DeepStack [3d 5d]
Dealt to Mike_McDonald_@MikeMcDonald89 [Jc Ac]
Mike_McDonald_@MikeMcDonald89: raises $225 to $375
DeepStack: calls $225
*** FLOP **** [Js 7h 2c]
DeepStack: checks
Mike_McDonald_@MikeMcDonald89: raises $375 to $375
DeepStack: folds
Uncalled bet ($375) returned to Mike_McDonald_@MikeMcDonald89
Mike_McDonald_@MikeMcDonald89 collected $750 from the pot
*** SUMMARY ***
Total pot $750 | Rake $0
Board [Js 7h 2c]
Seat 1: DeepStack (big blind) folded on the Flop
Seat 2: Mike_McDonald_@MikeMcDonald89 (button) (small blind) collected ($750)

PokerStars Hand #11000200016: Tournament #3, Apr29_2017-at-12_33_17 Hold'em No Limit ($75/$150 USD) - 2017/04/29 14:33:32 ET
Table 'ACPC Match' 2-max Seat #1 is the button
Seat 1: DeepStack ($17650 in chips)
Seat 2: Mike_McDonald_@MikeMcDonald89 ($22350 in chips)
DeepStack: posts small blind $75
Mike_McDonald_@MikeMcDonald89: posts big blind $150
*** HOLE CARDS ***
Dealt to DeepStack [6d 9s]
Dealt to Mike_McDonald_@MikeMcDonald89 [Qd 6h]
DeepStack: calls $75
Mike_McDonald_@MikeMcDonald89: checks
*** FLOP **** [Ts 2c Tc]
Mike_McDonald_@MikeMcDonald89: checks
DeepStack: raises $150 to $150
Mike_McDonald_@MikeMcDonald89: folds
Uncalled bet ($150) returned to DeepStack
DeepStack collected $300 from the pot
*** SUMMARY ***
Total pot $300 | Rake $0
Board [Ts 2c Tc]
Seat 1: DeepStack (button) (small blind) collected ($300)
Seat 2: Mike_McDonald_@MikeMcDonald89 (big blind) folded on the Flop

PokerStars Hand #11000200017: Tournament #3, Apr29_2017-at-12_33_17 Hold'em No Limit ($75/$150 USD) - 2017/04/29 14:33:33 ET
Table 'ACPC Match' 2-max Seat #2 is the button
Seat 1: DeepStack ($17800 in chips)
Seat 2: Mike_McDonald_@MikeMcDonald89 ($22200 in chips)
Mike_McDonald_@MikeMcDonald89: posts small blind $75
DeepStack: posts big blind $150
*** HOLE CARDS ***
Dealt to DeepStack [9s As]
Dealt to Mike_McDonald_@MikeMcDonald89 [Qs Ah]
Mike_McDonald_@MikeMcDonald89: raises $225 to $375
DeepStack: raises $750 to $1125
Mike_McDonald_@MikeMcDonald89: raises $2250 to $3375
DeepStack: calls $2250
*** FLOP **** [7h 6h 8s]
DeepStack: bets $14425 and is all-in
Mike_McDonald_@MikeMcDonald89: folds
Uncalled bet ($14425) returned to DeepStack
DeepStack collected $6750 from the pot
*** SUMMARY ***
Total pot $6750 | Rake $0
Board [7h 6h 8s]
Seat 1: DeepStack (big blind) collected ($6750)
Seat 2: Mike_McDonald_@MikeMcDonald89 (button) (small blind) folded on the Flop

PokerStars Hand #11000200018: Tournament #3, Apr29_2017-at-12_33_17 Hold'em No Limit ($75/$150 USD) - 2017/04/29 14:33:34 ET
Table 'ACPC Match' 2-max Seat #1 is the button
Seat 1: DeepStack ($21175 in chips)
Seat 2: Mike_McDonald_@MikeMcDonald89 ($18825 in chips)
DeepStack: posts small blind $75
Mike_McDonald_@MikeMcDonald89: posts big blind $150
*** HOLE CARDS ***
Dealt to DeepStack [Ah 4s]
Dealt to Mike_McDonald_@MikeMcDonald89 [7c As]
DeepStack: raises $150 to $300
Mike_McDonald_@MikeMcDonald89: calls $150
*** FLOP **** [Kh Ks Js]
Mike_McDonald_@MikeMcDonald89: checks
DeepStack: raises $300 to $300
Mike_McDonald_@MikeMcDonald89: calls $300
*** TURN **** [2c]
Mike_McDonald_@MikeMcDonald89: checks
DeepStack: checks
*** RIVER **** [7h]
Mike_McDonald_@MikeMcDonald89: checks
DeepStack: checks
*** SHOW DOWN ***
Mike_McDonald_@MikeMcDonald89: shows [7c As] (two pair, Kings and Sevens)
DeepStack: shows [Ah 4s] (a pair of Kings)
Mike_McDonald_@MikeMcDonald89 collected $1200 from pot
*** SUMMARY ***
Total pot $1200 | Rake $0
Board [Kh Ks Js 2c 7h]
Seat 1: DeepStack (button) (small blind) showed [Ah 4s] and lost with a pair of Kings
Seat 2: Mike_McDonald_@MikeMcDonald89 (big blind) showed [7c As] and won ($1200) with two pair, Kings and Sevens

PokerStars Hand #11000200019: Tournament #3, Apr29_2017-at-12_33_17 Hold'em No Limit ($75/$150 USD) - 2017/04/29 14:33:35 ET
Table 'ACPC Match' 2-max Seat #2 is the button
Seat 1: DeepStack ($20575 in chips)
Seat 2: Mike_McDonald_@MikeMcDonald89 ($19425 in chips)
Mike_McDonald_@MikeMcDonald89: posts small blind $75
DeepStack: posts big blind $150
*** HOLE CARDS ***
Dealt to DeepStack [3s 7h]
Dealt to Mike_McDonald_@MikeMcDonald89 [5h 4c]
Mike_McDonald_@MikeMcDonald89: raises $225 to $375
DeepStack: folds
Uncalled bet ($225) returned to Mike_McDonald_@MikeMcDonald89
Mike_McDonald_@MikeMcDonald89 collected $300 from the pot
*** SUMMARY ***
Total pot $300 | Rake $0
Seat 1: DeepStack (big blind) folded before the Flop
Seat 2: Mike_McDonald_@MikeMcDonald89 (button) (small blind) collected ($300)

PokerStars Hand #11000200020: Tournament #3, Apr29_2017-at-12_33_17 Hold'em No Limit ($75/$150 USD) - 2017/04/29 14:33:36 ET
Table 'ACPC Match' 2-max Seat #1 is the button
Seat 1: DeepStack ($20425 in chips)
Seat 2: Mike_McDonald_@MikeMcDonald89 ($19575 in chips)
DeepStack: posts small blind $75
Mike_McDonald_@MikeMcDonald89: posts big blind $150
*** HOLE CARDS ***
Dealt to DeepStack [7h 9h]
Dealt to Mike_McDonald_@MikeMcDonald89 [8h Qh]
DeepStack: raises $300 to $450
Mike_McDonald_@MikeMcDonald89: calls $300
*** FLOP **** [2d 3h Ah]
Mike_McDonald_@MikeMcDonald89: checks
DeepStack: raises $450 to $450
Mike_McDonald_@MikeMcDonald89: calls $450
*** TURN **** [Qc]
Mike_McDonald_@MikeMcDonald89: checks
DeepStack: raises $1800 to $1800
Mike_McDonald_@MikeMcDonald89: calls $1800
*** RIVER **** [7c]
Mike_McDonald_@MikeMcDonald89: checks
DeepStack: raises $5400 to $5400
Mike_McDonald_@MikeMcDonald89: folds
Uncalled bet ($5400) returned to DeepStack
DeepStack collected $5400 from the pot
*** SUMMARY ***
Total pot $5400 | Rake $0
Board [2d 3h Ah Qc 7c]
Seat 1: DeepStack (button) (small blind) collected ($5400)
Seat 2: Mike_McDonald_@MikeMcDonald89 (big blind) folded on the River

PokerStars Hand #11000200021: Tournament #3, Apr29_2017-at-12_33_17 Hold'em No Limit ($100/$200 USD) - 2017/04/29 14:33:37 ET
Table 'ACPC Match' 2-max Seat #2 is the button
Seat 1: DeepStack ($23125 in chips)
Seat 2: Mike_McDonald_@MikeMcDonald89 ($16875 in chips)
Mike_McDonald_@MikeMcDonald89: posts small blind $100
DeepStack: posts big blind $200
*** HOLE CARDS ***
Dealt to DeepStack [Qc 6c]
Dealt to Mike_McDonald_@MikeMcDonald89 [6s Th]
Mike_McDonald_@MikeMcDonald89: raises $300 to $500
DeepStack: calls $300
*** FLOP **** [9d Js 5h]
DeepStack: checks
Mike_McDonald_@MikeMcDonald89: raises $500 to $500
DeepStack: folds
Uncalled bet ($500) returned to Mike_McDonald_@MikeMcDonald89
Mike_McDonald_@MikeMcDonald89 collected $1000 from the pot
*** SUMMARY ***
Total pot $1000 | Rake $0
Board [9d Js 5h]
Seat 1: DeepStack (big blind) folded on the Flop
Seat 2: Mike_McDonald_@MikeMcDonald89 (button) (small blind) collected ($1000)

PokerStars Hand #11000200022: Tournament #3, Apr29_2017-at-12_33_17 Hold'em No Limit ($100/$200 USD) - 2017/04/29 14:33:38 ET
Table 'ACPC Match' 2-max Seat #1 is the button
Seat 1: DeepStack ($22625 in chips)
Seat 2: Mike_McDonald_@MikeMcDonald89 ($17375 in chips)
DeepStack: posts small blind $100
Mike_McDonald_@MikeMcDonald89: posts big blind $200
*** HOLE CARDS ***
Dealt to DeepStack [5h 6h]
Dealt to Mike_McDonald_@MikeMcDonald89 [Qd 9d]
DeepStack: raises $200 to $400
Mike_McDonald_@MikeMcDonald89: raises $1000 to $1400
DeepStack: calls $1000
*** FLOP **** [8d Ad Kc]
Mike_McDonald_@MikeMcDonald89: bets $1400
DeepStack: folds
Uncalled bet ($1400) returned to Mike_McDonald_@MikeMcDonald89
Mike_McDonald_@MikeMcDonald89 collected $2800 from the pot
*** SUMMARY ***
Total pot $2800 | Rake $0
Board [8d Ad Kc]
Seat 1: DeepStack (button) (small blind) folded on the Flop
Seat 2: Mike_McDonald_@MikeMcDonald89 (big blind) collected ($2800)

PokerStars Hand #11000200023: Tournament #3, Apr29_2017-at-12_33_17 Hold'em No Limit ($100/$200 USD) - 2017/04/29 14:33:39 ET
Table 'ACPC Match' 2-max Seat #2 is the button
Seat 1: DeepStack ($21225 in chips)
Seat 2: Mike_McDonald_@MikeMcDonald89 ($18775 in chips)
Mike_McDonald_@MikeMcDonald89: posts small blind $100
DeepStack: posts big blind $200
*** HOLE CARDS ***
Dealt to DeepStack [8s 7c]
Dealt to Mike_McDonald_@MikeMcDonald89 [Kd Qc]
Mike_McDonald_@MikeMcDonald89: raises $300 to $500
DeepStack: calls $300
*** FLOP **** [6d 3s As]
DeepStack: checks
Mike_McDonald_@MikeMcDonald89: checks
*** TURN **** [6h]
DeepStack: checks
Mike_McDonald_@MikeMcDonald89: raises $300 to $300
DeepStack: folds
Uncalled bet ($300) returned to Mike_McDonald_@MikeMcDonald89
Mike_McDonald_@MikeMcDonald89 collected $1000 from the pot
*** SUMMARY ***
Total pot $1000 | Rake $0
Board [6d 3s As 6h]
Seat 1: DeepStack (big blind) folded on the Turn
Seat 2: Mike_McDonald_@MikeMcDonald89 (button) (small blind) collected ($1000)

PokerStars Hand #11000200024: Tournament #3, Apr29_2017-at-12_33_17 Hold'em No Limit ($100/$200 USD) - 2017/04/29 14:33:40 ET
Table 'ACPC Match' 2-max Seat #1 is the button
Seat 1: DeepStack ($20725 in chips)
Seat 2: Mike_McDonald_@MikeMcDonald89 ($19275 in chips)
DeepStack: posts small blind $100
Mike_McDonald_@MikeMcDonald89: posts big blind $200
*** HOLE CARDS ***
Dealt to DeepStack [2d 3h]
Dealt to Mike_McDonald_@MikeMcDonald89 [8h 6d]
DeepStack: folds
Uncalled bet ($100) returned to Mike_McDonald_@MikeMcDonald89
Mike_McDonald_@MikeMcDonald89 collected $200 from the pot
*** SUMMARY ***
Total pot $200 | Rake $0
Seat 1: DeepStack (button) (small blind) folded before the Flop
Seat 2: Mike_McDonald_@MikeMcDonald89 (big blind) collected ($200)

PokerStars Hand #11000200025: Tournament #3, Apr29_2017-at-12_33_17 Hold'em No Limit ($100/$200 USD) - 2017/04/29 14:33:41 ET
Table 'ACPC Match' 2-max Seat #2 is the button
Seat 1: DeepStack ($20625 in chips)
Seat 2: Mike_McDonald_@MikeMcDonald89 ($19375 in chips)
Mike_McDonald_@MikeMcDonald89: posts small blind $100
DeepStack: posts big blind $200
*** HOLE CARDS ***
Dealt to DeepStack [3d 6c]
Dealt to Mike_McDonald_@MikeMcDonald89 [8s Tc]
Mike_McDonald_@MikeMcDonald89: raises $300 to $500
DeepStack: folds
Uncalled bet ($300) returned to Mike_McDonald_@MikeMcDonald89
Mike_McDonald_@MikeMcDonald89 collected $400 from the pot
*** SUMMARY ***
Total pot $400 | Rake $0
Seat 1: DeepStack (big blind) folded before the Flop
Seat 2: Mike_McDonald_@MikeMcDonald89 (button) (small blind) collected ($400)

PokerStars Hand #11000200026: Tournament #3, Apr29_2017-at-12_33_17 Hold'em No Limit ($100/$200 USD) - 2017/04/29 14:33:42 ET
Table 'ACPC Match' 2-max Seat #1 is the button
Seat 1: DeepStack ($20425 in chips)
Seat 2: Mike_McDonald_@MikeMcDonald89 ($19575 in chips)
DeepStack: posts small blind $100
Mike_McDonald_@MikeMcDonald89: posts big blind $200
*** HOLE CARDS ***
Dealt to DeepStack [7h 2h]
Dealt to Mike_McDonald_@MikeMcDonald89 [Kd Ad]
DeepStack: calls $100
Mike_McDonald_@MikeMcDonald89: raises $400 to $600
DeepStack: calls $400
*** FLOP **** [Ah 9h 3s]
Mike_McDonald_@MikeMcDonald89: bets $600
DeepStack: calls $600
*** TURN **** [7s]
Mike_McDonald_@MikeMcDonald89: bets $1800
DeepStack: calls $1800
*** RIVER **** [9s]
Mike_McDonald_@MikeMcDonald89: checks
DeepStack: checks
*** SHOW DOWN ***
Mike_McDonald_@MikeMcDonald89: shows [Kd Ad] (two pair, Aces and Nines)
DeepStack: shows [7h 2h] (two pair, Nines and Sevens)
Mike_McDonald_@MikeMcDonald89 collected $6000 from pot
*** SUMMARY ***
Total pot $6000 | Rake $0
Board [Ah 9h 3s 7s 9s]
Seat 1: DeepStack (button) (small blind) showed [7h 2h] and lost with two pair, Nines and Sevens
Seat 2: Mike_McDonald_@MikeMcDonald89 (big blind) showed [Kd Ad] and won ($6000) with two pair, Aces and Nines

PokerStars Hand #11000200027: Tournament #3, Apr29_2017-at-12_33_17 Hold'em No Limit ($100/$200 USD) - 2017/04/29 14:33:43 ET
Table 'ACPC Match' 2-max Seat #2 is the button
Seat 1: DeepStack ($17425 in chips)
Seat 2: Mike_McDonald_@MikeMcDonald89 ($22575 in chips)
Mike_McDonald_@MikeMcDonald89: posts small blind $100
DeepStack: posts big blind $200
*** HOLE CARDS ***
Dealt to DeepStack [Kh 5h]
Dealt to Mike_McDonald_@MikeMcDonald89 [Qh 3c]
Mike_McDonald_@MikeMcDonald89: raises $300 to $500
DeepStack: raises $1000 to $1500
Mike_McDonald_@MikeMcDonald89: folds
Uncalled bet ($1000) returned to DeepStack
DeepStack collected $1000 from the pot
*** SUMMARY ***
Total pot $1000 | Rake $0
Seat 1: DeepStack (big blind) collected ($1000)
Seat 2: Mike_McDonald_@MikeMcDonald89 (button) (small blind) folded before the Flop

PokerStars Hand #11000200028: Tournament #3, Apr29_2017-at-12_33_17 Hold'em No Limit ($100/$200 USD) - 2017/04/29 14:33:44 ET
Table 'ACPC Match' 2-max Seat #1 is the button
Seat 1: DeepStack ($17925 in chips)
Seat 2: Mike_McDonald_@MikeMcDonald89 ($22075 in chips)
DeepStack: posts small blind $100
Mike_McDonald_@MikeMcDonald89: posts big blind $200
*** HOLE CARDS ***
Dealt to DeepStack [6c Ad]
Dealt to Mike_McDonald_@MikeMcDonald89 [8d 8h]
DeepStack: raises $200 to $400
Mike_McDonald_@MikeMcDonald89: raises $1000 to $1400
DeepStack: folds
Uncalled bet ($1000) returned to Mike_McDonald_@MikeMcDonald89
Mike_McDonald_@MikeMcDonald89 collected $800 from the pot
*** SUMMARY ***
Total pot $800 | Rake $0
Seat 1: DeepStack (button) (small blind) folded before the Flop
Seat 2: Mike_McDonald_@MikeMcDonald89 (big blind) collected ($800)

PokerStars Hand #11000200029: Tournament #3, Apr29_2017-at-12_33_17 Hold'em No Limit ($100/$200 USD) - 2017/04/29 14:33:45 ET
Table 'ACPC Match' 2-max Seat #2 is the button
Seat 1: DeepStack ($17525 in chips)
Seat 2: Mike_McDonald_@MikeMcDonald89 ($22475 in chips)
Mike_McDonald_@MikeMcDonald89: posts small blind $100
DeepStack: posts big blind $200
*** HOLE CARDS ***
Dealt to DeepStack [3s 4d]
Dealt to Mike_McDonald_@MikeMcDonald89 [5c Td]
Mike_McDonald_@MikeMcDonald89: raises $300 to $500
DeepStack: folds
Uncalled bet ($300) returned to Mike_McDonald_@MikeMcDonald89
Mike_McDonald_@MikeMcDonald89 collected $400 from the pot
*** SUMMARY ***
Total pot $400 | Rake $0
Seat 1: DeepStack (big blind) folded before the Flop
Seat 2: Mike_McDonald_@MikeMcDonald89 (button) (small blind) collected ($400)

PokerStars Hand #11000200030: Tournament #3, Apr29_2017-at-12_33_17 Hold'em No Limit ($100/$200 USD) - 2017/04/29 14:33:46 ET
Table 'ACPC Match' 2-max Seat #1 is the button
Seat 1: DeepStack ($17325 in chips)
Seat 2: Mike_McDonald_@MikeMcDonald89 ($22675 in chips)
DeepStack: posts small blind $100
Mike_McDonald_@MikeMcDonald89: posts big blind $200
*** HOLE CARDS ***
Dealt to DeepStack [9c 8s]
Dealt to Mike_McDonald_@MikeMcDonald89 [Kc 5c]
DeepStack: raises $200 to $400
Mike_McDonald_@MikeMcDonald89: calls $200
*** FLOP **** [6d 6s Qd]
Mike_McDonald_@MikeMcDonald89: checks
DeepStack: checks
*** TURN **** [2d]
Mike_McDonald_@MikeMcDonald89: checks
DeepStack: checks
*** RIVER **** [9d]
Mike_McDonald_@MikeMcDonald89: checks
DeepStack: checks
*** SHOW DOWN ***
Mike_McDonald_@MikeMcDonald89: shows [Kc 5c] (a pair of Sixes)
DeepStack: shows [9c 8s] (two pair, Nines and Sixes)
DeepStack collected $800 from pot
*** SUMMARY ***
Total pot $800 | Rake $0
Board [6d 6s Qd 2d 9d]
Seat 1: DeepStack (button) (small blind) showed [9c 8s] and won ($800) with two pair, Nines and Sixes
Seat 2: Mike_McDonald_@MikeMcDonald89 (big blind) showed [Kc 5c] and lost with a pair of Sixes

PokerStars Hand #11000200031: Tournament #3, Apr29_2017-at-12_33_17 Hold'em No Limit ($150/$300 USD) - 2017/04/29 14:33:47 ET
Table 'ACPC Match' 2-max Seat #2 is the button
Seat 1: DeepStack ($17725 in chips)
Seat 2: Mike_McDonald_@MikeMcDonald89 ($22275 in chips)
Mike_McDonald_@MikeMcDonald89: posts small blind $150
DeepStack: posts big blind $300
*** HOLE CARDS ***
Dealt to DeepStack [Qs 7h]
Dealt to Mike_McDonald_@MikeMcDonald89 [2s 4s]
Mike_McDonald_@MikeMcDonald89: raises $450 to $750
DeepStack: calls $450
*** FLOP **** [2d Jc Kh]
DeepStack: checks
Mike_McDonald_@MikeMcDonald89: checks
*** TURN **** [8s]
DeepStack: checks
Mike_McDonald_@MikeMcDonald89: checks
*** RIVER **** [As]
DeepStack: checks
Mike_McDonald_@MikeMcDonald89: checks
*** SHOW DOWN ***
DeepStack: shows [Qs 7h] (Ace high)
Mike_McDonald_@MikeMcDonald89: shows [2s 4s] (a pair of Deuces)
Mike_McDonald_@MikeMcDonald89 collected $1500 from pot
*** SUMMARY ***
Total pot $1500 | Rake $0
Board [2d Jc Kh 8s As]
Seat 1: DeepStack (big blind) showed [Qs 7h] and lost with Ace high
Seat 2: Mike_McDonald_@MikeMcDonald89 (button) (small blind) showed [2s 4s] and won ($1500) with a pair of Deuces

PokerStars Hand #11000200032: Tournament #3, Apr29_2017-at-12_33_17 Hold'em No Limit ($150/$300 USD) - 2017/04/29 14:33:48 ET
Table 'ACPC Match' 2-max Seat #1 is the button
Seat 1: DeepStack ($16975 in chips)
Seat 2: Mike_McDonald_@MikeMcDonald89 ($23025 in chips)
DeepStack: posts small blind $150
Mike_McDonald_@MikeMcDonald89: posts big blind $300
*** HOLE CARDS ***
Dealt to DeepStack [4h Tc]
Dealt to Mike_McDonald_@MikeMcDonald89 [5h 7s]
DeepStack: calls $150
Mike_McDonald_@MikeMcDonald89: checks
*** FLOP **** [3h Js 2h]
Mike_McDonald_@MikeMcDonald89: checks
DeepStack: raises $300 to $300
Mike_McDonald_@MikeMcDonald89: folds
Uncalled bet ($300) returned to DeepStack
DeepStack collected $600 from the pot
*** SUMMARY ***
Total pot $600 | Rake $0
Board [3h Js 2h]
Seat 1: DeepStack (button) (small blind) collected ($600)
Seat 2: Mike_McDonald_@MikeMcDonald89 (big blind) folded on the Flop

PokerStars Hand #11000200033: Tournament #3, Apr29_2017-at-12_33_17 Hold'em No Limit ($150/$300 USD) - 2017/04/29 14:33:49 ET
Table 'ACPC Match' 2-max Seat #2 is the button
Seat 1: DeepStack ($17275 in chips)
Seat 2: Mike_McDonald_@MikeMcDonald89 ($22725 in chips)
Mike_McDonald_@MikeMcDonald89: posts small blind $150
DeepStack: posts big blind $300
*** HOLE CARDS ***
Dealt to DeepStack [4s Kd]
Dealt to Mike_McDonald_@MikeMcDonald89 [9s 7s]
Mike_McDonald_@MikeMcDonald89: raises $450 to $750
DeepStack: calls $450
*** FLOP **** [4d As 2h]
DeepStack: checks
Mike_McDonald_@MikeMcDonald89: raises $750 to $750
DeepStack: raises $1500 to $2250
Mike_McDonald_@MikeMcDonald89: folds
Uncalled bet ($1500) returned to DeepStack
DeepStack collected $3000 from the pot
*** SUMMARY ***
Total pot $3000 | Rake $0
Board [4d As 2h]
Seat 1: DeepStack (big blind) collected ($3000)
Seat 2: Mike_McDonald_@MikeMcDonald89 (button) (small blind) folded on the Flop

PokerStars Hand #11000200034: Tournament #3, Apr29_2017-at-12_33_17 Hold'em No Limit ($150/$300 USD) - 2017/04/29 14:33:50 ET
Table 'ACPC Match' 2-max Seat #1 is the button
Seat 1: DeepStack ($18775 in chips)
Seat 2: Mike_McDonald_@MikeMcDonald89 ($21225 in chips)
DeepStack: posts small blind $150
Mike_McDonald_@MikeMcDonald89: posts big blind $300
*** HOLE CARDS ***
Dealt to DeepStack [8h 8c]
Dealt to Mike_McDonald_@MikeMcDonald89 [Ah 2d]
DeepStack: raises $300 to $600
Mike_McDonald_@MikeMcDonald89: calls $300
*** FLOP **** [7h 2c Td]
Mike_McDonald_@MikeMcDonald89: checks
DeepStack: raises $600 to $600
Mike_McDonald_@MikeMcDonald89: calls $600
*** TURN **** [Qd]
Mike_McDonald_@MikeMcDonald89: checks
DeepStack: checks
*** RIVER **** [Jh]
Mike_McDonald_@MikeMcDonald89: checks
DeepStack: checks
*** SHOW DOWN ***
Mike_McDonald_@MikeMcDonald89: shows [Ah 2d] (a pair of Deuces)
DeepStack: shows [8h 8c] (a pair of Eights)
DeepStack collected $2400 from pot
*** SUMMARY ***
Total pot $2400 | Rake $0
Board [7h 2c Td Qd Jh]
Seat 1: DeepStack (button) (small blind) showed [8h 8c] and won ($2400) with a pair of Eights
Seat 2: Mike_McDonald_@MikeMcDonald89 (big blind) showed [Ah 2d] and lost with a pair of Deuces

PokerStars Hand #11000200035: Tournament #3, Apr29_2017-at-12_33_17 Hold'em No Limit ($150/$300 USD) - 2017/04/29 14:33:51 ET
Table 'ACPC Match' 2-max Seat #2 is the button
Seat 1: DeepStack ($19975 in chips)
Seat 2: Mike_McDonald_@MikeMcDonald89 ($20025 in chips)
Mike_McDonald_@MikeMcDonald89: posts small blind $150
DeepStack: posts big blind $300
*** HOLE CARDS ***
Dealt to DeepStack [Js Td]
Dealt to Mike_McDonald_@MikeMcDonald89 [Qs 2d]
Mike_McDonald_@MikeMcDonald89: raises $450 to $750
DeepStack: raises $1500 to $2250
Mike_McDonald_@MikeMcDonald89: folds
Uncalled bet ($1500) returned to DeepStack
DeepStack collected $1500 from the pot
*** SUMMARY ***
Total pot $1500 | Rake $0
Seat 1: DeepStack (big blind) collected ($1500)
Seat 2: Mike_McDonald_@MikeMcDonald89 (button) (small blind) folded before the Flop

PokerStars Hand #11000200036: Tournament #3, Apr29_2017-at-12_33_17 Hold'em No Limit ($150/$300 USD) - 2017/04/29 14:33:52 ET
Table 'ACPC Match' 2-max Seat #1 is the button
Seat 1: DeepStack ($20725 in chips)
Seat 2: Mike_McDonald_@MikeMcDonald89 ($19275 in chips)
DeepStack: posts small blind $150
Mike_McDonald_@MikeMcDonald89: posts big blind $300
*** HOLE CARDS ***
Dealt to DeepStack [Qh 8d]
Dealt to Mike_McDonald_@MikeMcDonald89 [2d Qs]
DeepStack: raises $300 to $600
Mike_McDonald_@MikeMcDonald89: calls $300
*** FLOP **** [4s 2c 3c]
Mike_McDonald_@MikeMcDonald89: checks
DeepStack: checks
*** TURN **** [Ks]
Mike_McDonald_@MikeMcDonald89: checks
DeepStack: checks
*** RIVER **** [Jc]
Mike_McDonald_@MikeMcDonald89: checks
DeepStack: checks
*** SHOW DOWN ***
Mike_McDonald_@MikeMcDonald89: shows [2d Qs] (a pair of Deuces)
DeepStack: shows [Qh 8d] (King high)
Mike_McDonald_@MikeMcDonald89 collected $1200 from pot
*** SUMMARY ***
Total pot $1200 | Rake $0
Board [4s 2c 3c Ks Jc]
Seat 1: DeepStack (button) (small blind) showed [Qh 8d] and lost with King high
Seat 2: Mike_McDonald_@MikeMcDonald89 (big blind) showed [2d Qs] and won ($1200) with a pair of Deuces

PokerStars Hand #11000200037: Tournament #3, Apr29_2017-at-12_33_17 Hold'em No Limit ($150/$300 USD) - 2017/04/29 14:33:53 ET
Table 'ACPC Match' 2-max Seat #2 is the button
Seat 1: DeepStack ($20125 in chips)
Seat 2: Mike_McDonald_@MikeMcDonald89 ($19875 in chips)
Mike_McDonald_@MikeMcDonald89: posts small blind $150
DeepStack: posts big blind $300
*** HOLE CARDS ***
Dealt to DeepStack [Qs 3d]
Dealt to Mike_McDonald_@MikeMcDonald89 [Jd 8h]
Mike_McDonald_@MikeMcDonald89: raises $450 to $750
DeepStack: folds
Uncalled bet ($450) returned to Mike_McDonald_@MikeMcDonald89
Mike_McDonald_@MikeMcDonald89 collected $600 from the pot
*** SUMMARY ***
Total pot $600 | Rake $0
Seat 1: DeepStack (big blind) folded before the Flop
Seat 2: Mike_McDonald_@MikeMcDonald89 (button) (small blind) collected ($600)

PokerStars Hand #11000200038: Tournament #3, Apr29_2017-at-12_33_17 Hold'em No Limit ($150/$300 USD) - 2017/04/29 14:33:54 ET
Table 'ACPC Match' 2-max Seat #1 is the button
Seat 1: DeepStack ($19825 in chips)
Seat 2: Mike_McDonald_@MikeMcDonald89 ($20175 in chips)
DeepStack: posts small blind $150
Mike_McDonald_@MikeMcDonald89: posts big blind $300
*** HOLE CARDS ***
Dealt to DeepStack [2h 8d]
Dealt to Mike_McDonald_@MikeMcDonald89 [3c 6s]
DeepStack: folds
Uncalled bet ($150) returned to Mike_McDonald_@MikeMcDonald89
Mike_McDonald_@MikeMcDonald89 collected $300 from the pot
*** SUMMARY ***
Total pot $300 | Rake $0
Seat 1: DeepStack (button) (small blind) folded before the Flop
Seat 2: Mike_McDonald_@MikeMcDonald89 (big blind) collected ($300)

PokerStars Hand #11000200039: Tournament #3, Apr29_2017-at-12_33_17 Hold'em No Limit ($150/$300 USD) - 2017/04/29 14:33:55 ET
Table 'ACPC Match' 2-max Seat #2 is the button
Seat 1: DeepStack ($19675 in chips)
Seat 2: Mike_McDonald_@MikeMcDonald89 ($20325 in chips)
Mike_McDonald_@MikeMcDonald89: posts small blind $150
DeepStack: posts big blind $300
*** HOLE CARDS ***
Dealt to DeepStack [2d Jh]
Dealt to Mike_McDonald_@MikeMcDonald89 [4d 2s]
Mike_McDonald_@MikeMcDonald89: folds
Uncalled bet ($150) returned to DeepStack
DeepStack collected $300 from the pot
*** SUMMARY ***
Total pot $300 | Rake $0
Seat 1: DeepStack (big blind) collected ($300)
Seat 2: Mike_McDonald_@MikeMcDonald89 (button) (small blind) folded before the Flop

PokerStars Hand #11000200040: Tournament #3, Apr29_2017-at-12_33_17 Hold'em No Limit ($150/$300 USD) - 2017/04/29 14:33:56 ET
Table 'ACPC Match' 2-max Seat #1 is the button
Seat 1: DeepStack ($19825 in chips)
Seat 2: Mike_McDonald_@MikeMcDonald89 ($20175 in chips)
DeepStack: posts small blind $150
Mike_McDonald_@MikeMcDonald89: posts big blind $300
*** HOLE CARDS ***
Dealt to DeepStack [Qc 2s]
Dealt to Mike_McDonald_@MikeMcDonald89 [Ac 7s]
DeepStack: calls $150
Mike_McDonald_@MikeMcDonald89: raises $600 to $900
DeepStack: folds
Uncalled bet ($600) returned to Mike_McDonald_@MikeMcDonald89
Mike_McDonald_@MikeMcDonald89 collected $600 from the pot
*** SUMMARY ***
Total pot $600 | Rake $0
Seat 1: DeepStack (button) (small blind) folded before the Flop
Seat 2: Mike_McDonald_@MikeMcDonald89 (big blind) collected ($600)

PokerStars Hand #11000200041: Tournament #3, Apr29_2017-at-12_33_17 Hold'em No Limit ($200/$400 USD) - 2017/04/29 14:33:57 ET
Table 'ACPC Match' 2-max Seat #2 is the button
Seat 1: DeepStack ($19525 in chips)
Seat 2: Mike_McDonald_@MikeMcDonald89 ($20475 in chips)
Mike_McDonald_@MikeMcDonald89: posts small blind $200
DeepStack: posts big blind $400
*** HOLE CARDS ***
Dealt to DeepStack [Tc Qh]
Dealt to Mike_McDonald_@MikeMcDonald89 [2h 4c]
Mike_McDonald_@MikeMcDonald89: folds
Uncalled bet ($200) returned to DeepStack
DeepStack collected $400 from the pot
*** SUMMARY ***
Total pot $400 | Rake $0
Seat 1: DeepStack (big blind) collected ($400)
Seat 2: Mike_McDonald_@MikeMcDonald89 (button) (small blind) folded before the Flop

PokerStars Hand #11000200042: Tournament #3, Apr29_2017-at-12_33_17 Hold'em No Limit ($200/$400 USD) - 2017/04/29 14:33:58 ET
Table 'ACPC Match' 2-max Seat #1 is the button
Seat 1: DeepStack ($19725 in chips)
Seat 2: Mike_McDonald_@MikeMcDonald89 ($20275 in chips)
DeepStack: posts small blind $200
Mike_McDonald_@MikeMcDonald89: posts big blind $400
*** HOLE CARDS ***
Dealt to DeepStack [3d 4h]
Dealt to Mike_McDonald_@MikeMcDonald89 [7s 2h]
DeepStack: folds
Uncalled bet ($200) returned to Mike_McDonald_@MikeMcDonald89
Mike_McDonald_@MikeMcDonald89 collected $400 from the pot
*** SUMMARY ***
Total pot $400 | Rake $0
Seat 1: DeepStack (button) (small blind) folded before the Flop
Seat 2: Mike_McDonald_@MikeMcDonald89 (big blind) collected ($400)

PokerStars Hand #11000200043: Tournament #3, Apr29_2017-at-12_33_17 Hold'em No Limit ($200/$400 USD) - 2017/04/29 14:33:59 ET
Table 'ACPC Match' 2-max Seat #2 is the button
Seat 1: DeepStack ($19525 in chips)
Seat 2: Mike_McDonald_@MikeMcDonald89 ($20475 in chips)
Mike_McDonald_@MikeMcDonald89: posts small blind $200
DeepStack: posts big blind $400
*** HOLE CARDS ***
Dealt to DeepStack [8h 2s]
Dealt to Mike_McDonald_@MikeMcDonald89 [Td 6h]
Mike_McDonald_@MikeMcDonald89: raises $600 to $1000
DeepStack: folds
Uncalled bet ($600) returned to Mike_McDonald_@MikeMcDonald89
Mike_McDonald_@MikeMcDonald89 collected $800 from the pot
*** SUMMARY ***
Total pot $800 | Rake $0
Seat 1: DeepStack (big blind) folded before the Flop
Seat 2: Mike_McDonald_@MikeMcDonald89 (button) (small blind) collected ($800)

PokerStars Hand #11000200044: Tournament #3, Apr29_2017-at-12_33_17 Hold'em No Limit ($200/$400 USD) - 2017/04/29 14:34:00 ET
Table 'ACPC Match' 2-max Seat #1 is the button
Seat 1: DeepStack ($19125 in chips)
Seat 2: Mike_McDonald_@MikeMcDonald89 ($20875 in chips)
DeepStack: posts small blind $200
Mike_McDonald_@MikeMcDonald89: posts big blind $400
*** HOLE CARDS ***
Dealt to DeepStack [8h 5d]
Dealt to Mike_McDonald_@MikeMcDonald89 [Qh 6c]
DeepStack: raises $400 to $800
Mike_McDonald_@MikeMcDonald89: calls $400
*** FLOP **** [7s 8d Qc]
Mike_McDonald_@MikeMcDonald89: checks
DeepStack: checks
*** TURN **** [9d]
Mike_McDonald_@MikeMcDonald89: bets $1200
DeepStack: raises $2000 to $3200
Mike_McDonald_@MikeMcDonald89: calls $2000
*** RIVER **** [Th]
Mike_McDonald_@MikeMcDonald89: checks
DeepStack: checks
*** SHOW DOWN ***
Mike_McDonald_@MikeMcDonald89: shows [Qh 6c] (straight, Ten high)
DeepStack: shows [8h 5d] (a pair of Eights)
Mike_McDonald_@MikeMcDonald89 collected $8000 from pot
*** SUMMARY ***
Total pot $8000 | Rake $0
Board [7s 8d Qc 9d Th]
Seat 1: DeepStack (button) (small blind) showed [8h 5d] and lost with a pair of Eights
Seat 2: Mike_McDonald_@MikeMcDonald89 (big blind) showed [Qh 6c] and won ($8000) with straight, Ten high

PokerStars Hand #11000200045: Tournament #3, Apr29_2017-at-12_33_17 Hold'em No Limit ($200/$400 USD) - 2017/04/29 14:34:01 ET
Table 'ACPC Match' 2-max Seat #2 is the button
Seat 1: DeepStack ($15125 in chips)
Seat 2: Mike_McDonald_@MikeMcDonald89 ($24875 in chips)
Mike_McDonald_@MikeMcDonald89: posts small blind $200
DeepStack: posts big blind $400
*** HOLE CARDS ***
Dealt to DeepStack [Td 8d]
Dealt to Mike_McDonald_@MikeMcDonald89 [4s 9c]
Mike_McDonald_@MikeMcDonald89: folds
Uncalled bet ($200) returned to DeepStack
DeepStack collected $400 from the pot
*** SUMMARY ***
Total pot $400 | Rake $0
Seat 1: DeepStack (big blind) collected ($400)
Seat 2: Mike_McDonald_@MikeMcDonald89 (button) (small blind) folded before the Flop

PokerStars Hand #11000200046: Tournament #3, Apr29_2017-at-12_33_17 Hold'em No Limit ($200/$400 USD) - 2017/04/29 14:34:02 ET
Table 'ACPC Match' 2-max Seat #1 is the button
Seat 1: DeepStack ($15325 in chips)
Seat 2: Mike_McDonald_@MikeMcDonald89 ($24675 in chips)
DeepStack: posts small blind $200
Mike_McDonald_@MikeMcDonald89: posts big blind $400
*** HOLE CARDS ***
Dealt to DeepStack [2h 3s]
Dealt to Mike_McDonald_@MikeMcDonald89 [Kc 4d]
DeepStack: folds
Uncalled bet ($200) returned to Mike_McDonald_@MikeMcDonald89
Mike_McDonald_@MikeMcDonald89 collected $400 from the pot
*** SUMMARY ***
Total pot $400 | Rake $0
Seat 1: DeepStack (button) (small blind) folded before the Flop
Seat 2: Mike_McDonald_@MikeMcDonald89 (big blind) collected ($400)

PokerStars Hand #11000200047: Tournament #3, Apr29_2017-at-12_33_17 Hold'em No Limit ($200/$400 USD) - 2017/04/29 14:34:03 ET
Table 'ACPC Match' 2-max Seat #2 is the button
Seat 1: DeepStack ($15125 in chips)
Seat 2: Mike_McDonald_@MikeMcDonald89 ($24875 in chips)
Mike_McDonald_@MikeMcDonald89: posts small blind $200
DeepStack: posts big blind $400
*** HOLE CARDS ***
Dealt to DeepStack [Js 8d]
Dealt to Mike_McDonald_@MikeMcDonald89 [8s 5h]
Mike_McDonald_@MikeMcDonald89: raises $600 to $1000
DeepStack: raises $2000 to $3000
Mike_McDonald_@MikeMcDonald89: folds
Uncalled bet ($2000) returned to DeepStack
DeepStack collected $2000 from the pot
*** SUMMARY ***
Total pot $2000 | Rake $0
Seat 1: DeepStack (big blind) collected ($2000)
Seat 2: Mike_McDonald_@MikeMcDonald89 (button) (small blind) folded before the Flop

PokerStars Hand #11000200048: Tournament #3, Apr29_2017-at-12_33_17 Hold'em No Limit ($200/$400 USD) - 2017/04/29 14:34:04 ET
Table 'ACPC Match' 2-max Seat #1 is the button
Seat 1: DeepStack ($16125 in chips)
Seat 2: Mike_McDonald_@MikeMcDonald89 ($23875 in chips)
DeepStack: posts small blind $200
Mike_McDonald_@MikeMcDonald89: posts big blind $400
*** HOLE CARDS ***
Dealt to DeepStack [6d Ks]
Dealt to Mike_McDonald_@MikeMcDonald89 [4c 3h]
DeepStack: calls $200
Mike_McDonald_@MikeMcDonald89: raises $1200 to $1600
DeepStack: calls $1200
*** FLOP **** [9c Qc Kh]
Mike_McDonald_@MikeMcDonald89: checks
DeepStack: checks
*** TURN **** [8d]
Mike_McDonald_@MikeMcDonald89: checks
DeepStack: checks
*** RIVER **** [5d]
Mike_McDonald_@MikeMcDonald89: bets $1600
DeepStack: calls $1600
*** SHOW DOWN ***
Mike_McDonald_@MikeMcDonald89: shows [4c 3h] (King high)
DeepStack: shows [6d Ks] (a pair of Kings)
DeepStack collected $6400 from pot
*** SUMMARY ***
Total pot $6400 | Rake $0
Board [9c Qc Kh 8d 5d]
Seat 1: DeepStack (button) (small blind) showed [6d Ks] and won ($6400) with a pair of Kings
Seat 2: Mike_McDonald_@MikeMcDonald89 (big blind) showed [4c 3h] and lost with King high

PokerStars Hand #11000200049: Tournament #3, Apr29_2017-at-12_33_17 Hold'em No Limit ($200/$400 USD) - 2017/04/29 14:34:05 ET
Table 'ACPC Match' 2-max Seat #2 is the button
Seat 1: DeepStack ($19325 in chips)
Seat 2: Mike_McDonald_@MikeMcDonald89 ($20675 in chips)
Mike_McDonald_@MikeMcDonald89: posts small blind $200
DeepStack: posts big blind $400
*** HOLE CARDS ***
Dealt to DeepStack [4s Kc]
Dealt to Mike_McDonald_@MikeMcDonald89 [Td 7c]
Mike_McDonald_@MikeMcDonald89: raises $600 to $1000
DeepStack: calls $600
*** FLOP **** [Ks 8s 5c]
DeepStack: checks
Mike_McDonald_@MikeMcDonald89: checks
*** TURN **** [Qh]
DeepStack: checks
Mike_McDonald_@MikeMcDonald89: checks
*** RIVER **** [6c]
DeepStack: bets $2000
Mike_McDonald_@MikeMcDonald89: folds
Uncalled bet ($2000) returned to DeepStack
DeepStack collected $2000 from the pot
*** SUMMARY ***
Total pot $2000 | Rake $0
Board [Ks 8s 5c Qh 6c]
Seat 1: DeepStack (big blind) collected ($2000)
Seat 2: Mike_McDonald_@MikeMcDonald89 (button) (small blind) folded on the River

PokerStars Hand #11000200050: Tournament #3, Apr29_2017-at-12_33_17 Hold'em No Limit ($200/$400 USD) - 2017/04/29 14:34:06 ET
Table 'ACPC Match' 2-max Seat #1 is the button
Seat 1: DeepStack ($20325 in chips)
Seat 2: Mike_McDonald_@MikeMcDonald89 ($19675 in chips)
DeepStack: posts small blind $200
Mike_McDonald_@MikeMcDonald89: posts big blind $400
*** HOLE CARDS ***
Dealt to DeepStack [6s Kh]
Dealt to Mike_McDonald_@MikeMcDonald89 [9c 2d]
DeepStack: raises $800 to $1200
Mike_McDonald_@MikeMcDonald89: folds
Uncalled bet ($800) returned to DeepStack
DeepStack collected $800 from the pot
*** SUMMARY ***
Total pot $800 | Rake $0
Seat 1: DeepStack (button) (small blind) collected ($800)
Seat 2: Mike_McDonald_@MikeMcDonald89 (big blind) folded before the Flop

PokerStars Hand #11000200051: Tournament #3, Apr29_2017-at-12_33_17 Hold'em No Limit ($300/$600 USD) - 2017/04/29 14:34:07 ET
Table 'ACPC Match' 2-max Seat #2 is the button
Seat 1: DeepStack ($20725 in chips)
Seat 2: Mike_McDonald_@MikeMcDonald89 ($19275 in chips)
Mike_McDonald_@MikeMcDonald89: posts small blind $300
DeepStack: posts big blind $600
*** HOLE CARDS ***
Dealt to DeepStack [Qd 8d]
Dealt to Mike_McDonald_@MikeMcDonald89 [6s 8s]
Mike_McDonald_@MikeMcDonald89: raises $800 to $1400
DeepStack: calls $800
*** FLOP **** [Ad Js 4d]
DeepStack: bets $1400
Mike_McDonald_@MikeMcDonald89: calls $1400
*** TURN **** [9c]
DeepStack: bets $2800
Mike_McDonald_@MikeMcDonald89: folds
Uncalled bet ($2800) returned to DeepStack
DeepStack collected $5600 from the pot
*** SUMMARY ***
Total pot $5600 | Rake $0
Board [Ad Js 4d 9c]
Seat 1: DeepStack (big blind) collected ($5600)
Seat 2: Mike_McDonald_@MikeMcDonald89 (button) (small blind) folded on the Turn

PokerStars Hand #11000200052: Tournament #3, Apr29_2017-at-12_33_17 Hold'em No Limit ($300/$600 USD) - 2017/04/29 14:34:08 ET
Table 'ACPC Match' 2-max Seat #1 is the button
Seat 1: DeepStack ($23525 in chips)
Seat 2: Mike_McDonald_@MikeMcDonald89 ($16475 in chips)
DeepStack: posts small blind $300
Mike_McDonald_@MikeMcDonald89: posts big blind $600
*** HOLE CARDS ***
Dealt to DeepStack [4h 4s]
Dealt to Mike_McDonald_@MikeMcDonald89 [6s Qh]
DeepStack: calls $300
Mike_McDonald_@MikeMcDonald89: checks
*** FLOP **** [Ks 3h Jc]
Mike_McDonald_@MikeMcDonald89: checks
DeepStack: checks
*** TURN **** [As]
Mike_McDonald_@MikeMcDonald89: checks
DeepStack: checks
*** RIVER **** [Ac]
Mike_McDonald_@MikeMcDonald89: checks
DeepStack: raises $1200 to $1200
Mike_McDonald_@MikeMcDonald89: folds
Uncalled bet ($1200) returned to DeepStack
DeepStack collected $1200 from the pot
*** SUMMARY ***
Total pot $1200 | Rake $0
Board [Ks 3h Jc As Ac]
Seat 1: DeepStack (button) (small blind) collected ($1200)
Seat 2: Mike_McDonald_@MikeMcDonald89 (big blind) folded on the River

PokerStars Hand #11000200053: Tournament #3, Apr29_2017-at-12_33_17 Hold'em No Limit ($300/$600 USD) - 2017/04/29 14:34:09 ET
Table 'ACPC Match' 2-max Seat #2 is the button
Seat 1: DeepStack ($24125 in chips)
Seat 2: Mike_McDonald_@MikeMcDonald89 ($15875 in chips)
Mike_McDonald_@MikeMcDonald89: posts small blind $300
DeepStack: posts big blind $600
*** HOLE CARDS ***
Dealt to DeepStack [9d Ad]
Dealt to Mike_McDonald_@MikeMcDonald89 [Ts 8c]
Mike_McDonald_@MikeMcDonald89: calls $300
DeepStack: raises $1200 to $1800
Mike_McDonald_@MikeMcDonald89: calls $1200
*** FLOP **** [3h Jc As]
DeepStack: bets $1800
Mike_McDonald_@MikeMcDonald89: folds
Uncalled bet ($1800) returned to DeepStack
DeepStack collected $3600 from the pot
*** SUMMARY ***
Total pot $3600 | Rake $0
Board [3h Jc As]
Seat 1: DeepStack (big blind) collected ($3600)
Seat 2: Mike_McDonald_@MikeMcDonald89 (button) (small blind) folded on the Flop

PokerStars Hand #11000200054: Tournament #3, Apr29_2017-at-12_33_17 Hold'em No Limit ($300/$600 USD) - 2017/04/29 14:34:10 ET
Table 'ACPC Match' 2-max Seat #1 is the button
Seat 1: DeepStack ($25925 in chips)
Seat 2: Mike_McDonald_@MikeMcDonald89 ($14075 in chips)
DeepStack: posts small blind $300
Mike_McDonald_@MikeMcDonald89: posts big blind $600
*** HOLE CARDS ***
Dealt to DeepStack [Ts 7c]
Dealt to Mike_McDonald_@MikeMcDonald89 [Qh 2c]
DeepStack: raises $600 to $1200
Mike_McDonald_@MikeMcDonald89: folds
Uncalled bet ($600) returned to DeepStack
DeepStack collected $1200 from the pot
*** SUMMARY ***
Total pot $1200 | Rake $0
Seat 1: DeepStack (button) (small blind) collected ($1200)
Seat 2: Mike_McDonald_@MikeMcDonald89 (big blind) folded before the Flop

PokerStars Hand #11000200055: Tournament #3, Apr29_2017-at-12_33_17 Hold'em No Limit ($300/$600 USD) - 2017/04/29 14:34:11 ET
Table 'ACPC Match' 2-max Seat #2 is the button
Seat 1: DeepStack ($26525 in chips)
Seat 2: Mike_McDonald_@MikeMcDonald89 ($13475 in chips)
Mike_McDonald_@MikeMcDonald89: posts small blind $300
DeepStack: posts big blind $600
*** HOLE CARDS ***
Dealt to DeepStack [2c 9c]
Dealt to Mike_McDonald_@MikeMcDonald89 [Qh Tc]
Mike_McDonald_@MikeMcDonald89: calls $300
DeepStack: checks
*** FLOP **** [Ac 9s 9h]
DeepStack: checks
Mike_McDonald_@MikeMcDonald89: raises $600 to $600
DeepStack: raises $2400 to $3000
Mike_McDonald_@MikeMcDonald89: folds
Uncalled bet ($2400) returned to DeepStack
DeepStack collected $2400 from the pot
*** SUMMARY ***
Total pot $2400 | Rake $0
Board [Ac 9s 9h]
Seat 1: DeepStack (big blind) collected ($2400)
Seat 2: Mike_McDonald_@MikeMcDonald89 (button) (small blind) folded on the Flop

PokerStars Hand #11000200056: Tournament #3, Apr29_2017-at-12_33_17 Hold'em No Limit ($300/$600 USD) - 2017/04/29 14:34:12 ET
Table 'ACPC Match' 2-max Seat #1 is the button
Seat 1: DeepStack ($27725 in chips)
Seat 2: Mike_McDonald_@MikeMcDonald89 ($12275 in chips)
DeepStack: posts small blind $300
Mike_McDonald_@MikeMcDonald89: posts big blind $600
*** HOLE CARDS ***
Dealt to DeepStack [Qh 3c]
Dealt to Mike_McDonald_@MikeMcDonald89 [Qc Jd]
DeepStack: calls $300
Mike_McDonald_@MikeMcDonald89: raises $1000 to $1600
DeepStack: calls $1000
*** FLOP **** [4h Kh 7s]
Mike_McDonald_@MikeMcDonald89: checks
DeepStack: raises $1600 to $1600
Mike_McDonald_@MikeMcDonald89: folds
Uncalled bet ($1600) returned to DeepStack
DeepStack collected $3200 from the pot
*** SUMMARY ***
Total pot $3200 | Rake $0
Board [4h Kh 7s]
Seat 1: DeepStack (button) (small blind) collected ($3200)
Seat 2: Mike_McDonald_@MikeMcDonald89 (big blind) folded on the Flop

PokerStars Hand #11000200057: Tournament #3, Apr29_2017-at-12_33_17 Hold'em No Limit ($300/$600 USD) - 2017/04/29 14:34:13 ET
Table 'ACPC Match' 2-max Seat #2 is the button
Seat 1: DeepStack ($29325 in chips)
Seat 2: Mike_McDonald_@MikeMcDonald89 ($10675 in chips)
Mike_McDonald_@MikeMcDonald89: posts small blind $300
DeepStack: posts big blind $600
*** HOLE CARDS ***
Dealt to DeepStack [3h 7h]
Dealt to Mike_McDonald_@MikeMcDonald89 [2c As]
Mike_McDonald_@MikeMcDonald89: raises $10075 to $10675 and is all-in
DeepStack: folds
Uncalled bet ($10075) returned to Mike_McDonald_@MikeMcDonald89
Mike_McDonald_@MikeMcDonald89 collected $1200 from the pot
*** SUMMARY ***
Total pot $1200 | Rake $0
Seat 1: DeepStack (big blind) folded before the Flop
Seat 2: Mike_McDonald_@MikeMcDonald89 (button) (small blind) collected ($1200)

PokerStars Hand #11000200058: Tournament #3, Apr29_2017-at-12_33_17 Hold'em No Limit ($300/$600 USD) - 2017/04/29 14:34:14 ET
Table 'ACPC Match' 2-max Seat #1 is the button
Seat 1: DeepStack ($28725 in chips)
Seat 2: Mike_McDonald_@MikeMcDonald89 ($11275 in chips)
DeepStack: posts small blind $300
Mike_McDonald_@MikeMcDonald89: posts big blind $600
*** HOLE CARDS ***
Dealt to DeepStack [Ad Ks]
Dealt to Mike_McDonald_@MikeMcDonald89 [6h 9h]
DeepStack: raises $600 to $1200
Mike_McDonald_@MikeMcDonald89: raises $10075 to $11275 and is all-in
DeepStack: calls $10075
*** FLOP **** [7c 5h Jd]
*** TURN **** [9s]
*** RIVER **** [6d]
*** SHOW DOWN ***
Mike_McDonald_@MikeMcDonald89: shows [6h 9h] (two pair, Nines and Sixes)
DeepStack: shows [Ad Ks] (Ace high)
Mike_McDonald_@MikeMcDonald89 collected $22550 from pot
*** SUMMARY ***
Total pot $22550 | Rake $0
Board [7c 5h Jd 9s 6d]
Seat 1: DeepStack (button) (small blind) showed [Ad Ks] and lost with Ace high
Seat 2: Mike_McDonald_@MikeMcDonald89 (big blind) showed [6h 9h] and won ($22550) with two pair, Nines and Sixes

PokerStars Hand #11000200059: Tournament #3, Apr29_2017-at-12_33_17 Hold'em No Limit ($300/$600 USD) - 2017/04/29 14:34:15 ET
Table 'ACPC Match' 2-max Seat #2 is the button
Seat 1: DeepStack ($17450 in chips)
Seat 2: Mike_McDonald_@MikeMcDonald89 ($22550 in chips)
Mike_McDonald_@MikeMcDonald89: posts small blind $300
DeepStack: posts big blind $600
*** HOLE CARDS ***
Dealt to DeepStack [Jc 4d]
Dealt to Mike_McDonald_@MikeMcDonald89 [7c 8d]
Mike_McDonald_@MikeMcDonald89: calls $300
DeepStack: checks
*** FLOP **** [9c Ah 8s]
DeepStack: checks
Mike_McDonald_@MikeMcDonald89: checks
*** TURN **** [Js]
DeepStack: checks
Mike_McDonald_@MikeMcDonald89: checks
*** RIVER **** [8h]
DeepStack: bets $1200
Mike_McDonald_@MikeMcDonald89: raises $2400 to $3600
DeepStack: folds
Uncalled bet ($2400) returned to Mike_McDonald_@MikeMcDonald89
Mike_McDonald_@MikeMcDonald89 collected $3600 from the pot
*** SUMMARY ***
Total pot $3600 | Rake $0
Board [9c Ah 8s Js 8h]
Seat 1: DeepStack (big blind) folded on the River
Seat 2: Mike_McDonald_@MikeMcDonald89 (button) (small blind) collected ($3600)

PokerStars Hand #11000200060: Tournament #3, Apr29_2017-at-12_33_17 Hold'em No Limit ($300/$600 USD) - 2017/04/29 14:34:16 ET
Table 'ACPC Match' 2-max Seat #1 is the button
Seat 1: DeepStack ($15650 in chips)
Seat 2: Mike_McDonald_@MikeMcDonald89 ($24350 in chips)
DeepStack: posts small blind $300
Mike_McDonald_@MikeMcDonald89: posts big blind $600
*** HOLE CARDS ***
Dealt to DeepStack [6h 5s]
Dealt to Mike_McDonald_@MikeMcDonald89 [9c 6c]
DeepStack: raises $600 to $1200
Mike_McDonald_@MikeMcDonald89: raises $23150 to $24350 and is all-in
DeepStack: folds
Uncalled bet ($23150) returned to Mike_McDonald_@MikeMcDonald89
Mike_McDonald_@MikeMcDonald89 collected $2400 from the pot
*** SUMMARY ***
Total pot $2400 | Rake $0
Seat 1: DeepStack (button) (small blind) folded before the Flop
Seat 2: Mike_McDonald_@MikeMcDonald89 (big blind) collected ($2400)

PokerStars Hand #11000200061: Tournament #3, Apr29_2017-at-12_33_17 Hold'em No Limit ($400/$800 USD) - 2017/04/29 14:34:17 ET
Table 'ACPC Match' 2-max Seat #2 is the button
Seat 1: DeepStack ($14450 in chips)
Seat 2: Mike_McDonald_@MikeMcDonald89 ($25550 in chips)
Mike_McDonald_@MikeMcDonald89: posts small blind $400
DeepStack: posts big blind $800
*** HOLE CARDS ***
Dealt to DeepStack [2d Qh]
Dealt to Mike_McDonald_@MikeMcDonald89 [5h Th]
Mike_McDonald_@MikeMcDonald89: raises $24750 to $25550 and is all-in
DeepStack: folds
Uncalled bet ($24750) returned to Mike_McDonald_@MikeMcDonald89
Mike_McDonald_@MikeMcDonald89 collected $1600 from the pot
*** SUMMARY ***
Total pot $1600 | Rake $0
Seat 1: DeepStack (big blind) folded before the Flop
Seat 2: Mike_McDonald_@MikeMcDonald89 (button) (small blind) collected ($1600)

PokerStars Hand #11000200062: Tournament #3, Apr29_2017-at-12_33_17 Hold'em No Limit ($400/$800 USD) - 2017/04/29 14:34:18 ET
Table 'ACPC Match' 2-max Seat #1 is the button
Seat 1: DeepStack ($13650 in chips)
Seat 2: Mike_McDonald_@MikeMcDonald89 ($26350 in chips)
DeepStack: posts small blind $400
Mike_McDonald_@MikeMcDonald89: posts big blind $800
*** HOLE CARDS ***
Dealt to DeepStack [6d 8c]
Dealt to Mike_McDonald_@MikeMcDonald89 [Jd 7h]
DeepStack: calls $400
Mike_McDonald_@MikeMcDonald89: checks
*** FLOP **** [7s Ts 8h]
Mike_McDonald_@MikeMcDonald89: checks
DeepStack: raises $800 to $800
Mike_McDonald_@MikeMcDonald89: calls $800
*** TURN **** [7d]
Mike_McDonald_@MikeMcDonald89: checks
DeepStack: checks
*** RIVER **** [Kd]
Mike_McDonald_@MikeMcDonald89: checks
DeepStack: checks
*** SHOW DOWN ***
Mike_McDonald_@MikeMcDonald89: shows [Jd 7h] (three of a kind, Sevens)
DeepStack: shows [6d 8c] (two pair, Eights and Sevens)
Mike_McDonald_@MikeMcDonald89 collected $3200 from pot
*** SUMMARY ***
Total pot $3200 | Rake $0
Board [7s Ts 8h 7d Kd]
Seat 1: DeepStack (button) (small blind) showed [6d 8c] and lost with two pair, Eights and Sevens
Seat 2: Mike_McDonald_@MikeMcDonald89 (big blind) showed [Jd 7h] and won ($3200) with three of a kind, Sevens

PokerStars Hand #11000200063: Tournament #3, Apr29_2017-at-12_33_17 Hold'em No Limit ($400/$800 USD) - 2017/04/29 14:34:19 ET
Table 'ACPC Match' 2-max Seat #2 is the button
Seat 1: DeepStack ($12050 in chips)
Seat 2: Mike_McDonald_@MikeMcDonald89 ($27950 in chips)
Mike_McDonald_@MikeMcDonald89: posts small blind $400
DeepStack: posts big blind $800
*** HOLE CARDS ***
Dealt to DeepStack [2c 7d]
Dealt to Mike_McDonald_@MikeMcDonald89 [9s Ts]
Mike_McDonald_@MikeMcDonald89: raises $27150 to $27950 and is all-in
DeepStack: folds
Uncalled bet ($27150) returned to Mike_McDonald_@MikeMcDonald89
Mike_McDonald_@MikeMcDonald89 collected $1600 from the pot
*** SUMMARY ***
Total pot $1600 | Rake $0
Seat 1: DeepStack (big blind) folded before the Flop
Seat 2: Mike_McDonald_@MikeMcDonald89 (button) (small blind) collected ($1600)

PokerStars Hand #11000200064: Tournament #3, Apr29_2017-at-12_33_17 Hold'em No Limit ($400/$800 USD) - 2017/04/29 14:34:20 ET
Table 'ACPC Match' 2-max Seat #1 is the button
Seat 1: DeepStack ($11250 in chips)
Seat 2: Mike_McDonald_@MikeMcDonald89 ($28750 in chips)
DeepStack: posts small blind $400
Mike_McDonald_@MikeMcDonald89: posts big blind $800
*** HOLE CARDS ***
Dealt to DeepStack [6h 3h]
Dealt to Mike_McDonald_@MikeMcDonald89 [3c 8h]
DeepStack: calls $400
Mike_McDonald_@MikeMcDonald89: raises $1400 to $2200
DeepStack: calls $1400
*** FLOP **** [Kd Kc 5d]
Mike_McDonald_@MikeMcDonald89: bets $1400
DeepStack: folds
Uncalled bet ($1400) returned to Mike_McDonald_@MikeMcDonald89
Mike_McDonald_@MikeMcDonald89 collected $4400 from the pot
*** SUMMARY ***
Total pot $4400 | Rake $0
Board [Kd Kc 5d]
Seat 1: DeepStack (button) (small blind) folded on the Flop
Seat 2: Mike_McDonald_@MikeMcDonald89 (big blind) collected ($4400)

PokerStars Hand #11000200065: Tournament #3, Apr29_2017-at-12_33_17 Hold'em No Limit ($400/$800 USD) - 2017/04/29 14:34:21 ET
Table 'ACPC Match' 2-max Seat #2 is the button
Seat 1: DeepStack ($9050 in chips)
Seat 2: Mike_McDonald_@MikeMcDonald89 ($30950 in chips)
Mike_McDonald_@MikeMcDonald89: posts small blind $400
DeepStack: posts big blind $800
*** HOLE CARDS ***
Dealt to DeepStack [Kh 9s]
Dealt to Mike_McDonald_@MikeMcDonald89 [2h 2s]
Mike_McDonald_@MikeMcDonald89: raises $30150 to $30950 and is all-in
DeepStack: calls $8250 and is all-in
Uncalled bet ($21900) returned to Mike_McDonald_@MikeMcDonald89
*** FLOP **** [Ts 5h 9h]
*** TURN **** [Qs]
*** RIVER **** [As]
*** SHOW DOWN ***
Mike_McDonald_@MikeMcDonald89: shows [2h 2s] (a pair of Deuces)
DeepStack: shows [Kh 9s] (a pair of Nines)
DeepStack collected $18100 from pot
*** SUMMARY ***
Total pot $18100 | Rake $0
Board [Ts 5h 9h Qs As]
Seat 1: DeepStack (big blind) showed [Kh 9s] and won ($18100) with a pair of Nines
Seat 2: Mike_McDonald_@MikeMcDonald89 (button) (small blind) showed [2h 2s] and lost with a pair of Deuces

PokerStars Hand #11000200066: Tournament #3, Apr29_2017-at-12_33_17 Hold'em No Limit ($400/$800 USD) - 2017/04/29 14:34:22 ET
Table 'ACPC Match' 2-max Seat #1 is the button
Seat 1: DeepStack ($18100 in chips)
Seat 2: Mike_McDonald_@MikeMcDonald89 ($21900 in chips)
DeepStack: posts small blind $400
Mike_McDonald_@MikeMcDonald89: posts big blind $800
*** HOLE CARDS ***
Dealt to DeepStack [9h 6d]
Dealt to Mike_McDonald_@MikeMcDonald89 [Qc 2c]
DeepStack: calls $400
Mike_McDonald_@MikeMcDonald89: checks
*** FLOP **** [8d Th Kc]
Mike_McDonald_@MikeMcDonald89: checks
DeepStack: raises $800 to $800
Mike_McDonald_@MikeMcDonald89: folds
Uncalled bet ($800) returned to DeepStack
DeepStack collected $1600 from the pot
*** SUMMARY ***
Total pot $1600 | Rake $0
Board [8d Th Kc]
Seat 1: DeepStack (button) (small blind) collected ($1600)
Seat 2: Mike_McDonald_@MikeMcDonald89 (big blind) folded on the Flop

PokerStars Hand #11000200067: Tournament #3, Apr29_2017-at-12_33_17 Hold'em No Limit ($400/$800 USD) - 2017/04/29 14:34:23 ET
Table 'ACPC Match' 2-max Seat #2 is the button
Seat 1: DeepStack ($18900 in chips)
Seat 2: Mike_McDonald_@MikeMcDonald89 ($21100 in chips)
Mike_McDonald_@MikeMcDonald89: posts small blind $400
DeepStack: posts big blind $800
*** HOLE CARDS ***
Dealt to DeepStack [8c 7s]
Dealt to Mike_McDonald_@MikeMcDonald89 [3s Ac]
Mike_McDonald_@MikeMcDonald89: raises $20300 to $21100 and is all-in
DeepStack: folds
Uncalled bet ($20300) returned to Mike_McDonald_@MikeMcDonald89
Mike_McDonald_@MikeMcDonald89 collected $1600 from the pot
*** SUMMARY ***
Total pot $1600 | Rake $0
Seat 1: DeepStack (big blind) folded before the Flop
Seat 2: Mike_McDonald_@MikeMcDonald89 (button) (small blind) collected ($1600)

PokerStars Hand #11000200068: Tournament #3, Apr29_2017-at-12_33_17 Hold'em No Limit ($400/$800 USD) - 2017/04/29 14:34:24 ET
Table 'ACPC Match' 2-max Seat #1 is the button
Seat 1: DeepStack ($18100 in chips)
Seat 2: Mike_McDonald_@MikeMcDonald89 ($21900 in chips)
DeepStack: posts small blind $400
Mike_McDonald_@MikeMcDonald89: posts big blind $800
*** HOLE CARDS ***
Dealt to DeepStack [6d 3d]
Dealt to Mike_McDonald_@MikeMcDonald89 [Kh 4d]
DeepStack: calls $400
Mike_McDonald_@MikeMcDonald89: checks
*** FLOP **** [9s 3c 5c]
Mike_McDonald_@MikeMcDonald89: checks
DeepStack: checks
*** TURN **** [Ac]
Mike_McDonald_@MikeMcDonald89: checks
DeepStack: checks
*** RIVER **** [Ad]
Mike_McDonald_@MikeMcDonald89: checks
DeepStack: checks
*** SHOW DOWN ***
Mike_McDonald_@MikeMcDonald89: shows [Kh 4d] (a pair of Aces)
DeepStack: shows [6d 3d] (two pair, Aces and Threes)
DeepStack collected $1600 from pot
*** SUMMARY ***
Total pot $1600 | Rake $0
Board [9s 3c 5c Ac Ad]
Seat 1: DeepStack (button) (small blind) showed [6d 3d] and won ($1600) with two pair, Aces and Threes
Seat 2: Mike_McDonald_@MikeMcDonald89 (big blind) showed [Kh 4d] and lost with a pair of Aces

PokerStars Hand #11000200069: Tournament #3, Apr29_2017-at-12_33_17 Hold'em No Limit ($400/$800 USD) - 2017/04/29 14:34:25 ET
Table 'ACPC Match' 2-max Seat #2 is the button
Seat 1: DeepStack ($18900 in chips)
Seat 2: Mike_McDonald_@MikeMcDonald89 ($21100 in chips)
Mike_McDonald_@MikeMcDonald89: posts small blind $400
DeepStack: posts big blind $800
*** HOLE CARDS ***
Dealt to DeepStack [6c 6s]
Dealt to Mike_McDonald_@MikeMcDonald89 [Jh 7c]
Mike_McDonald_@MikeMcDonald89: calls $400
DeepStack: raises $18100 to $18900 and is all-in
Mike_McDonald_@MikeMcDonald89: folds
Uncalled bet ($18100) returned to DeepStack
DeepStack collected $1600 from the pot
*** SUMMARY ***
Total pot $1600 | Rake $0
Seat 1: DeepStack (big blind) collected ($1600)
Seat 2: Mike_McDonald_@MikeMcDonald89 (button) (small blind) folded before the Flop

PokerStars Hand #11000200070: Tournament #3, Apr29_2017-at-12_33_17 Hold'em No Limit ($400/$800 USD) - 2017/04/29 14:34:26 ET
Table 'ACPC Match' 2-max Seat #1 is the button
Seat 1: DeepStack ($19700 in chips)
Seat 2: Mike_McDonald_@MikeMcDonald89 ($20300 in chips)
DeepStack: posts small blind $400
Mike_McDonald_@MikeMcDonald89: posts big blind $800
*** HOLE CARDS ***
Dealt to DeepStack [6c Qs]
Dealt to Mike_McDonald_@MikeMcDonald89 [5d 3c]
DeepStack: calls $400
Mike_McDonald_@MikeMcDonald89: raises $1400 to $2200
DeepStack: calls $1400
*** FLOP **** [5s 9c 6s]
Mike_McDonald_@MikeMcDonald89: checks
DeepStack: checks
*** TURN **** [5h]
Mike_McDonald_@MikeMcDonald89: checks
DeepStack: raises $2200 to $2200
Mike_McDonald_@MikeMcDonald89: calls $2200
*** RIVER **** [Th]
Mike_McDonald_@MikeMcDonald89: checks
DeepStack: checks
*** SHOW DOWN ***
Mike_McDonald_@MikeMcDonald89: shows [5d 3c] (three of a kind, Fives)
DeepStack: shows [6c Qs] (two pair, Sixes and Fives)
Mike_McDonald_@MikeMcDonald89 collected $8800 from pot
*** SUMMARY ***
Total pot $8800 | Rake $0
Board [5s 9c 6s 5h Th]
Seat 1: DeepStack (button) (small blind) showed [6c Qs] and lost with two pair, Sixes and Fives
Seat 2: Mike_McDonald_@MikeMcDonald89 (big blind) showed [5d 3c] and won ($8800) with three of a kind, Fives

PokerStars Hand #11000200071: Tournament #3, Apr29_2017-at-12_33_17 Hold'em No Limit ($500/$1000 USD) - 2017/04/29 14:34:27 ET
Table 'ACPC Match' 2-max Seat #2 is the button
Seat 1: DeepStack ($15300 in chips)
Seat 2: Mike_McDonald_@MikeMcDonald89 ($24700 in chips)
Mike_McDonald_@MikeMcDonald89: posts small blind $500
DeepStack: posts big blind $1000
*** HOLE CARDS ***
Dealt to DeepStack [Js 2h]
Dealt to Mike_McDonald_@MikeMcDonald89 [Tc Kh]
Mike_McDonald_@MikeMcDonald89: raises $1200 to $2200
DeepStack: folds
Uncalled bet ($1200) returned to Mike_McDonald_@MikeMcDonald89
Mike_McDonald_@MikeMcDonald89 collected $2000 from the pot
*** SUMMARY ***
Total pot $2000 | Rake $0
Seat 1: DeepStack (big blind) folded before the Flop
Seat 2: Mike_McDonald_@MikeMcDonald89 (button) (small blind) collected ($2000)

PokerStars Hand #11000200072: Tournament #3, Apr29_2017-at-12_33_17 Hold'em No Limit ($500/$1000 USD) - 2017/04/29 14:34:28 ET
Table 'ACPC Match' 2-max Seat #1 is the button
Seat 1: DeepStack ($14300 in chips)
Seat 2: Mike_McDonald_@MikeMcDonald89 ($25700 in chips)
DeepStack: posts small blind $500
Mike_McDonald_@MikeMcDonald89: posts big blind $1000
*** HOLE CARDS ***
Dealt to DeepStack [Jh 8h]
Dealt to Mike_McDonald_@MikeMcDonald89 [7s 8d]
DeepStack: calls $500
Mike_McDonald_@MikeMcDonald89: checks
*** FLOP **** [5h 9h 6h]
Mike_McDonald_@MikeMcDonald89: checks
DeepStack: checks
*** TURN **** [Ac]
Mike_McDonald_@MikeMcDonald89: checks
DeepStack: checks
*** RIVER **** [4h]
Mike_McDonald_@MikeMcDonald89: checks
DeepStack: raises $2000 to $2000
Mike_McDonald_@MikeMcDonald89: calls $2000
*** SHOW DOWN ***
DeepStack: shows [Jh 8h] (flush, Jack high)
Mike_McDonald_@MikeMcDonald89: shows [7s 8d] (straight, Nine high)
DeepStack collected $6000 from pot
*** SUMMARY ***
Total pot $6000 | Rake $0
Board [5h 9h 6h Ac 4h]
Seat 1: DeepStack (button) (small blind) showed [Jh 8h] and won ($6000) with flush, Jack high
Seat 2: Mike_McDonald_@MikeMcDonald89 (big blind) showed [7s 8d] and lost with straight, Nine high

PokerStars Hand #11000200073: Tournament #3, Apr29_2017-at-12_33_17 Hold'em No Limit ($500/$1000 USD) - 2017/04/29 14:34:29 ET
Table 'ACPC Match' 2-max Seat #2 is the button
Seat 1: DeepStack ($17300 in chips)
Seat 2: Mike_McDonald_@MikeMcDonald89 ($22700 in chips)
Mike_McDonald_@MikeMcDonald89: posts small blind $500
DeepStack: posts big blind $1000
*** HOLE CARDS ***
Dealt to DeepStack [4c Kc]
Dealt to Mike_McDonald_@MikeMcDonald89 [8h Kh]
Mike_McDonald_@MikeMcDonald89: raises $1200 to $2200
DeepStack: raises $15100 to $17300 and is all-in
Mike_McDonald_@MikeMcDonald89: calls $15100
*** FLOP **** [3d 2h Td]
*** TURN **** [Ac]
*** RIVER **** [Tc]
*** SHOW DOWN ***
DeepStack: shows [4c Kc] (a pair of Tens)
Mike_McDonald_@MikeMcDonald89: shows [8h Kh] (a pair of Tens)
Mike_McDonald_@MikeMcDonald89 collected $34600 from pot
*** SUMMARY ***
Total pot $34600 | Rake $0
Board [3d 2h Td Ac Tc]
Seat 1: DeepStack (big blind) showed [4c Kc] and lost with a pair of Tens
Seat 2: Mike_McDonald_@MikeMcDonald89 (button) (small blind) showed [8h Kh] and won ($34600) with a pair of Tens
