PokerStars Hand #11000100001: Tournament #2, Apr29_2017-at-11_44_48 Hold'em No Limit ($50/$100 USD) - 2017/04/29 13:44:48 ET
Table 'ACPC Match' 2-max Seat #2 is the button
Seat 1: DeepStack ($20000 in chips)
Seat 2: Mike_McDonald_@MikeMcDonald89 ($20000 in chips)
Mike_McDonald_@MikeMcDonald89: posts small blind $50
DeepStack: posts big blind $100
*** HOLE CARDS ***
Dealt to DeepStack [3d 7c]
Dealt to Mike_McDonald_@MikeMcDonald89 [4h Qc]
Mike_McDonald_@MikeMcDonald89: raises $150 to $250
DeepStack: folds
Uncalled bet ($150) returned to Mike_McDonald_@MikeMcDonald89
Mike_McDonald_@MikeMcDonald89 collected $200 from the pot
*** SUMMARY ***
Total pot $200 | Rake $0
Seat 1: DeepStack (big blind) folded before the Flop
Seat 2: Mike_McDonald_@MikeMcDonald89 (button) (small blind) collected ($200)

PokerStars Hand #11000100002: Tournament #2, Apr29_2017-at-11_44_48 Hold'em No Limit ($50/$100 USD) - 2017/04/29 13:44:49 ET
Table 'ACPC Match' 2-max Seat #1 is the button
Seat 1: DeepStack ($19900 in chips)
Seat 2: Mike_McDonald_@MikeMcDonald89 ($20100 in chips)
DeepStack: posts small blind $50
Mike_McDonald_@MikeMcDonald89: posts big blind $100
*** HOLE CARDS ***
Dealt to DeepStack [8h 4c]
Dealt to Mike_McDonald_@MikeMcDonald89 [Th 9d]
DeepStack: calls $50
Mike_McDonald_@MikeMcDonald89: checks
*** FLOP **** [As 9h 6c]
Mike_McDonald_@MikeMcDonald89: checks
DeepStack: checks
*** TURN **** [2d]
Mike_McDonald_@MikeMcDonald89: checks
DeepStack: checks
*** RIVER **** [Jh]
Mike_McDonald_@MikeMcDonald89: bets $150
DeepStack: folds
Uncalled bet ($150) returned to Mike_McDonald_@MikeMcDonald89
Mike_McDonald_@MikeMcDonald89 collected $200 from the pot
*** SUMMARY ***
Total pot $200 | Rake $0
Board [As 9h 6c 2d Jh]
Seat 1: DeepStack (button) (small blind) folded on the River
Seat 2: Mike_McDonald_@MikeMcDonald89 (big blind) collected ($200)

PokerStars Hand #11000100003: Tournament #2, Apr29_2017-at-11_44_48 Hold'em No Limit ($50/$100 USD) - 2017/04/29 13:44:50 ET
Table 'ACPC Match' 2-max Seat #2 is the button
Seat 1: DeepStack ($19800 in chips)
Seat 2: Mike_McDonald_@MikeMcDonald89 ($20200 in chips)
Mike_McDonald_@MikeMcDonald89: posts small blind $50
DeepStack: posts big blind $100
*** HOLE CARDS ***
Dealt to DeepStack [5s 9h]
Dealt to Mike_McDonald_@MikeMcDonald89 [Kh 7c]
Mike_McDonald_@MikeMcDonald89: raises $150 to $250
DeepStack: folds
Uncalled bet ($150) returned to Mike_McDonald_@MikeMcDonald89
Mike_McDonald_@MikeMcDonald89 collected $200 from the pot
*** SUMMARY ***
Total pot $200 | Rake $0
Seat 1: DeepStack (big blind) folded before the Flop
Seat 2: Mike_McDonald_@MikeMcDonald89 (button) (small blind) collected ($200)

PokerStars Hand #11000100004: Tournament #2, Apr29_2017-at-11_44_48 Hold'em No Limit ($50/$100 USD) - 2017/04/29 13:44:51 ET
Table 'ACPC Match' 2-max Seat #1 is the button
Seat 1: DeepStack ($19700 in chips)
Seat 2: Mike_McDonald_@MikeMcDonald89 ($20300 in chips)
DeepStack: posts small blind $50
Mike_McDonald_@MikeMcDonald89: posts big blind $100
*** HOLE CARDS ***
Dealt to DeepStack [8h Td]
Dealt to Mike_McDonald_@MikeMcDonald89 [Ah Kh]
DeepStack: raises $100 to $200
Mike_McDonald_@MikeMcDonald89: raises $600 to $800
DeepStack: folds
Uncalled bet ($600) returned to Mike_McDonald_@MikeMcDonald89
Mike_McDonald_@MikeMcDonald89 collected $400 from the pot
*** SUMMARY ***
Total pot $400 | Rake $0
Seat 1: DeepStack (button) (small blind) folded before the Flop
Seat 2: Mike_McDonald_@MikeMcDonald89 (big blind) collected ($400)

PokerStars Hand #11000100005: Tournament #2, Apr29_2017-at-11_44_48 Hold'em No Limit ($50/$100 USD) - 2017/04/29 13:44:52 ET
Table 'ACPC Match' 2-max Seat #2 is the button
Seat 1: DeepStack ($19500 in chips)
Seat 2: Mike_McDonald_@MikeMcDonald89 ($20500 in chips)
Mike_McDonald_@MikeMcDonald89: posts small blind $50
DeepStack: posts big blind $100
*** HOLE CARDS ***
Dealt to DeepStack [8c Ks]
Dealt to Mike_McDonald_@MikeMcDonald89 [Qh Jh]
Mike_McDonald_@MikeMcDonald89: raises $150 to $250
DeepStack: calls $150
*** FLOP **** [7h Kd 6h]
DeepStack: checks
Mike_McDonald_@MikeMcDonald89: raises $250 to $250
DeepStack: calls $250
*** TURN **** [Js]
DeepStack: checks
Mike_McDonald_@MikeMcDonald89: raises $500 to $500
DeepStack: calls $500
*** RIVER **** [5s]
DeepStack: bets $1000
Mike_McDonald_@MikeMcDonald89: folds
Uncalled bet ($1000) returned to DeepStack
DeepStack collected $2000 from the pot
*** SUMMARY ***
Total pot $2000 | Rake $0
Board [7h Kd 6h Js 5s]
Seat 1: DeepStack (big blind) collected ($2000)
Seat 2: Mike_McDonald_@MikeMcDonald89 (button) (small blind) folded on the River

PokerStars Hand #11000100006: Tournament #2, Apr29_2017-at-11_44_48 Hold'em No Limit ($50/$100 USD) - 2017/04/29 13:44:53 ET
Table 'ACPC Match' 2-max Seat #1 is the button
Seat 1: DeepStack ($20500 in chips)
Seat 2: Mike_McDonald_@MikeMcDonald89 ($19500 in chips)
DeepStack: posts small blind $50
Mike_McDonald_@MikeMcDonald89: posts big blind $100
*** HOLE CARDS ***
Dealt to DeepStack [Qh Kh]
Dealt to Mike_McDonald_@MikeMcDonald89 [7d Qc]
DeepStack: raises $200 to $300
Mike_McDonald_@MikeMcDonald89: calls $200
*** FLOP **** [Td Kc 9s]
Mike_McDonald_@MikeMcDonald89: checks
DeepStack: raises $300 to $300
Mike_McDonald_@MikeMcDonald89: calls $300
*** TURN **** [Ks]
Mike_McDonald_@MikeMcDonald89: checks
DeepStack: checks
*** RIVER **** [7h]
Mike_McDonald_@MikeMcDonald89: checks
DeepStack: raises $2400 to $2400
Mike_McDonald_@MikeMcDonald89: folds
Uncalled bet ($2400) returned to DeepStack
DeepStack collected $1200 from the pot
*** SUMMARY ***
Total pot $1200 | Rake $0
Board [Td Kc 9s Ks 7h]
Seat 1: DeepStack (button) (small blind) collected ($1200)
Seat 2: Mike_McDonald_@MikeMcDonald89 (big blind) folded on the River

PokerStars Hand #11000100007: Tournament #2, Apr29_2017-at-11_44_48 Hold'em No Limit ($50/$100 USD) - 2017/04/29 13:44:54 ET
Table 'ACPC Match' 2-max Seat #2 is the button
Seat 1: DeepStack ($21100 in chips)
Seat 2: Mike_McDonald_@MikeMcDonald89 ($18900 in chips)
Mike_McDonald_@MikeMcDonald89: posts small blind $50
DeepStack: posts big blind $100
*** HOLE CARDS ***
Dealt to DeepStack [Td Ts]
Dealt to Mike_McDonald_@MikeMcDonald89 [Qd 9s]
Mike_McDonald_@MikeMcDonald89: raises $150 to $250
DeepStack: raises $500 to $750
Mike_McDonald_@MikeMcDonald89: calls $500
*** FLOP **** [Qc Ks 9d]
DeepStack: checks
Mike_McDonald_@MikeMcDonald89: raises $750 to $750
DeepStack: calls $750
*** TURN **** [Js]
DeepStack: checks
Mike_McDonald_@MikeMcDonald89: checks
*** RIVER **** [6s]
DeepStack: bets $1500
Mike_McDonald_@MikeMcDonald89: calls $1500
*** SHOW DOWN ***
DeepStack: shows [Td Ts] (straight, King high)
Mike_McDonald_@MikeMcDonald89: shows [Qd 9s] (two pair, Queens and Nines)
DeepStack collected $6000 from pot
*** SUMMARY ***
Total pot $6000 | Rake $0
Board [Qc Ks 9d Js 6s]
Seat 1: DeepStack (big blind) showed [Td Ts] and won ($6000) with straight, King high
Seat 2: Mike_McDonald_@MikeMcDonald89 (button) (small blind) showed [Qd 9s] and lost with two pair, Queens and Nines

PokerStars Hand #11000100008: Tournament #2, Apr29_2017-at-11_44_48 Hold'em No Limit ($50/$100 USD) - 2017/04/29 13:44:55 ET
Table 'ACPC Match' 2-max Seat #1 is the button
Seat 1: DeepStack ($24100 in chips)
Seat 2: Mike_McDonald_@MikeMcDonald89 ($15900 in chips)
DeepStack: posts small blind $50
Mike_McDonald_@MikeMcDonald89: posts big blind $100
*** HOLE CARDS ***
Dealt to DeepStack [7h Kc]
Dealt to Mike_McDonald_@MikeMcDonald89 [Ah Th]
DeepStack: raises $200 to $300
Mike_McDonald_@MikeMcDonald89: raises $800 to $1100
DeepStack: folds
Uncalled bet ($800) returned to Mike_McDonald_@MikeMcDonald89
Mike_McDonald_@MikeMcDonald89 collected $600 from the pot
*** SUMMARY ***
Total pot $600 | Rake $0
Seat 1: DeepStack (button) (small blind) folded before the Flop
Seat 2: Mike_McDonald_@MikeMcDonald89 (big blind) collected ($600)

PokerStars Hand #11000100009: Tournament #2, Apr29_2017-at-11_44_48 Hold'em No Limit ($50/$100 USD) - 2017/04/29 13:44:56 ET
Table 'ACPC Match' 2-max Seat #2 is the button
Seat 1: DeepStack ($23800 in chips)
Seat 2: Mike_McDonald_@MikeMcDonald89 ($16200 in chips)
Mike_McDonald_@MikeMcDonald89: posts small blind $50
DeepStack: posts big blind $100
*** HOLE CARDS ***
Dealt to DeepStack [8d Jc]
Dealt to Mike_McDonald_@MikeMcDonald89 [Ad Kh]
Mike_McDonald_@MikeMcDonald89: raises $150 to $250
DeepStack: calls $150
*** FLOP **** [2d 9c 5s]
DeepStack: checks
Mike_McDonald_@MikeMcDonald89: checks
*** TURN **** [7c]
DeepStack: bets $500
Mike_McDonald_@MikeMcDonald89: folds
Uncalled bet ($500) returned to DeepStack
DeepStack collected $500 from the pot
*** SUMMARY ***
Total pot $500 | Rake $0
Board [2d 9c 5s 7c]
Seat 1: DeepStack (big blind) collected ($500)
Seat 2: Mike_McDonald_@MikeMcDonald89 (button) (small blind) folded on the Turn

PokerStars Hand #11000100010: Tournament #2, Apr29_2017-at-11_44_48 Hold'em No Limit ($50/$100 USD) - 2017/04/29 13:44:57 ET
Table 'ACPC Match' 2-max Seat #1 is the button
Seat 1: DeepStack ($24050 in chips)
Seat 2: Mike_McDonald_@MikeMcDonald89 ($15950 in chips)
DeepStack: posts small blind $50
Mike_McDonald_@MikeMcDonald89: posts big blind $100
*** HOLE CARDS ***
Dealt to DeepStack [3c 5s]
Dealt to Mike_McDonald_@MikeMcDonald89 [8d 4d]
DeepStack: calls $50
Mike_McDonald_@MikeMcDonald89: raises $200 to $300
DeepStack: calls $200
*** FLOP **** [Jh 4h 7c]
Mike_McDonald_@MikeMcDonald89: checks
DeepStack: raises $600 to $600
Mike_McDonald_@MikeMcDonald89: calls $600
*** TURN **** [Ac]
Mike_McDonald_@MikeMcDonald89: checks
DeepStack: raises $1800 to $1800
Mike_McDonald_@MikeMcDonald89: folds
Uncalled bet ($1800) returned to DeepStack
DeepStack collected $1800 from the pot
*** SUMMARY ***
Total pot $1800 | Rake $0
Board [Jh 4h 7c Ac]
Seat 1: DeepStack (button) (small blind) collected ($1800)
Seat 2: Mike_McDonald_@MikeMcDonald89 (big blind) folded on the Turn

PokerStars Hand #11000100011: Tournament #2, Apr29_2017-at-11_44_48 Hold'em No Limit ($75/$150 USD) - 2017/04/29 13:44:58 ET
Table 'ACPC Match' 2-max Seat #2 is the button
Seat 1: DeepStack ($24950 in chips)
Seat 2: Mike_McDonald_@MikeMcDonald89 ($15050 in chips)
Mike_McDonald_@MikeMcDonald89: posts small blind $75
DeepStack: posts big blind $150
*** HOLE CARDS ***
Dealt to DeepStack [4s 7d]
Dealt to Mike_McDonald_@MikeMcDonald89 [4c 8c]
Mike_McDonald_@MikeMcDonald89: raises $225 to $375
DeepStack: folds
Uncalled bet ($225) returned to Mike_McDonald_@MikeMcDonald89
Mike_McDonald_@MikeMcDonald89 collected $300 from the pot
*** SUMMARY ***
Total pot $300 | Rake $0
Seat 1: DeepStack (big blind) folded before the Flop
Seat 2: Mike_McDonald_@MikeMcDonald89 (button) (small blind) collected ($300)

PokerStars Hand #11000100012: Tournament #2, Apr29_2017-at-11_44_48 Hold'em No Limit ($75/$150 USD) - 2017/04/29 13:44:59 ET
Table 'ACPC Match' 2-max Seat #1 is the button
Seat 1: DeepStack ($24800 in chips)
Seat 2: Mike_McDonald_@MikeMcDonald89 ($15200 in chips)
DeepStack: posts small blind $75
Mike_McDonald_@MikeMcDonald89: posts big blind $150
*** HOLE CARDS ***
Dealt to DeepStack [Td 4d]
Dealt to Mike_McDonald_@MikeMcDonald89 [Jc Qs]
DeepStack: raises $150 to $300
Mike_McDonald_@MikeMcDonald89: calls $150
*** FLOP **** [Js 2h As]
Mike_McDonald_@MikeMcDonald89: checks
DeepStack: checks
*** TURN **** [9h]
Mike_McDonald_@MikeMcDonald89: bets $300
DeepStack: folds
Uncalled bet ($300) returned to Mike_McDonald_@MikeMcDonald89
Mike_McDonald_@MikeMcDonald89 collected $600 from the pot
*** SUMMARY ***
Total pot $600 | Rake $0
Board [Js 2h As 9h]
Seat 1: DeepStack (button) (small blind) folded on the Turn
Seat 2: Mike_McDonald_@MikeMcDonald89 (big blind) collected ($600)

PokerStars Hand #11000100013: Tournament #2, Apr29_2017-at-11_44_48 Hold'em No Limit ($75/$150 USD) - 2017/04/29 13:45:00 ET
Table 'ACPC Match' 2-max Seat #2 is the button
Seat 1: DeepStack ($24500 in chips)
Seat 2: Mike_McDonald_@MikeMcDonald89 ($15500 in chips)
Mike_McDonald_@MikeMcDonald89: posts small blind $75
DeepStack: posts big blind $150
*** HOLE CARDS ***
Dealt to DeepStack [Ks 5c]
Dealt to Mike_McDonald_@MikeMcDonald89 [Th 2h]
Mike_McDonald_@MikeMcDonald89: raises $225 to $375
DeepStack: calls $225
*** FLOP **** [Ad Tc Ah]
DeepStack: checks
Mike_McDonald_@MikeMcDonald89: checks
*** TURN **** [Td]
DeepStack: checks
Mike_McDonald_@MikeMcDonald89: raises $250 to $250
DeepStack: calls $250
*** RIVER **** [Jh]
DeepStack: checks
Mike_McDonald_@MikeMcDonald89: raises $800 to $800
DeepStack: folds
Uncalled bet ($800) returned to Mike_McDonald_@MikeMcDonald89
Mike_McDonald_@MikeMcDonald89 collected $1250 from the pot
*** SUMMARY ***
Total pot $1250 | Rake $0
Board [Ad Tc Ah Td Jh]
Seat 1: DeepStack (big blind) folded on the River
Seat 2: Mike_McDonald_@MikeMcDonald89 (button) (small blind) collected ($1250)

PokerStars Hand #11000100014: Tournament #2, Apr29_2017-at-11_44_48 Hold'em No Limit ($75/$150 USD) - 2017/04/29 13:45:01 ET
Table 'ACPC Match' 2-max Seat #1 is the button
Seat 1: DeepStack ($23875 in chips)
Seat 2: Mike_McDonald_@MikeMcDonald89 ($16125 in chips)
DeepStack: posts small blind $75
Mike_McDonald_@MikeMcDonald89: posts big blind $150
*** HOLE CARDS ***
Dealt to DeepStack [Kh 7s]
Dealt to Mike_McDonald_@MikeMcDonald89 [Ks Js]
DeepStack: raises $150 to $300
Mike_McDonald_@MikeMcDonald89: raises $900 to $1200
DeepStack: folds
Uncalled bet ($900) returned to Mike_McDonald_@MikeMcDonald89
Mike_McDonald_@MikeMcDonald89 collected $600 from the pot
*** SUMMARY ***
Total pot $600 | Rake $0
Seat 1: DeepStack (button) (small blind) folded before the Flop
Seat 2: Mike_McDonald_@MikeMcDonald89 (big blind) collected ($600)

PokerStars Hand #11000100015: Tournament #2, Apr29_2017-at-11_44_48 Hold'em No Limit ($75/$150 USD) - 2017/04/29 13:45:02 ET
Table 'ACPC Match' 2-max Seat #2 is the button
Seat 1: DeepStack ($23575 in chips)
Seat 2: Mike_McDonald_@MikeMcDonald89 ($16425 in chips)
Mike_McDonald_@MikeMcDonald89: posts small blind $75
DeepStack: posts big blind $150
*** HOLE CARDS ***
Dealt to DeepStack [4c 5h]
Dealt to Mike_McDonald_@MikeMcDonald89 [5c 2s]
Mike_McDonald_@MikeMcDonald89: folds
Uncalled bet ($75) returned to DeepStack
DeepStack collected $150 from the pot
*** SUMMARY ***
Total pot $150 | Rake $0
Seat 1: DeepStack (big blind) collected ($150)
Seat 2: Mike_McDonald_@MikeMcDonald89 (button) (small blind) folded before the Flop

PokerStars Hand #11000100016: Tournament #2, Apr29_2017-at-11_44_48 Hold'em No Limit ($75/$150 USD) - 2017/04/29 13:45:03 ET
Table 'ACPC Match' 2-max Seat #1 is the button
Seat 1: DeepStack ($23650 in chips)
Seat 2: Mike_McDonald_@MikeMcDonald89 ($16350 in chips)
DeepStack: posts small blind $75
Mike_McDonald_@MikeMcDonald89: posts big blind $150
*** HOLE CARDS ***
Dealt to DeepStack [8h Kd]
Dealt to Mike_McDonald_@MikeMcDonald89 [6d 9c]
DeepStack: raises $150 to $300
Mike_McDonald_@MikeMcDonald89: calls $150
*** FLOP **** [4s Kh Td]
Mike_McDonald_@MikeMcDonald89: checks
DeepStack: checks
*** TURN **** [7s]
Mike_McDonald_@MikeMcDonald89: bets $450
DeepStack: calls $450
*** RIVER **** [2d]
Mike_McDonald_@MikeMcDonald89: bets $1500
DeepStack: calls $1500
*** SHOW DOWN ***
Mike_McDonald_@MikeMcDonald89: shows [6d 9c] (King high)
DeepStack: shows [8h Kd] (a pair of Kings)
DeepStack collected $4500 from pot
*** SUMMARY ***
Total pot $4500 | Rake $0
Board [4s Kh Td 7s 2d]
Seat 1: DeepStack (button) (small blind) showed [8h Kd] and won ($4500) with a pair of Kings
Seat 2: Mike_McDonald_@MikeMcDonald89 (big blind) showed [6d 9c] and lost with King high

PokerStars Hand #11000100017: Tournament #2, Apr29_2017-at-11_44_48 Hold'em No Limit ($75/$150 USD) - 2017/04/29 13:45:04 ET
Table 'ACPC Match' 2-max Seat #2 is the button
Seat 1: DeepStack ($25900 in chips)
Seat 2: Mike_McDonald_@MikeMcDonald89 ($14100 in chips)
Mike_McDonald_@MikeMcDonald89: posts small blind $75
DeepStack: posts big blind $150
*** HOLE CARDS ***
Dealt to DeepStack [6c 9c]
Dealt to Mike_McDonald_@MikeMcDonald89 [6h Ad]
Mike_McDonald_@MikeMcDonald89: raises $225 to $375
DeepStack: calls $225
*** FLOP **** [3d 5c Qc]
DeepStack: checks
Mike_McDonald_@MikeMcDonald89: checks
*** TURN **** [2h]
DeepStack: checks
Mike_McDonald_@MikeMcDonald89: checks
*** RIVER **** [9s]
DeepStack: bets $375
Mike_McDonald_@MikeMcDonald89: calls $375
*** SHOW DOWN ***
DeepStack: shows [6c 9c] (a pair of Nines)
Mike_McDonald_@MikeMcDonald89: shows [6h Ad] (Ace high)
DeepStack collected $1500 from pot
*** SUMMARY ***
Total pot $1500 | Rake $0
Board [3d 5c Qc 2h 9s]
Seat 1: DeepStack (big blind) showed [6c 9c] and won ($1500) with a pair of Nines
Seat 2: Mike_McDonald_@MikeMcDonald89 (button) (small blind) showed [6h Ad] and lost with Ace high

PokerStars Hand #11000100018: Tournament #2, Apr29_2017-at-11_44_48 Hold'em No Limit ($75/$150 USD) - 2017/04/29 13:45:05 ET
Table 'ACPC Match' 2-max Seat #1 is the button
Seat 1: DeepStack ($26650 in chips)
Seat 2: Mike_McDonald_@MikeMcDonald89 ($13350 in chips)
DeepStack: posts small blind $75
Mike_McDonald_@MikeMcDonald89: posts big blind $150
*** HOLE CARDS ***
Dealt to DeepStack [Kc Qd]
Dealt to Mike_McDonald_@MikeMcDonald89 [Th 2s]
DeepStack: raises $300 to $450
Mike_McDonald_@MikeMcDonald89: folds
Uncalled bet ($300) returned to DeepStack
DeepStack collected $300 from the pot
*** SUMMARY ***
Total pot $300 | Rake $0
Seat 1: DeepStack (button) (small blind) collected ($300)
Seat 2: Mike_McDonald_@MikeMcDonald89 (big blind) folded before the Flop

PokerStars Hand #11000100019: Tournament #2, Apr29_2017-at-11_44_48 Hold'em No Limit ($75/$150 USD) - 2017/04/29 13:45:06 ET
Table 'ACPC Match' 2-max Seat #2 is the button
Seat 1: DeepStack ($26800 in chips)
Seat 2: Mike_McDonald_@MikeMcDonald89 ($13200 in chips)
Mike_McDonald_@MikeMcDonald89: posts small blind $75
DeepStack: posts big blind $150
*** HOLE CARDS ***
Dealt to DeepStack [4s 3d]
Dealt to Mike_McDonald_@MikeMcDonald89 [5d Qs]
Mike_McDonald_@MikeMcDonald89: folds
Uncalled bet ($75) returned to DeepStack
DeepStack collected $150 from the pot
*** SUMMARY ***
Total pot $150 | Rake $0
Seat 1: DeepStack (big blind) collected ($150)
Seat 2: Mike_McDonald_@MikeMcDonald89 (button) (small blind) folded before the Flop

PokerStars Hand #11000100020: Tournament #2, Apr29_2017-at-11_44_48 Hold'em No Limit ($75/$150 USD) - 2017/04/29 13:45:07 ET
Table 'ACPC Match' 2-max Seat #1 is the button
Seat 1: DeepStack ($26875 in chips)
Seat 2: Mike_McDonald_@MikeMcDonald89 ($13125 in chips)
DeepStack: posts small blind $75
Mike_McDonald_@MikeMcDonald89: posts big blind $150
*** HOLE CARDS ***
Dealt to DeepStack [7h 4c]
Dealt to Mike_McDonald_@MikeMcDonald89 [Kd 5c]
DeepStack: calls $75
Mike_McDonald_@MikeMcDonald89: checks
*** FLOP **** [Jh 4d 6h]
Mike_McDonald_@MikeMcDonald89: checks
DeepStack: checks
*** TURN **** [9h]
Mike_McDonald_@MikeMcDonald89: checks
DeepStack: checks
*** RIVER **** [Kh]
Mike_McDonald_@MikeMcDonald89: checks
DeepStack: raises $300 to $300
Mike_McDonald_@MikeMcDonald89: calls $300
*** SHOW DOWN ***
DeepStack: shows [7h 4c] (flush, King high)
Mike_McDonald_@MikeMcDonald89: shows [Kd 5c] (a pair of Kings)
DeepStack collected $900 from pot
*** SUMMARY ***
Total pot $900 | Rake $0
Board [Jh 4d 6h 9h Kh]
Seat 1: DeepStack (button) (small blind) showed [7h 4c] and won ($900) with flush, King high
Seat 2: Mike_McDonald_@MikeMcDonald89 (big blind) showed [Kd 5c] and lost with a pair of Kings

PokerStars Hand #11000100021: Tournament #2, Apr29_2017-at-11_44_48 Hold'em No Limit ($100/$200 USD) - 2017/04/29 13:45:08 ET
Table 'ACPC Match' 2-max Seat #2 is the button
Seat 1: DeepStack ($27325 in chips)
Seat 2: Mike_McDonald_@MikeMcDonald89 ($12675 in chips)
Mike_McDonald_@MikeMcDonald89: posts small blind $100
DeepStack: posts big blind $200
*** HOLE CARDS ***
Dealt to DeepStack [Kd 6d]
Dealt to Mike_McDonald_@MikeMcDonald89 [7c Jh]
Mike_McDonald_@MikeMcDonald89: raises $300 to $500
DeepStack: raises $1000 to $1500
Mike_McDonald_@MikeMcDonald89: folds
Uncalled bet ($1000) returned to DeepStack
DeepStack collected $1000 from the pot
*** SUMMARY ***
Total pot $1000 | Rake $0
Seat 1: DeepStack (big blind) collected ($1000)
Seat 2: Mike_McDonald_@MikeMcDonald89 (button) (small blind) folded before the Flop

PokerStars Hand #11000100022: Tournament #2, Apr29_2017-at-11_44_48 Hold'em No Limit ($100/$200 USD) - 2017/04/29 13:45:09 ET
Table 'ACPC Match' 2-max Seat #1 is the button
Seat 1: DeepStack ($27825 in chips)
Seat 2: Mike_McDonald_@MikeMcDonald89 ($12175 in chips)
DeepStack: posts small blind $100
Mike_McDonald_@MikeMcDonald89: posts big blind $200
*** HOLE CARDS ***
Dealt to DeepStack [8s 4d]
Dealt to Mike_McDonald_@MikeMcDonald89 [8h Jd]
DeepStack: calls $100
Mike_McDonald_@MikeMcDonald89: checks
*** FLOP **** [Ah Ad 2s]
Mike_McDonald_@MikeMcDonald89: checks
DeepStack: raises $200 to $200
Mike_McDonald_@MikeMcDonald89: folds
Uncalled bet ($200) returned to DeepStack
DeepStack collected $400 from the pot
*** SUMMARY ***
Total pot $400 | Rake $0
Board [Ah Ad 2s]
Seat 1: DeepStack (button) (small blind) collected ($400)
Seat 2: Mike_McDonald_@MikeMcDonald89 (big blind) folded on the Flop

PokerStars Hand #11000100023: Tournament #2, Apr29_2017-at-11_44_48 Hold'em No Limit ($100/$200 USD) - 2017/04/29 13:45:10 ET
Table 'ACPC Match' 2-max Seat #2 is the button
Seat 1: DeepStack ($28025 in chips)
Seat 2: Mike_McDonald_@MikeMcDonald89 ($11975 in chips)
Mike_McDonald_@MikeMcDonald89: posts small blind $100
DeepStack: posts big blind $200
*** HOLE CARDS ***
Dealt to DeepStack [Kh Qs]
Dealt to Mike_McDonald_@MikeMcDonald89 [Jh Th]
Mike_McDonald_@MikeMcDonald89: raises $300 to $500
DeepStack: raises $1000 to $1500
Mike_McDonald_@MikeMcDonald89: calls $1000
*** FLOP **** [Jd 8c Qc]
DeepStack: bets $1500
Mike_McDonald_@MikeMcDonald89: calls $1500
*** TURN **** [Ad]
DeepStack: checks
Mike_McDonald_@MikeMcDonald89: checks
*** RIVER **** [Ac]
DeepStack: checks
Mike_McDonald_@MikeMcDonald89: checks
*** SHOW DOWN ***
DeepStack: shows [Kh Qs] (two pair, Aces and Queens)
Mike_McDonald_@MikeMcDonald89: shows [Jh Th] (two pair, Aces and Jacks)
DeepStack collected $6000 from pot
*** SUMMARY ***
Total pot $6000 | Rake $0
Board [Jd 8c Qc Ad Ac]
Seat 1: DeepStack (big blind) showed [Kh Qs] and won ($6000) with two pair, Aces and Queens
Seat 2: Mike_McDonald_@MikeMcDonald89 (button) (small blind) showed [Jh Th] and lost with two pair, Aces and Jacks

PokerStars Hand #11000100024: Tournament #2, Apr29_2017-at-11_44_48 Hold'em No Limit ($100/$200 USD) - 2017/04/29 13:45:11 ET
Table 'ACPC Match' 2-max Seat #1 is the button
Seat 1: DeepStack ($31025 in chips)
Seat 2: Mike_McDonald_@MikeMcDonald89 ($8975 in chips)
DeepStack: posts small blind $100
Mike_McDonald_@MikeMcDonald89: posts big blind $200
*** HOLE CARDS ***
Dealt to DeepStack [Ks 3h]
Dealt to Mike_McDonald_@MikeMcDonald89 [Jd 8h]
DeepStack: raises $200 to $400
Mike_McDonald_@MikeMcDonald89: calls $200
*** FLOP **** [5s Qh Js]
Mike_McDonald_@MikeMcDonald89: checks
DeepStack: raises $800 to $800
Mike_McDonald_@MikeMcDonald89: calls $800
*** TURN **** [7c]
Mike_McDonald_@MikeMcDonald89: checks
DeepStack: checks
*** RIVER **** [2c]
Mike_McDonald_@MikeMcDonald89: bets $800
DeepStack: folds
Uncalled bet ($800) returned to Mike_McDonald_@MikeMcDonald89
Mike_McDonald_@MikeMcDonald89 collected $2400 from the pot
*** SUMMARY ***
Total pot $2400 | Rake $0
Board [5s Qh Js 7c 2c]
Seat 1: DeepStack (button) (small blind) folded on the River
Seat 2: Mike_McDonald_@MikeMcDonald89 (big blind) collected ($2400)

PokerStars Hand #11000100025: Tournament #2, Apr29_2017-at-11_44_48 Hold'em No Limit ($100/$200 USD) - 2017/04/29 13:45:12 ET
Table 'ACPC Match' 2-max Seat #2 is the button
Seat 1: DeepStack ($29825 in chips)
Seat 2: Mike_McDonald_@MikeMcDonald89 ($10175 in chips)
Mike_McDonald_@MikeMcDonald89: posts small blind $100
DeepStack: posts big blind $200
*** HOLE CARDS ***
Dealt to DeepStack [Td 3d]
Dealt to Mike_McDonald_@MikeMcDonald89 [Kd 6c]
Mike_McDonald_@MikeMcDonald89: raises $300 to $500
DeepStack: calls $300
*** FLOP **** [8c 5d 2c]
DeepStack: checks
Mike_McDonald_@MikeMcDonald89: checks
*** TURN **** [Th]
DeepStack: bets $999
Mike_McDonald_@MikeMcDonald89: folds
Uncalled bet ($999) returned to DeepStack
DeepStack collected $1000 from the pot
*** SUMMARY ***
Total pot $1000 | Rake $0
Board [8c 5d 2c Th]
Seat 1: DeepStack (big blind) collected ($1000)
Seat 2: Mike_McDonald_@MikeMcDonald89 (button) (small blind) folded on the Turn

PokerStars Hand #11000100026: Tournament #2, Apr29_2017-at-11_44_48 Hold'em No Limit ($100/$200 USD) - 2017/04/29 13:45:13 ET
Table 'ACPC Match' 2-max Seat #1 is the button
Seat 1: DeepStack ($30325 in chips)
Seat 2: Mike_McDonald_@MikeMcDonald89 ($9675 in chips)
DeepStack: posts small blind $100
Mike_McDonald_@MikeMcDonald89: posts big blind $200
*** HOLE CARDS ***
Dealt to DeepStack [8h 5c]
Dealt to Mike_McDonald_@MikeMcDonald89 [Td Kd]
DeepStack: raises $200 to $400
Mike_McDonald_@MikeMcDonald89: raises $800 to $1200
DeepStack: folds
Uncalled bet ($800) returned to Mike_McDonald_@MikeMcDonald89
Mike_McDonald_@MikeMcDonald89 collected $800 from the pot
*** SUMMARY ***
Total pot $800 | Rake $0
Seat 1: DeepStack (button) (small blind) folded before the Flop
Seat 2: Mike_McDonald_@MikeMcDonald89 (big blind) collected ($800)

PokerStars Hand #11000100027: Tournament #2, Apr29_2017-at-11_44_48 Hold'em No Limit ($100/$200 USD) - 2017/04/29 13:45:14 ET
Table 'ACPC Match' 2-max Seat #2 is the button
Seat 1: DeepStack ($29925 in chips)
Seat 2: Mike_McDonald_@MikeMcDonald89 ($10075 in chips)
Mike_McDonald_@MikeMcDonald89: posts small blind $100
DeepStack: posts big blind $200
*** HOLE CARDS ***
Dealt to DeepStack [9c Qd]
Dealt to Mike_McDonald_@MikeMcDonald89 [2s Qc]
Mike_McDonald_@MikeMcDonald89: raises $300 to $500
DeepStack: calls $300
*** FLOP **** [Ac Td Kc]
DeepStack: checks
Mike_McDonald_@MikeMcDonald89: raises $500 to $500
DeepStack: calls $500
*** TURN **** [9s]
DeepStack: checks
Mike_McDonald_@MikeMcDonald89: raises $1500 to $1500
DeepStack: calls $1500
*** RIVER **** [7s]
DeepStack: checks
Mike_McDonald_@MikeMcDonald89: raises $3750 to $3750
DeepStack: folds
Uncalled bet ($3750) returned to Mike_McDonald_@MikeMcDonald89
Mike_McDonald_@MikeMcDonald89 collected $5000 from the pot
*** SUMMARY ***
Total pot $5000 | Rake $0
Board [Ac Td Kc 9s 7s]
Seat 1: DeepStack (big blind) folded on the River
Seat 2: Mike_McDonald_@MikeMcDonald89 (button) (small blind) collected ($5000)

PokerStars Hand #11000100028: Tournament #2, Apr29_2017-at-11_44_48 Hold'em No Limit ($100/$200 USD) - 2017/04/29 13:45:15 ET
Table 'ACPC Match' 2-max Seat #1 is the button
Seat 1: DeepStack ($27425 in chips)
Seat 2: Mike_McDonald_@MikeMcDonald89 ($12575 in chips)
DeepStack: posts small blind $100
Mike_McDonald_@MikeMcDonald89: posts big blind $200
*** HOLE CARDS ***
Dealt to DeepStack [6d 8s]
Dealt to Mike_McDonald_@MikeMcDonald89 [7c 4h]
DeepStack: raises $200 to $400
Mike_McDonald_@MikeMcDonald89: calls $200
*** FLOP **** [Jd 6h 3h]
Mike_McDonald_@MikeMcDonald89: checks
DeepStack: checks
*** TURN **** [7s]
Mike_McDonald_@MikeMcDonald89: checks
DeepStack: checks
*** RIVER **** [5s]
Mike_McDonald_@MikeMcDonald89: bets $400
DeepStack: calls $400
*** SHOW DOWN ***
Mike_McDonald_@MikeMcDonald89: shows [7c 4h] (straight, Seven high)
DeepStack: shows [6d 8s] (a pair of Sixes)
Mike_McDonald_@MikeMcDonald89 collected $1600 from pot
*** SUMMARY ***
Total pot $1600 | Rake $0
Board [Jd 6h 3h 7s 5s]
Seat 1: DeepStack (button) (small blind) showed [6d 8s] and lost with a pair of Sixes
Seat 2: Mike_McDonald_@MikeMcDonald89 (big blind) showed [7c 4h] and won ($1600) with straight, Seven high

PokerStars Hand #11000100029: Tournament #2, Apr29_2017-at-11_44_48 Hold'em No Limit ($100/$200 USD) - 2017/04/29 13:45:16 ET
Table 'ACPC Match' 2-max Seat #2 is the button
Seat 1: DeepStack ($26625 in chips)
Seat 2: Mike_McDonald_@MikeMcDonald89 ($13375 in chips)
Mike_McDonald_@MikeMcDonald89: posts small blind $100
DeepStack: posts big blind $200
*** HOLE CARDS ***
Dealt to DeepStack [Js Ac]
Dealt to Mike_McDonald_@MikeMcDonald89 [9d 8d]
Mike_McDonald_@MikeMcDonald89: raises $300 to $500
DeepStack: raises $1000 to $1500
Mike_McDonald_@MikeMcDonald89: raises $11875 to $13375 and is all-in
DeepStack: folds
Uncalled bet ($11875) returned to Mike_McDonald_@MikeMcDonald89
Mike_McDonald_@MikeMcDonald89 collected $3000 from the pot
*** SUMMARY ***
Total pot $3000 | Rake $0
Seat 1: DeepStack (big blind) folded before the Flop
Seat 2: Mike_McDonald_@MikeMcDonald89 (button) (small blind) collected ($3000)

PokerStars Hand #11000100030: Tournament #2, Apr29_2017-at-11_44_48 Hold'em No Limit ($100/$200 USD) - 2017/04/29 13:45:17 ET
Table 'ACPC Match' 2-max Seat #1 is the button
Seat 1: DeepStack ($25125 in chips)
Seat 2: Mike_McDonald_@MikeMcDonald89 ($14875 in chips)
DeepStack: posts small blind $100
Mike_McDonald_@MikeMcDonald89: posts big blind $200
*** HOLE CARDS ***
Dealt to DeepStack [Jh Qc]
Dealt to Mike_McDonald_@MikeMcDonald89 [Ac 2s]
DeepStack: raises $200 to $400
Mike_McDonald_@MikeMcDonald89: calls $200
*** FLOP **** [Th As Td]
Mike_McDonald_@MikeMcDonald89: checks
DeepStack: raises $400 to $400
Mike_McDonald_@MikeMcDonald89: calls $400
*** TURN **** [4h]
Mike_McDonald_@MikeMcDonald89: checks
DeepStack: raises $800 to $800
Mike_McDonald_@MikeMcDonald89: calls $800
*** RIVER **** [6d]
Mike_McDonald_@MikeMcDonald89: checks
DeepStack: checks
*** SHOW DOWN ***
Mike_McDonald_@MikeMcDonald89: shows [Ac 2s] (two pair, Aces and Tens)
DeepStack: shows [Jh Qc] (a pair of Tens)
Mike_McDonald_@MikeMcDonald89 collected $3200 from pot
*** SUMMARY ***
Total pot $3200 | Rake $0
Board [Th As Td 4h 6d]
Seat 1: DeepStack (button) (small blind) showed [Jh Qc] and lost with a pair of Tens
Seat 2: Mike_McDonald_@MikeMcDonald89 (big blind) showed [Ac 2s] and won ($3200) with two pair, Aces and Tens

PokerStars Hand #11000100031: Tournament #2, Apr29_2017-at-11_44_48 Hold'em No Limit ($150/$300 USD) - 2017/04/29 13:45:18 ET
Table 'ACPC Match' 2-max Seat #2 is the button
Seat 1: DeepStack ($23525 in chips)
Seat 2: Mike_McDonald_@MikeMcDonald89 ($16475 in chips)
Mike_McDonald_@MikeMcDonald89: posts small blind $150
DeepStack: posts big blind $300
*** HOLE CARDS ***
Dealt to DeepStack [Ts Tc]
Dealt to Mike_McDonald_@MikeMcDonald89 [8c 5c]
Mike_McDonald_@MikeMcDonald89: raises $450 to $750
DeepStack: raises $1500 to $2250
Mike_McDonald_@MikeMcDonald89: calls $1500
*** FLOP **** [Jh 3d Ad]
DeepStack: checks
Mike_McDonald_@MikeMcDonald89: checks
*** TURN **** [Kh]
DeepStack: checks
Mike_McDonald_@MikeMcDonald89: checks
*** RIVER **** [As]
DeepStack: checks
Mike_McDonald_@MikeMcDonald89: raises $2250 to $2250
DeepStack: calls $2250
*** SHOW DOWN ***
Mike_McDonald_@MikeMcDonald89: shows [8c 5c] (a pair of Aces)
DeepStack: shows [Ts Tc] (two pair, Aces and Tens)
DeepStack collected $9000 from pot
*** SUMMARY ***
Total pot $9000 | Rake $0
Board [Jh 3d Ad Kh As]
Seat 1: DeepStack (big blind) showed [Ts Tc] and won ($9000) with two pair, Aces and Tens
Seat 2: Mike_McDonald_@MikeMcDonald89 (button) (small blind) showed [8c 5c] and lost with a pair of Aces

PokerStars Hand #11000100032: Tournament #2, Apr29_2017-at-11_44_48 Hold'em No Limit ($150/$300 USD) - 2017/04/29 13:45:19 ET
Table 'ACPC Match' 2-max Seat #1 is the button
Seat 1: DeepStack ($28025 in chips)
Seat 2: Mike_McDonald_@MikeMcDonald89 ($11975 in chips)
DeepStack: posts small blind $150
Mike_McDonald_@MikeMcDonald89: posts big blind $300
*** HOLE CARDS ***
Dealt to DeepStack [Td 6d]
Dealt to Mike_McDonald_@MikeMcDonald89 [8s 4h]
DeepStack: raises $300 to $600
Mike_McDonald_@MikeMcDonald89: folds
Uncalled bet ($300) returned to DeepStack
DeepStack collected $600 from the pot
*** SUMMARY ***
Total pot $600 | Rake $0
Seat 1: DeepStack (button) (small blind) collected ($600)
Seat 2: Mike_McDonald_@MikeMcDonald89 (big blind) folded before the Flop

PokerStars Hand #11000100033: Tournament #2, Apr29_2017-at-11_44_48 Hold'em No Limit ($150/$300 USD) - 2017/04/29 13:45:20 ET
Table 'ACPC Match' 2-max Seat #2 is the button
Seat 1: DeepStack ($28325 in chips)
Seat 2: Mike_McDonald_@MikeMcDonald89 ($11675 in chips)
Mike_McDonald_@MikeMcDonald89: posts small blind $150
DeepStack: posts big blind $300
*** HOLE CARDS ***
Dealt to DeepStack [5s Td]
Dealt to Mike_McDonald_@MikeMcDonald89 [Qc 4d]
Mike_McDonald_@MikeMcDonald89: raises $450 to $750
DeepStack: folds
Uncalled bet ($450) returned to Mike_McDonald_@MikeMcDonald89
Mike_McDonald_@MikeMcDonald89 collected $600 from the pot
*** SUMMARY ***
Total pot $600 | Rake $0
Seat 1: DeepStack (big blind) folded before the Flop
Seat 2: Mike_McDonald_@MikeMcDonald89 (button) (small blind) collected ($600)

PokerStars Hand #11000100034: Tournament #2, Apr29_2017-at-11_44_48 Hold'em No Limit ($150/$300 USD) - 2017/04/29 13:45:21 ET
Table 'ACPC Match' 2-max Seat #1 is the button
Seat 1: DeepStack ($28025 in chips)
Seat 2: Mike_McDonald_@MikeMcDonald89 ($11975 in chips)
DeepStack: posts small blind $150
Mike_McDonald_@MikeMcDonald89: posts big blind $300
*** HOLE CARDS ***
Dealt to DeepStack [Td Kd]
Dealt to Mike_McDonald_@MikeMcDonald89 [9c 3c]
DeepStack: raises $300 to $600
Mike_McDonald_@MikeMcDonald89: raises $1200 to $1800
DeepStack: calls $1200
*** FLOP **** [6h 7h 3d]
Mike_McDonald_@MikeMcDonald89: checks
DeepStack: checks
*** TURN **** [As]
Mike_McDonald_@MikeMcDonald89: checks
DeepStack: checks
*** RIVER **** [7c]
Mike_McDonald_@MikeMcDonald89: checks
DeepStack: checks
*** SHOW DOWN ***
Mike_McDonald_@MikeMcDonald89: shows [9c 3c] (two pair, Sevens and Threes)
DeepStack: shows [Td Kd] (a pair of Sevens)
Mike_McDonald_@MikeMcDonald89 collected $3600 from pot
*** SUMMARY ***
Total pot $3600 | Rake $0
Board [6h 7h 3d As 7c]
Seat 1: DeepStack (button) (small blind) showed [Td Kd] and lost with a pair of Sevens
Seat 2: Mike_McDonald_@MikeMcDonald89 (big blind) showed [9c 3c] and won ($3600) with two pair, Sevens and Threes

PokerStars Hand #11000100035: Tournament #2, Apr29_2017-at-11_44_48 Hold'em No Limit ($150/$300 USD) - 2017/04/29 13:45:22 ET
Table 'ACPC Match' 2-max Seat #2 is the button
Seat 1: DeepStack ($26225 in chips)
Seat 2: Mike_McDonald_@MikeMcDonald89 ($13775 in chips)
Mike_McDonald_@MikeMcDonald89: posts small blind $150
DeepStack: posts big blind $300
*** HOLE CARDS ***
Dealt to DeepStack [Qs 7d]
Dealt to Mike_McDonald_@MikeMcDonald89 [Kc 4h]
Mike_McDonald_@MikeMcDonald89: raises $450 to $750
DeepStack: calls $450
*** FLOP **** [3s Ah Jh]
DeepStack: checks
Mike_McDonald_@MikeMcDonald89: checks
*** TURN **** [5d]
DeepStack: checks
Mike_McDonald_@MikeMcDonald89: checks
*** RIVER **** [Jc]
DeepStack: checks
Mike_McDonald_@MikeMcDonald89: checks
*** SHOW DOWN ***
DeepStack: shows [Qs 7d] (a pair of Jacks)
Mike_McDonald_@MikeMcDonald89: shows [Kc 4h] (a pair of Jacks)
Mike_McDonald_@MikeMcDonald89 collected $1500 from pot
*** SUMMARY ***
Total pot $1500 | Rake $0
Board [3s Ah Jh 5d Jc]
Seat 1: DeepStack (big blind) showed [Qs 7d] and lost with a pair of Jacks
Seat 2: Mike_McDonald_@MikeMcDonald89 (button) (small blind) showed [Kc 4h] and won ($1500) with a pair of Jacks

PokerStars Hand #11000100036: Tournament #2, Apr29_2017-at-11_44_48 Hold'em No Limit ($150/$300 USD) - 2017/04/29 13:45:23 ET
Table 'ACPC Match' 2-max Seat #1 is the button
Seat 1: DeepStack ($25475 in chips)
Seat 2: Mike_McDonald_@MikeMcDonald89 ($14525 in chips)
DeepStack: posts small blind $150
Mike_McDonald_@MikeMcDonald89: posts big blind $300
*** HOLE CARDS ***
Dealt to DeepStack [Kh Qc]
Dealt to Mike_McDonald_@MikeMcDonald89 [5h 9d]
DeepStack: raises $300 to $600
Mike_McDonald_@MikeMcDonald89: calls $300
*** FLOP **** [Jc 6c Ad]
Mike_McDonald_@MikeMcDonald89: checks
DeepStack: raises $1200 to $1200
Mike_McDonald_@MikeMcDonald89: folds
Uncalled bet ($1200) returned to DeepStack
DeepStack collected $1200 from the pot
*** SUMMARY ***
Total pot $1200 | Rake $0
Board [Jc 6c Ad]
Seat 1: DeepStack (button) (small blind) collected ($1200)
Seat 2: Mike_McDonald_@MikeMcDonald89 (big blind) folded on the Flop

PokerStars Hand #11000100037: Tournament #2, Apr29_2017-at-11_44_48 Hold'em No Limit ($150/$300 USD) - 2017/04/29 13:45:24 ET
Table 'ACPC Match' 2-max Seat #2 is the button
Seat 1: DeepStack ($26075 in chips)
Seat 2: Mike_McDonald_@MikeMcDonald89 ($13925 in chips)
Mike_McDonald_@MikeMcDonald89: posts small blind $150
DeepStack: posts big blind $300
*** HOLE CARDS ***
Dealt to DeepStack [8d 5s]
Dealt to Mike_McDonald_@MikeMcDonald89 [6c 5c]
Mike_McDonald_@MikeMcDonald89: raises $450 to $750
DeepStack: folds
Uncalled bet ($450) returned to Mike_McDonald_@MikeMcDonald89
Mike_McDonald_@MikeMcDonald89 collected $600 from the pot
*** SUMMARY ***
Total pot $600 | Rake $0
Seat 1: DeepStack (big blind) folded before the Flop
Seat 2: Mike_McDonald_@MikeMcDonald89 (button) (small blind) collected ($600)

PokerStars Hand #11000100038: Tournament #2, Apr29_2017-at-11_44_48 Hold'em No Limit ($150/$300 USD) - 2017/04/29 13:45:25 ET
Table 'ACPC Match' 2-max Seat #1 is the button
Seat 1: DeepStack ($25775 in chips)
Seat 2: Mike_McDonald_@MikeMcDonald89 ($14225 in chips)
DeepStack: posts small blind $150
Mike_McDonald_@MikeMcDonald89: posts big blind $300
*** HOLE CARDS ***
Dealt to DeepStack [Qh Ts]
Dealt to Mike_McDonald_@MikeMcDonald89 [Qs 2d]
DeepStack: calls $150
Mike_McDonald_@MikeMcDonald89: checks
*** FLOP **** [Jd As 9h]
Mike_McDonald_@MikeMcDonald89: checks
DeepStack: raises $300 to $300
Mike_McDonald_@MikeMcDonald89: folds
Uncalled bet ($300) returned to DeepStack
DeepStack collected $600 from the pot
*** SUMMARY ***
Total pot $600 | Rake $0
Board [Jd As 9h]
Seat 1: DeepStack (button) (small blind) collected ($600)
Seat 2: Mike_McDonald_@MikeMcDonald89 (big blind) folded on the Flop

PokerStars Hand #11000100039: Tournament #2, Apr29_2017-at-11_44_48 Hold'em No Limit ($150/$300 USD) - 2017/04/29 13:45:26 ET
Table 'ACPC Match' 2-max Seat #2 is the button
Seat 1: DeepStack ($26075 in chips)
Seat 2: Mike_McDonald_@MikeMcDonald89 ($13925 in chips)
Mike_McDonald_@MikeMcDonald89: posts small blind $150
DeepStack: posts big blind $300
*** HOLE CARDS ***
Dealt to DeepStack [6c Qc]
Dealt to Mike_McDonald_@MikeMcDonald89 [Qs 6s]
Mike_McDonald_@MikeMcDonald89: raises $450 to $750
DeepStack: raises $1500 to $2250
Mike_McDonald_@MikeMcDonald89: calls $1500
*** FLOP **** [Kd 5s Ad]
DeepStack: checks
Mike_McDonald_@MikeMcDonald89: checks
*** TURN **** [5d]
DeepStack: checks
Mike_McDonald_@MikeMcDonald89: checks
*** RIVER **** [Jd]
DeepStack: bets $2250
Mike_McDonald_@MikeMcDonald89: folds
Uncalled bet ($2250) returned to DeepStack
DeepStack collected $4500 from the pot
*** SUMMARY ***
Total pot $4500 | Rake $0
Board [Kd 5s Ad 5d Jd]
Seat 1: DeepStack (big blind) collected ($4500)
Seat 2: Mike_McDonald_@MikeMcDonald89 (button) (small blind) folded on the River

PokerStars Hand #11000100040: Tournament #2, Apr29_2017-at-11_44_48 Hold'em No Limit ($150/$300 USD) - 2017/04/29 13:45:27 ET
Table 'ACPC Match' 2-max Seat #1 is the button
Seat 1: DeepStack ($28325 in chips)
Seat 2: Mike_McDonald_@MikeMcDonald89 ($11675 in chips)
DeepStack: posts small blind $150
Mike_McDonald_@MikeMcDonald89: posts big blind $300
*** HOLE CARDS ***
Dealt to DeepStack [2h Ac]
Dealt to Mike_McDonald_@MikeMcDonald89 [As 3h]
DeepStack: raises $300 to $600
Mike_McDonald_@MikeMcDonald89: calls $300
*** FLOP **** [7h Kc 4c]
Mike_McDonald_@MikeMcDonald89: checks
DeepStack: raises $600 to $600
Mike_McDonald_@MikeMcDonald89: calls $600
*** TURN **** [Js]
Mike_McDonald_@MikeMcDonald89: checks
DeepStack: raises $1200 to $1200
Mike_McDonald_@MikeMcDonald89: folds
Uncalled bet ($1200) returned to DeepStack
DeepStack collected $2400 from the pot
*** SUMMARY ***
Total pot $2400 | Rake $0
Board [7h Kc 4c Js]
Seat 1: DeepStack (button) (small blind) collected ($2400)
Seat 2: Mike_McDonald_@MikeMcDonald89 (big blind) folded on the Turn

PokerStars Hand #11000100041: Tournament #2, Apr29_2017-at-11_44_48 Hold'em No Limit ($200/$400 USD) - 2017/04/29 13:45:28 ET
Table 'ACPC Match' 2-max Seat #2 is the button
Seat 1: DeepStack ($29525 in chips)
Seat 2: Mike_McDonald_@MikeMcDonald89 ($10475 in chips)
Mike_McDonald_@MikeMcDonald89: posts small blind $200
DeepStack: posts big blind $400
*** HOLE CARDS ***
Dealt to DeepStack [2c 2d]
Dealt to Mike_McDonald_@MikeMcDonald89 [Qs 9c]
Mike_McDonald_@MikeMcDonald89: raises $500 to $900
DeepStack: raises $9575 to $10475
Mike_McDonald_@MikeMcDonald89: folds
Uncalled bet ($9575) returned to DeepStack
DeepStack collected $1800 from the pot
*** SUMMARY ***
Total pot $1800 | Rake $0
Seat 1: DeepStack (big blind) collected ($1800)
Seat 2: Mike_McDonald_@MikeMcDonald89 (button) (small blind) folded before the Flop

PokerStars Hand #11000100042: Tournament #2, Apr29_2017-at-11_44_48 Hold'em No Limit ($200/$400 USD) - 2017/04/29 13:45:29 ET
Table 'ACPC Match' 2-max Seat #1 is the button
Seat 1: DeepStack ($30425 in chips)
Seat 2: Mike_McDonald_@MikeMcDonald89 ($9575 in chips)
DeepStack: posts small blind $200
Mike_McDonald_@MikeMcDonald89: posts big blind $400
*** HOLE CARDS ***
Dealt to DeepStack [2h 2d]
Dealt to Mike_McDonald_@MikeMcDonald89 [7c 3h]
DeepStack: calls $200
Mike_McDonald_@MikeMcDonald89: raises $700 to $1100
DeepStack: calls $700
*** FLOP **** [Ts 4c 6s]
Mike_McDonald_@MikeMcDonald89: bets $1100
DeepStack: calls $1100
*** TURN **** [Kh]
Mike_McDonald_@MikeMcDonald89: bets $2200
DeepStack: folds
Uncalled bet ($2200) returned to Mike_McDonald_@MikeMcDonald89
Mike_McDonald_@MikeMcDonald89 collected $4400 from the pot
*** SUMMARY ***
Total pot $4400 | Rake $0
Board [Ts 4c 6s Kh]
Seat 1: DeepStack (button) (small blind) folded on the Turn
Seat 2: Mike_McDonald_@MikeMcDonald89 (big blind) collected ($4400)

PokerStars Hand #11000100043: Tournament #2, Apr29_2017-at-11_44_48 Hold'em No Limit ($200/$400 USD) - 2017/04/29 13:45:30 ET
Table 'ACPC Match' 2-max Seat #2 is the button
Seat 1: DeepStack ($28225 in chips)
Seat 2: Mike_McDonald_@MikeMcDonald89 ($11775 in chips)
Mike_McDonald_@MikeMcDonald89: posts small blind $200
DeepStack: posts big blind $400
*** HOLE CARDS ***
Dealt to DeepStack [3h 4h]
Dealt to Mike_McDonald_@MikeMcDonald89 [As Ad]
Mike_McDonald_@MikeMcDonald89: raises $500 to $900
DeepStack: calls $500
*** FLOP **** [8c 9s Kh]
DeepStack: checks
Mike_McDonald_@MikeMcDonald89: raises $900 to $900
DeepStack: folds
Uncalled bet ($900) returned to Mike_McDonald_@MikeMcDonald89
Mike_McDonald_@MikeMcDonald89 collected $1800 from the pot
*** SUMMARY ***
Total pot $1800 | Rake $0
Board [8c 9s Kh]
Seat 1: DeepStack (big blind) folded on the Flop
Seat 2: Mike_McDonald_@MikeMcDonald89 (button) (small blind) collected ($1800)

PokerStars Hand #11000100044: Tournament #2, Apr29_2017-at-11_44_48 Hold'em No Limit ($200/$400 USD) - 2017/04/29 13:45:31 ET
Table 'ACPC Match' 2-max Seat #1 is the button
Seat 1: DeepStack ($27325 in chips)
Seat 2: Mike_McDonald_@MikeMcDonald89 ($12675 in chips)
DeepStack: posts small blind $200
Mike_McDonald_@MikeMcDonald89: posts big blind $400
*** HOLE CARDS ***
Dealt to DeepStack [9d 5s]
Dealt to Mike_McDonald_@MikeMcDonald89 [5c Qs]
DeepStack: calls $200
Mike_McDonald_@MikeMcDonald89: checks
*** FLOP **** [Td 2h 9c]
Mike_McDonald_@MikeMcDonald89: checks
DeepStack: checks
*** TURN **** [6h]
Mike_McDonald_@MikeMcDonald89: checks
DeepStack: checks
*** RIVER **** [4d]
Mike_McDonald_@MikeMcDonald89: checks
DeepStack: raises $800 to $800
Mike_McDonald_@MikeMcDonald89: folds
Uncalled bet ($800) returned to DeepStack
DeepStack collected $800 from the pot
*** SUMMARY ***
Total pot $800 | Rake $0
Board [Td 2h 9c 6h 4d]
Seat 1: DeepStack (button) (small blind) collected ($800)
Seat 2: Mike_McDonald_@MikeMcDonald89 (big blind) folded on the River

PokerStars Hand #11000100045: Tournament #2, Apr29_2017-at-11_44_48 Hold'em No Limit ($200/$400 USD) - 2017/04/29 13:45:32 ET
Table 'ACPC Match' 2-max Seat #2 is the button
Seat 1: DeepStack ($27725 in chips)
Seat 2: Mike_McDonald_@MikeMcDonald89 ($12275 in chips)
Mike_McDonald_@MikeMcDonald89: posts small blind $200
DeepStack: posts big blind $400
*** HOLE CARDS ***
Dealt to DeepStack [Ks 2d]
Dealt to Mike_McDonald_@MikeMcDonald89 [Th 5s]
Mike_McDonald_@MikeMcDonald89: raises $600 to $1000
DeepStack: calls $600
*** FLOP **** [3c 5h Ts]
DeepStack: checks
Mike_McDonald_@MikeMcDonald89: raises $1000 to $1000
DeepStack: folds
Uncalled bet ($1000) returned to Mike_McDonald_@MikeMcDonald89
Mike_McDonald_@MikeMcDonald89 collected $2000 from the pot
*** SUMMARY ***
Total pot $2000 | Rake $0
Board [3c 5h Ts]
Seat 1: DeepStack (big blind) folded on the Flop
Seat 2: Mike_McDonald_@MikeMcDonald89 (button) (small blind) collected ($2000)

PokerStars Hand #11000100046: Tournament #2, Apr29_2017-at-11_44_48 Hold'em No Limit ($200/$400 USD) - 2017/04/29 13:45:33 ET
Table 'ACPC Match' 2-max Seat #1 is the button
Seat 1: DeepStack ($26725 in chips)
Seat 2: Mike_McDonald_@MikeMcDonald89 ($13275 in chips)
DeepStack: posts small blind $200
Mike_McDonald_@MikeMcDonald89: posts big blind $400
*** HOLE CARDS ***
Dealt to DeepStack [6d Ac]
Dealt to Mike_McDonald_@MikeMcDonald89 [7c 5c]
DeepStack: raises $400 to $800
Mike_McDonald_@MikeMcDonald89: raises $12475 to $13275 and is all-in
DeepStack: folds
Uncalled bet ($12475) returned to Mike_McDonald_@MikeMcDonald89
Mike_McDonald_@MikeMcDonald89 collected $1600 from the pot
*** SUMMARY ***
Total pot $1600 | Rake $0
Seat 1: DeepStack (button) (small blind) folded before the Flop
Seat 2: Mike_McDonald_@MikeMcDonald89 (big blind) collected ($1600)

PokerStars Hand #11000100047: Tournament #2, Apr29_2017-at-11_44_48 Hold'em No Limit ($200/$400 USD) - 2017/04/29 13:45:34 ET
Table 'ACPC Match' 2-max Seat #2 is the button
Seat 1: DeepStack ($25925 in chips)
Seat 2: Mike_McDonald_@MikeMcDonald89 ($14075 in chips)
Mike_McDonald_@MikeMcDonald89: posts small blind $200
DeepStack: posts big blind $400
*** HOLE CARDS ***
Dealt to DeepStack [9d 7d]
Dealt to Mike_McDonald_@MikeMcDonald89 [9h Kh]
Mike_McDonald_@MikeMcDonald89: raises $600 to $1000
DeepStack: calls $600
*** FLOP **** [8c 7s 2h]
DeepStack: checks
Mike_McDonald_@MikeMcDonald89: raises $1000 to $1000
DeepStack: calls $1000
*** TURN **** [Ad]
DeepStack: checks
Mike_McDonald_@MikeMcDonald89: checks
*** RIVER **** [3c]
DeepStack: checks
Mike_McDonald_@MikeMcDonald89: checks
*** SHOW DOWN ***
DeepStack: shows [9d 7d] (a pair of Sevens)
Mike_McDonald_@MikeMcDonald89: shows [9h Kh] (Ace high)
DeepStack collected $4000 from pot
*** SUMMARY ***
Total pot $4000 | Rake $0
Board [8c 7s 2h Ad 3c]
Seat 1: DeepStack (big blind) showed [9d 7d] and won ($4000) with a pair of Sevens
Seat 2: Mike_McDonald_@MikeMcDonald89 (button) (small blind) showed [9h Kh] and lost with Ace high

PokerStars Hand #11000100048: Tournament #2, Apr29_2017-at-11_44_48 Hold'em No Limit ($200/$400 USD) - 2017/04/29 13:45:35 ET
Table 'ACPC Match' 2-max Seat #1 is the button
Seat 1: DeepStack ($27925 in chips)
Seat 2: Mike_McDonald_@MikeMcDonald89 ($12075 in chips)
DeepStack: posts small blind $200
Mike_McDonald_@MikeMcDonald89: posts big blind $400
*** HOLE CARDS ***
Dealt to DeepStack [Kh 2d]
Dealt to Mike_McDonald_@MikeMcDonald89 [Ac 9c]
DeepStack: calls $200
Mike_McDonald_@MikeMcDonald89: raises $700 to $1100
DeepStack: folds
Uncalled bet ($700) returned to Mike_McDonald_@MikeMcDonald89
Mike_McDonald_@MikeMcDonald89 collected $800 from the pot
*** SUMMARY ***
Total pot $800 | Rake $0
Seat 1: DeepStack (button) (small blind) folded before the Flop
Seat 2: Mike_McDonald_@MikeMcDonald89 (big blind) collected ($800)

PokerStars Hand #11000100049: Tournament #2, Apr29_2017-at-11_44_48 Hold'em No Limit ($200/$400 USD) - 2017/04/29 13:45:36 ET
Table 'ACPC Match' 2-max Seat #2 is the button
Seat 1: DeepStack ($27525 in chips)
Seat 2: Mike_McDonald_@MikeMcDonald89 ($12475 in chips)
Mike_McDonald_@MikeMcDonald89: posts small blind $200
DeepStack: posts big blind $400
*** HOLE CARDS ***
Dealt to DeepStack [Ac Jc]
Dealt to Mike_McDonald_@MikeMcDonald89 [4s 6c]
Mike_McDonald_@MikeMcDonald89: raises $500 to $900
DeepStack: raises $1800 to $2700
Mike_McDonald_@MikeMcDonald89: folds
Uncalled bet ($1800) returned to DeepStack
DeepStack collected $1800 from the pot
*** SUMMARY ***
Total pot $1800 | Rake $0
Seat 1: DeepStack (big blind) collected ($1800)
Seat 2: Mike_McDonald_@MikeMcDonald89 (button) (small blind) folded before the Flop

PokerStars Hand #11000100050: Tournament #2, Apr29_2017-at-11_44_48 Hold'em No Limit ($200/$400 USD) - 2017/04/29 13:45:37 ET
Table 'ACPC Match' 2-max Seat #1 is the button
Seat 1: DeepStack ($28425 in chips)
Seat 2: Mike_McDonald_@MikeMcDonald89 ($11575 in chips)
DeepStack: posts small blind $200
Mike_McDonald_@MikeMcDonald89: posts big blind $400
*** HOLE CARDS ***
Dealt to DeepStack [Ah 8c]
Dealt to Mike_McDonald_@MikeMcDonald89 [9c Tc]
DeepStack: raises $400 to $800
Mike_McDonald_@MikeMcDonald89: raises $10775 to $11575 and is all-in
DeepStack: folds
Uncalled bet ($10775) returned to Mike_McDonald_@MikeMcDonald89
Mike_McDonald_@MikeMcDonald89 collected $1600 from the pot
*** SUMMARY ***
Total pot $1600 | Rake $0
Seat 1: DeepStack (button) (small blind) folded before the Flop
Seat 2: Mike_McDonald_@MikeMcDonald89 (big blind) collected ($1600)

PokerStars Hand #11000100051: Tournament #2, Apr29_2017-at-11_44_48 Hold'em No Limit ($300/$600 USD) - 2017/04/29 13:45:38 ET
Table 'ACPC Match' 2-max Seat #2 is the button
Seat 1: DeepStack ($27625 in chips)
Seat 2: Mike_McDonald_@MikeMcDonald89 ($12375 in chips)
Mike_McDonald_@MikeMcDonald89: posts small blind $300
DeepStack: posts big blind $600
*** HOLE CARDS ***
Dealt to DeepStack [Kd Ks]
Dealt to Mike_McDonald_@MikeMcDonald89 [Jh 4c]
Mike_McDonald_@MikeMcDonald89: calls $300
DeepStack: raises $1200 to $1800
Mike_McDonald_@MikeMcDonald89: folds
Uncalled bet ($1200) returned to DeepStack
DeepStack collected $1200 from the pot
*** SUMMARY ***
Total pot $1200 | Rake $0
Seat 1: DeepStack (big blind) collected ($1200)
Seat 2: Mike_McDonald_@MikeMcDonald89 (button) (small blind) folded before the Flop

PokerStars Hand #11000100052: Tournament #2, Apr29_2017-at-11_44_48 Hold'em No Limit ($300/$600 USD) - 2017/04/29 13:45:39 ET
Table 'ACPC Match' 2-max Seat #1 is the button
Seat 1: DeepStack ($28225 in chips)
Seat 2: Mike_McDonald_@MikeMcDonald89 ($11775 in chips)
DeepStack: posts small blind $300
Mike_McDonald_@MikeMcDonald89: posts big blind $600
*** HOLE CARDS ***
Dealt to DeepStack [6d As]
Dealt to Mike_McDonald_@MikeMcDonald89 [Ts Qc]
DeepStack: raises $600 to $1200
Mike_McDonald_@MikeMcDonald89: calls $600
*** FLOP **** [4c 7s 2c]
Mike_McDonald_@MikeMcDonald89: checks
DeepStack: checks
*** TURN **** [Ah]
Mike_McDonald_@MikeMcDonald89: checks
DeepStack: raises $2400 to $2400
Mike_McDonald_@MikeMcDonald89: folds
Uncalled bet ($2400) returned to DeepStack
DeepStack collected $2400 from the pot
*** SUMMARY ***
Total pot $2400 | Rake $0
Board [4c 7s 2c Ah]
Seat 1: DeepStack (button) (small blind) collected ($2400)
Seat 2: Mike_McDonald_@MikeMcDonald89 (big blind) folded on the Turn

PokerStars Hand #11000100053: Tournament #2, Apr29_2017-at-11_44_48 Hold'em No Limit ($300/$600 USD) - 2017/04/29 13:45:40 ET
Table 'ACPC Match' 2-max Seat #2 is the button
Seat 1: DeepStack ($29425 in chips)
Seat 2: Mike_McDonald_@MikeMcDonald89 ($10575 in chips)
Mike_McDonald_@MikeMcDonald89: posts small blind $300
DeepStack: posts big blind $600
*** HOLE CARDS ***
Dealt to DeepStack [2s Kh]
Dealt to Mike_McDonald_@MikeMcDonald89 [Ts 8c]
Mike_McDonald_@MikeMcDonald89: calls $300
DeepStack: checks
*** FLOP **** [5d Ah Qs]
DeepStack: checks
Mike_McDonald_@MikeMcDonald89: checks
*** TURN **** [4h]
DeepStack: bets $600
Mike_McDonald_@MikeMcDonald89: folds
Uncalled bet ($600) returned to DeepStack
DeepStack collected $1200 from the pot
*** SUMMARY ***
Total pot $1200 | Rake $0
Board [5d Ah Qs 4h]
Seat 1: DeepStack (big blind) collected ($1200)
Seat 2: Mike_McDonald_@MikeMcDonald89 (button) (small blind) folded on the Turn

PokerStars Hand #11000100054: Tournament #2, Apr29_2017-at-11_44_48 Hold'em No Limit ($300/$600 USD) - 2017/04/29 13:45:41 ET
Table 'ACPC Match' 2-max Seat #1 is the button
Seat 1: DeepStack ($30025 in chips)
Seat 2: Mike_McDonald_@MikeMcDonald89 ($9975 in chips)
DeepStack: posts small blind $300
Mike_McDonald_@MikeMcDonald89: posts big blind $600
*** HOLE CARDS ***
Dealt to DeepStack [7h 6s]
Dealt to Mike_McDonald_@MikeMcDonald89 [4h Qd]
DeepStack: calls $300
Mike_McDonald_@MikeMcDonald89: raises $1000 to $1600
DeepStack: calls $1000
*** FLOP **** [Tc 9h Ad]
Mike_McDonald_@MikeMcDonald89: checks
DeepStack: checks
*** TURN **** [7d]
Mike_McDonald_@MikeMcDonald89: checks
DeepStack: checks
*** RIVER **** [6c]
Mike_McDonald_@MikeMcDonald89: bets $1000
DeepStack: calls $1000
*** SHOW DOWN ***
Mike_McDonald_@MikeMcDonald89: shows [4h Qd] (Ace high)
DeepStack: shows [7h 6s] (two pair, Sevens and Sixes)
DeepStack collected $5200 from pot
*** SUMMARY ***
Total pot $5200 | Rake $0
Board [Tc 9h Ad 7d 6c]
Seat 1: DeepStack (button) (small blind) showed [7h 6s] and won ($5200) with two pair, Sevens and Sixes
Seat 2: Mike_McDonald_@MikeMcDonald89 (big blind) showed [4h Qd] and lost with Ace high

PokerStars Hand #11000100055: Tournament #2, Apr29_2017-at-11_44_48 Hold'em No Limit ($300/$600 USD) - 2017/04/29 13:45:42 ET
Table 'ACPC Match' 2-max Seat #2 is the button
Seat 1: DeepStack ($32625 in chips)
Seat 2: Mike_McDonald_@MikeMcDonald89 ($7375 in chips)
Mike_McDonald_@MikeMcDonald89: posts small blind $300
DeepStack: posts big blind $600
*** HOLE CARDS ***
Dealt to DeepStack [Jh 2d]
Dealt to Mike_McDonald_@MikeMcDonald89 [8h 7h]
Mike_McDonald_@MikeMcDonald89: raises $6775 to $7375 and is all-in
DeepStack: folds
Uncalled bet ($6775) returned to Mike_McDonald_@MikeMcDonald89
Mike_McDonald_@MikeMcDonald89 collected $1200 from the pot
*** SUMMARY ***
Total pot $1200 | Rake $0
Seat 1: DeepStack (big blind) folded before the Flop
Seat 2: Mike_McDonald_@MikeMcDonald89 (button) (small blind) collected ($1200)

PokerStars Hand #11000100056: Tournament #2, Apr29_2017-at-11_44_48 Hold'em No Limit ($300/$600 USD) - 2017/04/29 13:45:43 ET
Table 'ACPC Match' 2-max Seat #1 is the button
Seat 1: DeepStack ($32025 in chips)
Seat 2: Mike_McDonald_@MikeMcDonald89 ($7975 in chips)
DeepStack: posts small blind $300
Mike_McDonald_@MikeMcDonald89: posts big blind $600
*** HOLE CARDS ***
Dealt to DeepStack [6s 8c]
Dealt to Mike_McDonald_@MikeMcDonald89 [5d Ks]
DeepStack: calls $300
Mike_McDonald_@MikeMcDonald89: checks
*** FLOP **** [Ac Tc 7c]
Mike_McDonald_@MikeMcDonald89: checks
DeepStack: raises $600 to $600
Mike_McDonald_@MikeMcDonald89: calls $600
*** TURN **** [Jd]
Mike_McDonald_@MikeMcDonald89: checks
DeepStack: checks
*** RIVER **** [8h]
Mike_McDonald_@MikeMcDonald89: checks
DeepStack: checks
*** SHOW DOWN ***
Mike_McDonald_@MikeMcDonald89: shows [5d Ks] (Ace high)
DeepStack: shows [6s 8c] (a pair of Eights)
DeepStack collected $2400 from pot
*** SUMMARY ***
Total pot $2400 | Rake $0
Board [Ac Tc 7c Jd 8h]
Seat 1: DeepStack (button) (small blind) showed [6s 8c] and won ($2400) with a pair of Eights
Seat 2: Mike_McDonald_@MikeMcDonald89 (big blind) showed [5d Ks] and lost with Ace high

PokerStars Hand #11000100057: Tournament #2, Apr29_2017-at-11_44_48 Hold'em No Limit ($300/$600 USD) - 2017/04/29 13:45:44 ET
Table 'ACPC Match' 2-max Seat #2 is the button
Seat 1: DeepStack ($33225 in chips)
Seat 2: Mike_McDonald_@MikeMcDonald89 ($6775 in chips)
Mike_McDonald_@MikeMcDonald89: posts small blind $300
DeepStack: posts big blind $600
*** HOLE CARDS ***
Dealt to DeepStack [Tc 4c]
Dealt to Mike_McDonald_@MikeMcDonald89 [6c Ac]
Mike_McDonald_@MikeMcDonald89: raises $6175 to $6775 and is all-in
DeepStack: folds
Uncalled bet ($6175) returned to Mike_McDonald_@MikeMcDonald89
Mike_McDonald_@MikeMcDonald89 collected $1200 from the pot
*** SUMMARY ***
Total pot $1200 | Rake $0
Seat 1: DeepStack (big blind) folded before the Flop
Seat 2: Mike_McDonald_@MikeMcDonald89 (button) (small blind) collected ($1200)

PokerStars Hand #11000100058: Tournament #2, Apr29_2017-at-11_44_48 Hold'em No Limit ($300/$600 USD) - 2017/04/29 13:45:45 ET
Table 'ACPC Match' 2-max Seat #1 is the button
Seat 1: DeepStack ($32625 in chips)
Seat 2: Mike_McDonald_@MikeMcDonald89 ($7375 in chips)
DeepStack: posts small blind $300
Mike_McDonald_@MikeMcDonald89: posts big blind $600
*** HOLE CARDS ***
Dealt to DeepStack [3h 6d]
Dealt to Mike_McDonald_@MikeMcDonald89 [As 8h]
DeepStack: calls $300
Mike_McDonald_@MikeMcDonald89: raises $6775 to $7375 and is all-in
DeepStack: folds
Uncalled bet ($6775) returned to Mike_McDonald_@MikeMcDonald89
Mike_McDonald_@MikeMcDonald89 collected $1200 from the pot
*** SUMMARY ***
Total pot $1200 | Rake $0
Seat 1: DeepStack (button) (small blind) folded before the Flop
Seat 2: Mike_McDonald_@MikeMcDonald89 (big blind) collected ($1200)

PokerStars Hand #11000100059: Tournament #2, Apr29_2017-at-11_44_48 Hold'em No Limit ($300/$600 USD) - 2017/04/29 13:45:46 ET
Table 'ACPC Match' 2-max Seat #2 is the button
Seat 1: DeepStack ($32025 in chips)
Seat 2: Mike_McDonald_@MikeMcDonald89 ($7975 in chips)
Mike_McDonald_@MikeMcDonald89: posts small blind $300
DeepStack: posts big blind $600
*** HOLE CARDS ***
Dealt to DeepStack [Qd 5s]
Dealt to Mike_McDonald_@MikeMcDonald89 [5h Kh]
Mike_McDonald_@MikeMcDonald89: raises $7375 to $7975 and is all-in
DeepStack: folds
Uncalled bet ($7375) returned to Mike_McDonald_@MikeMcDonald89
Mike_McDonald_@MikeMcDonald89 collected $1200 from the pot
*** SUMMARY ***
Total pot $1200 | Rake $0
Seat 1: DeepStack (big blind) folded before the Flop
Seat 2: Mike_McDonald_@MikeMcDonald89 (button) (small blind) collected ($1200)

PokerStars Hand #11000100060: Tournament #2, Apr29_2017-at-11_44_48 Hold'em No Limit ($300/$600 USD) - 2017/04/29 13:45:47 ET
Table 'ACPC Match' 2-max Seat #1 is the button
Seat 1: DeepStack ($31425 in chips)
Seat 2: Mike_McDonald_@MikeMcDonald89 ($8575 in chips)
DeepStack: posts small blind $300
Mike_McDonald_@MikeMcDonald89: posts big blind $600
*** HOLE CARDS ***
Dealt to DeepStack [9d As]
Dealt to Mike_McDonald_@MikeMcDonald89 [2h Qd]
DeepStack: calls $300
Mike_McDonald_@MikeMcDonald89: raises $1000 to $1600
DeepStack: raises $6975 to $8575
Mike_McDonald_@MikeMcDonald89: folds
Uncalled bet ($6975) returned to DeepStack
DeepStack collected $3200 from the pot
*** SUMMARY ***
Total pot $3200 | Rake $0
Seat 1: DeepStack (button) (small blind) collected ($3200)
Seat 2: Mike_McDonald_@MikeMcDonald89 (big blind) folded before the Flop

PokerStars Hand #11000100061: Tournament #2, Apr29_2017-at-11_44_48 Hold'em No Limit ($400/$800 USD) - 2017/04/29 13:45:48 ET
Table 'ACPC Match' 2-max Seat #2 is the button
Seat 1: DeepStack ($33025 in chips)
Seat 2: Mike_McDonald_@MikeMcDonald89 ($6975 in chips)
Mike_McDonald_@MikeMcDonald89: posts small blind $400
DeepStack: posts big blind $800
*** HOLE CARDS ***
Dealt to DeepStack [Ks 6d]
Dealt to Mike_McDonald_@MikeMcDonald89 [7d 8d]
Mike_McDonald_@MikeMcDonald89: raises $6175 to $6975 and is all-in
DeepStack: calls $6175
*** FLOP **** [Jh Kc Jd]
*** TURN **** [5s]
*** RIVER **** [9h]
*** SHOW DOWN ***
Mike_McDonald_@MikeMcDonald89: shows [7d 8d] (a pair of Jacks)
DeepStack: shows [Ks 6d] (two pair, Kings and Jacks)
DeepStack collected $13950 from pot
*** SUMMARY ***
Total pot $13950 | Rake $0
Board [Jh Kc Jd 5s 9h]
Seat 1: DeepStack (big blind) showed [Ks 6d] and won ($13950) with two pair, Kings and Jacks
Seat 2: Mike_McDonald_@MikeMcDonald89 (button) (small blind) showed [7d 8d] and lost with a pair of Jacks
