PokerStars Hand #1001400001: Tournament #15, Mar29_2017-at-14_52_20 Hold'em No Limit ($50/$100 USD) - 2017/03/29 16:52:20 ET
Table 'ACPC Match' 2-max Seat #2 is the button
Seat 1: DeepStack ($20000 in chips)
Seat 2: Nate_@NateMeyvis ($20000 in chips)
Nate_@NateMeyvis: posts small blind $50
DeepStack: posts big blind $100
*** HOLE CARDS ***
Dealt to DeepStack [Qd 3s]
Dealt to Nate_@NateMeyvis [3h Js]
Nate_@NateMeyvis: raises $200 to $300
DeepStack: folds
Uncalled bet ($200) returned to Nate_@NateMeyvis
Nate_@NateMeyvis collected $200 from the pot
*** SUMMARY ***
Total pot $200 | Rake $0
Seat 1: DeepStack (big blind) folded before the Flop
Seat 2: Nate_@NateMeyvis (button) (small blind) collected ($200)

PokerStars Hand #1001400002: Tournament #15, Mar29_2017-at-14_52_20 Hold'em No Limit ($50/$100 USD) - 2017/03/29 16:52:21 ET
Table 'ACPC Match' 2-max Seat #1 is the button
Seat 1: DeepStack ($19900 in chips)
Seat 2: Nate_@NateMeyvis ($20100 in chips)
DeepStack: posts small blind $50
Nate_@NateMeyvis: posts big blind $100
*** HOLE CARDS ***
Dealt to DeepStack [8h 7d]
Dealt to Nate_@NateMeyvis [3d 8s]
DeepStack: calls $50
Nate_@NateMeyvis: checks
*** FLOP **** [8d Kh 5d]
Nate_@NateMeyvis: checks
DeepStack: raises $200 to $200
Nate_@NateMeyvis: calls $200
*** TURN **** [7c]
Nate_@NateMeyvis: checks
DeepStack: raises $300 to $300
Nate_@NateMeyvis: calls $300
*** RIVER **** [Qd]
Nate_@NateMeyvis: checks
DeepStack: raises $1200 to $1200
Nate_@NateMeyvis: folds
Uncalled bet ($1200) returned to DeepStack
DeepStack collected $1200 from the pot
*** SUMMARY ***
Total pot $1200 | Rake $0
Board [8d Kh 5d 7c Qd]
Seat 1: DeepStack (button) (small blind) collected ($1200)
Seat 2: Nate_@NateMeyvis (big blind) folded on the River

PokerStars Hand #1001400003: Tournament #15, Mar29_2017-at-14_52_20 Hold'em No Limit ($50/$100 USD) - 2017/03/29 16:52:22 ET
Table 'ACPC Match' 2-max Seat #2 is the button
Seat 1: DeepStack ($20500 in chips)
Seat 2: Nate_@NateMeyvis ($19500 in chips)
Nate_@NateMeyvis: posts small blind $50
DeepStack: posts big blind $100
*** HOLE CARDS ***
Dealt to DeepStack [4c 2s]
Dealt to Nate_@NateMeyvis [5c Ad]
Nate_@NateMeyvis: raises $200 to $300
DeepStack: folds
Uncalled bet ($200) returned to Nate_@NateMeyvis
Nate_@NateMeyvis collected $200 from the pot
*** SUMMARY ***
Total pot $200 | Rake $0
Seat 1: DeepStack (big blind) folded before the Flop
Seat 2: Nate_@NateMeyvis (button) (small blind) collected ($200)

PokerStars Hand #1001400004: Tournament #15, Mar29_2017-at-14_52_20 Hold'em No Limit ($50/$100 USD) - 2017/03/29 16:52:23 ET
Table 'ACPC Match' 2-max Seat #1 is the button
Seat 1: DeepStack ($20400 in chips)
Seat 2: Nate_@NateMeyvis ($19600 in chips)
DeepStack: posts small blind $50
Nate_@NateMeyvis: posts big blind $100
*** HOLE CARDS ***
Dealt to DeepStack [Ah 4c]
Dealt to Nate_@NateMeyvis [9c 3d]
DeepStack: raises $200 to $300
Nate_@NateMeyvis: folds
Uncalled bet ($200) returned to DeepStack
DeepStack collected $200 from the pot
*** SUMMARY ***
Total pot $200 | Rake $0
Seat 1: DeepStack (button) (small blind) collected ($200)
Seat 2: Nate_@NateMeyvis (big blind) folded before the Flop

PokerStars Hand #1001400005: Tournament #15, Mar29_2017-at-14_52_20 Hold'em No Limit ($50/$100 USD) - 2017/03/29 16:52:24 ET
Table 'ACPC Match' 2-max Seat #2 is the button
Seat 1: DeepStack ($20500 in chips)
Seat 2: Nate_@NateMeyvis ($19500 in chips)
Nate_@NateMeyvis: posts small blind $50
DeepStack: posts big blind $100
*** HOLE CARDS ***
Dealt to DeepStack [8d Th]
Dealt to Nate_@NateMeyvis [6s 3d]
Nate_@NateMeyvis: folds
Uncalled bet ($50) returned to DeepStack
DeepStack collected $100 from the pot
*** SUMMARY ***
Total pot $100 | Rake $0
Seat 1: DeepStack (big blind) collected ($100)
Seat 2: Nate_@NateMeyvis (button) (small blind) folded before the Flop

PokerStars Hand #1001400006: Tournament #15, Mar29_2017-at-14_52_20 Hold'em No Limit ($50/$100 USD) - 2017/03/29 16:52:25 ET
Table 'ACPC Match' 2-max Seat #1 is the button
Seat 1: DeepStack ($20550 in chips)
Seat 2: Nate_@NateMeyvis ($19450 in chips)
DeepStack: posts small blind $50
Nate_@NateMeyvis: posts big blind $100
*** HOLE CARDS ***
Dealt to DeepStack [8h 8c]
Dealt to Nate_@NateMeyvis [9c 2s]
DeepStack: raises $200 to $300
Nate_@NateMeyvis: folds
Uncalled bet ($200) returned to DeepStack
DeepStack collected $200 from the pot
*** SUMMARY ***
Total pot $200 | Rake $0
Seat 1: DeepStack (button) (small blind) collected ($200)
Seat 2: Nate_@NateMeyvis (big blind) folded before the Flop

PokerStars Hand #1001400007: Tournament #15, Mar29_2017-at-14_52_20 Hold'em No Limit ($50/$100 USD) - 2017/03/29 16:52:26 ET
Table 'ACPC Match' 2-max Seat #2 is the button
Seat 1: DeepStack ($20650 in chips)
Seat 2: Nate_@NateMeyvis ($19350 in chips)
Nate_@NateMeyvis: posts small blind $50
DeepStack: posts big blind $100
*** HOLE CARDS ***
Dealt to DeepStack [3s Kh]
Dealt to Nate_@NateMeyvis [Ad 4s]
Nate_@NateMeyvis: raises $200 to $300
DeepStack: folds
Uncalled bet ($200) returned to Nate_@NateMeyvis
Nate_@NateMeyvis collected $200 from the pot
*** SUMMARY ***
Total pot $200 | Rake $0
Seat 1: DeepStack (big blind) folded before the Flop
Seat 2: Nate_@NateMeyvis (button) (small blind) collected ($200)

PokerStars Hand #1001400008: Tournament #15, Mar29_2017-at-14_52_20 Hold'em No Limit ($50/$100 USD) - 2017/03/29 16:52:27 ET
Table 'ACPC Match' 2-max Seat #1 is the button
Seat 1: DeepStack ($20550 in chips)
Seat 2: Nate_@NateMeyvis ($19450 in chips)
DeepStack: posts small blind $50
Nate_@NateMeyvis: posts big blind $100
*** HOLE CARDS ***
Dealt to DeepStack [8s Kd]
Dealt to Nate_@NateMeyvis [4d Ac]
DeepStack: raises $200 to $300
Nate_@NateMeyvis: calls $200
*** FLOP **** [Ks 9d 6d]
Nate_@NateMeyvis: checks
DeepStack: raises $600 to $600
Nate_@NateMeyvis: folds
Uncalled bet ($600) returned to DeepStack
DeepStack collected $600 from the pot
*** SUMMARY ***
Total pot $600 | Rake $0
Board [Ks 9d 6d]
Seat 1: DeepStack (button) (small blind) collected ($600)
Seat 2: Nate_@NateMeyvis (big blind) folded on the Flop

PokerStars Hand #1001400009: Tournament #15, Mar29_2017-at-14_52_20 Hold'em No Limit ($50/$100 USD) - 2017/03/29 16:52:28 ET
Table 'ACPC Match' 2-max Seat #2 is the button
Seat 1: DeepStack ($20850 in chips)
Seat 2: Nate_@NateMeyvis ($19150 in chips)
Nate_@NateMeyvis: posts small blind $50
DeepStack: posts big blind $100
*** HOLE CARDS ***
Dealt to DeepStack [6s 8c]
Dealt to Nate_@NateMeyvis [7c Td]
Nate_@NateMeyvis: raises $200 to $300
DeepStack: folds
Uncalled bet ($200) returned to Nate_@NateMeyvis
Nate_@NateMeyvis collected $200 from the pot
*** SUMMARY ***
Total pot $200 | Rake $0
Seat 1: DeepStack (big blind) folded before the Flop
Seat 2: Nate_@NateMeyvis (button) (small blind) collected ($200)

PokerStars Hand #1001400010: Tournament #15, Mar29_2017-at-14_52_20 Hold'em No Limit ($50/$100 USD) - 2017/03/29 16:52:29 ET
Table 'ACPC Match' 2-max Seat #1 is the button
Seat 1: DeepStack ($20750 in chips)
Seat 2: Nate_@NateMeyvis ($19250 in chips)
DeepStack: posts small blind $50
Nate_@NateMeyvis: posts big blind $100
*** HOLE CARDS ***
Dealt to DeepStack [Tc Ah]
Dealt to Nate_@NateMeyvis [Jd 5h]
DeepStack: calls $50
Nate_@NateMeyvis: checks
*** FLOP **** [Kh 2h 9d]
Nate_@NateMeyvis: checks
DeepStack: checks
*** TURN **** [4h]
Nate_@NateMeyvis: bets $150
DeepStack: calls $150
*** RIVER **** [8c]
Nate_@NateMeyvis: bets $375
DeepStack: calls $375
*** SHOW DOWN ***
Nate_@NateMeyvis: shows [Jd 5h] (King high)
DeepStack: shows [Tc Ah] (Ace high)
DeepStack collected $1250 from pot
*** SUMMARY ***
Total pot $1250 | Rake $0
Board [Kh 2h 9d 4h 8c]
Seat 1: DeepStack (button) (small blind) showed [Tc Ah] and won ($1250) with Ace high
Seat 2: Nate_@NateMeyvis (big blind) showed [Jd 5h] and lost with King high

PokerStars Hand #1001400011: Tournament #15, Mar29_2017-at-14_52_20 Hold'em No Limit ($75/$150 USD) - 2017/03/29 16:52:30 ET
Table 'ACPC Match' 2-max Seat #2 is the button
Seat 1: DeepStack ($21375 in chips)
Seat 2: Nate_@NateMeyvis ($18625 in chips)
Nate_@NateMeyvis: posts small blind $75
DeepStack: posts big blind $150
*** HOLE CARDS ***
Dealt to DeepStack [6h Kc]
Dealt to Nate_@NateMeyvis [3d 3c]
Nate_@NateMeyvis: raises $300 to $450
DeepStack: calls $300
*** FLOP **** [7s Th 9h]
DeepStack: checks
Nate_@NateMeyvis: raises $675 to $675
DeepStack: folds
Uncalled bet ($675) returned to Nate_@NateMeyvis
Nate_@NateMeyvis collected $900 from the pot
*** SUMMARY ***
Total pot $900 | Rake $0
Board [7s Th 9h]
Seat 1: DeepStack (big blind) folded on the Flop
Seat 2: Nate_@NateMeyvis (button) (small blind) collected ($900)

PokerStars Hand #1001400012: Tournament #15, Mar29_2017-at-14_52_20 Hold'em No Limit ($75/$150 USD) - 2017/03/29 16:52:31 ET
Table 'ACPC Match' 2-max Seat #1 is the button
Seat 1: DeepStack ($20925 in chips)
Seat 2: Nate_@NateMeyvis ($19075 in chips)
DeepStack: posts small blind $75
Nate_@NateMeyvis: posts big blind $150
*** HOLE CARDS ***
Dealt to DeepStack [Jh 4s]
Dealt to Nate_@NateMeyvis [3s Ah]
DeepStack: calls $75
Nate_@NateMeyvis: checks
*** FLOP **** [4c 7s Qs]
Nate_@NateMeyvis: checks
DeepStack: raises $300 to $300
Nate_@NateMeyvis: folds
Uncalled bet ($300) returned to DeepStack
DeepStack collected $300 from the pot
*** SUMMARY ***
Total pot $300 | Rake $0
Board [4c 7s Qs]
Seat 1: DeepStack (button) (small blind) collected ($300)
Seat 2: Nate_@NateMeyvis (big blind) folded on the Flop

PokerStars Hand #1001400013: Tournament #15, Mar29_2017-at-14_52_20 Hold'em No Limit ($75/$150 USD) - 2017/03/29 16:52:32 ET
Table 'ACPC Match' 2-max Seat #2 is the button
Seat 1: DeepStack ($21075 in chips)
Seat 2: Nate_@NateMeyvis ($18925 in chips)
Nate_@NateMeyvis: posts small blind $75
DeepStack: posts big blind $150
*** HOLE CARDS ***
Dealt to DeepStack [3d 9s]
Dealt to Nate_@NateMeyvis [7d 2c]
Nate_@NateMeyvis: folds
Uncalled bet ($75) returned to DeepStack
DeepStack collected $150 from the pot
*** SUMMARY ***
Total pot $150 | Rake $0
Seat 1: DeepStack (big blind) collected ($150)
Seat 2: Nate_@NateMeyvis (button) (small blind) folded before the Flop

PokerStars Hand #1001400014: Tournament #15, Mar29_2017-at-14_52_20 Hold'em No Limit ($75/$150 USD) - 2017/03/29 16:52:33 ET
Table 'ACPC Match' 2-max Seat #1 is the button
Seat 1: DeepStack ($21150 in chips)
Seat 2: Nate_@NateMeyvis ($18850 in chips)
DeepStack: posts small blind $75
Nate_@NateMeyvis: posts big blind $150
*** HOLE CARDS ***
Dealt to DeepStack [As 8s]
Dealt to Nate_@NateMeyvis [9h 6d]
DeepStack: raises $300 to $450
Nate_@NateMeyvis: folds
Uncalled bet ($300) returned to DeepStack
DeepStack collected $300 from the pot
*** SUMMARY ***
Total pot $300 | Rake $0
Seat 1: DeepStack (button) (small blind) collected ($300)
Seat 2: Nate_@NateMeyvis (big blind) folded before the Flop

PokerStars Hand #1001400015: Tournament #15, Mar29_2017-at-14_52_20 Hold'em No Limit ($75/$150 USD) - 2017/03/29 16:52:34 ET
Table 'ACPC Match' 2-max Seat #2 is the button
Seat 1: DeepStack ($21300 in chips)
Seat 2: Nate_@NateMeyvis ($18700 in chips)
Nate_@NateMeyvis: posts small blind $75
DeepStack: posts big blind $150
*** HOLE CARDS ***
Dealt to DeepStack [5s 7d]
Dealt to Nate_@NateMeyvis [Th 2s]
Nate_@NateMeyvis: folds
Uncalled bet ($75) returned to DeepStack
DeepStack collected $150 from the pot
*** SUMMARY ***
Total pot $150 | Rake $0
Seat 1: DeepStack (big blind) collected ($150)
Seat 2: Nate_@NateMeyvis (button) (small blind) folded before the Flop

PokerStars Hand #1001400016: Tournament #15, Mar29_2017-at-14_52_20 Hold'em No Limit ($75/$150 USD) - 2017/03/29 16:52:35 ET
Table 'ACPC Match' 2-max Seat #1 is the button
Seat 1: DeepStack ($21375 in chips)
Seat 2: Nate_@NateMeyvis ($18625 in chips)
DeepStack: posts small blind $75
Nate_@NateMeyvis: posts big blind $150
*** HOLE CARDS ***
Dealt to DeepStack [8s 3h]
Dealt to Nate_@NateMeyvis [4d Jd]
DeepStack: folds
Uncalled bet ($75) returned to Nate_@NateMeyvis
Nate_@NateMeyvis collected $150 from the pot
*** SUMMARY ***
Total pot $150 | Rake $0
Seat 1: DeepStack (button) (small blind) folded before the Flop
Seat 2: Nate_@NateMeyvis (big blind) collected ($150)

PokerStars Hand #1001400017: Tournament #15, Mar29_2017-at-14_52_20 Hold'em No Limit ($75/$150 USD) - 2017/03/29 16:52:36 ET
Table 'ACPC Match' 2-max Seat #2 is the button
Seat 1: DeepStack ($21300 in chips)
Seat 2: Nate_@NateMeyvis ($18700 in chips)
Nate_@NateMeyvis: posts small blind $75
DeepStack: posts big blind $150
*** HOLE CARDS ***
Dealt to DeepStack [Ah 5s]
Dealt to Nate_@NateMeyvis [Ac 7h]
Nate_@NateMeyvis: raises $300 to $450
DeepStack: calls $300
*** FLOP **** [Th 3d Td]
DeepStack: checks
Nate_@NateMeyvis: checks
*** TURN **** [4h]
DeepStack: checks
Nate_@NateMeyvis: checks
*** RIVER **** [6s]
DeepStack: checks
Nate_@NateMeyvis: checks
*** SHOW DOWN ***
DeepStack: shows [Ah 5s] (a pair of Tens)
Nate_@NateMeyvis: shows [Ac 7h] (a pair of Tens)
Nate_@NateMeyvis collected $900 from pot
*** SUMMARY ***
Total pot $900 | Rake $0
Board [Th 3d Td 4h 6s]
Seat 1: DeepStack (big blind) showed [Ah 5s] and lost with a pair of Tens
Seat 2: Nate_@NateMeyvis (button) (small blind) showed [Ac 7h] and won ($900) with a pair of Tens

PokerStars Hand #1001400018: Tournament #15, Mar29_2017-at-14_52_20 Hold'em No Limit ($75/$150 USD) - 2017/03/29 16:52:37 ET
Table 'ACPC Match' 2-max Seat #1 is the button
Seat 1: DeepStack ($20850 in chips)
Seat 2: Nate_@NateMeyvis ($19150 in chips)
DeepStack: posts small blind $75
Nate_@NateMeyvis: posts big blind $150
*** HOLE CARDS ***
Dealt to DeepStack [2h 8c]
Dealt to Nate_@NateMeyvis [9s 7s]
DeepStack: folds
Uncalled bet ($75) returned to Nate_@NateMeyvis
Nate_@NateMeyvis collected $150 from the pot
*** SUMMARY ***
Total pot $150 | Rake $0
Seat 1: DeepStack (button) (small blind) folded before the Flop
Seat 2: Nate_@NateMeyvis (big blind) collected ($150)

PokerStars Hand #1001400019: Tournament #15, Mar29_2017-at-14_52_20 Hold'em No Limit ($75/$150 USD) - 2017/03/29 16:52:38 ET
Table 'ACPC Match' 2-max Seat #2 is the button
Seat 1: DeepStack ($20775 in chips)
Seat 2: Nate_@NateMeyvis ($19225 in chips)
Nate_@NateMeyvis: posts small blind $75
DeepStack: posts big blind $150
*** HOLE CARDS ***
Dealt to DeepStack [3h 2d]
Dealt to Nate_@NateMeyvis [6c Qh]
Nate_@NateMeyvis: raises $300 to $450
DeepStack: folds
Uncalled bet ($300) returned to Nate_@NateMeyvis
Nate_@NateMeyvis collected $300 from the pot
*** SUMMARY ***
Total pot $300 | Rake $0
Seat 1: DeepStack (big blind) folded before the Flop
Seat 2: Nate_@NateMeyvis (button) (small blind) collected ($300)

PokerStars Hand #1001400020: Tournament #15, Mar29_2017-at-14_52_20 Hold'em No Limit ($75/$150 USD) - 2017/03/29 16:52:39 ET
Table 'ACPC Match' 2-max Seat #1 is the button
Seat 1: DeepStack ($20625 in chips)
Seat 2: Nate_@NateMeyvis ($19375 in chips)
DeepStack: posts small blind $75
Nate_@NateMeyvis: posts big blind $150
*** HOLE CARDS ***
Dealt to DeepStack [3c 9s]
Dealt to Nate_@NateMeyvis [2h Tc]
DeepStack: folds
Uncalled bet ($75) returned to Nate_@NateMeyvis
Nate_@NateMeyvis collected $150 from the pot
*** SUMMARY ***
Total pot $150 | Rake $0
Seat 1: DeepStack (button) (small blind) folded before the Flop
Seat 2: Nate_@NateMeyvis (big blind) collected ($150)

PokerStars Hand #1001400021: Tournament #15, Mar29_2017-at-14_52_20 Hold'em No Limit ($100/$200 USD) - 2017/03/29 16:52:40 ET
Table 'ACPC Match' 2-max Seat #2 is the button
Seat 1: DeepStack ($20550 in chips)
Seat 2: Nate_@NateMeyvis ($19450 in chips)
Nate_@NateMeyvis: posts small blind $100
DeepStack: posts big blind $200
*** HOLE CARDS ***
Dealt to DeepStack [Js 9d]
Dealt to Nate_@NateMeyvis [8h 4s]
Nate_@NateMeyvis: folds
Uncalled bet ($100) returned to DeepStack
DeepStack collected $200 from the pot
*** SUMMARY ***
Total pot $200 | Rake $0
Seat 1: DeepStack (big blind) collected ($200)
Seat 2: Nate_@NateMeyvis (button) (small blind) folded before the Flop

PokerStars Hand #1001400022: Tournament #15, Mar29_2017-at-14_52_20 Hold'em No Limit ($100/$200 USD) - 2017/03/29 16:52:41 ET
Table 'ACPC Match' 2-max Seat #1 is the button
Seat 1: DeepStack ($20650 in chips)
Seat 2: Nate_@NateMeyvis ($19350 in chips)
DeepStack: posts small blind $100
Nate_@NateMeyvis: posts big blind $200
*** HOLE CARDS ***
Dealt to DeepStack [Ks 7c]
Dealt to Nate_@NateMeyvis [Qd 8h]
DeepStack: raises $200 to $400
Nate_@NateMeyvis: calls $200
*** FLOP **** [9c Js 5h]
Nate_@NateMeyvis: checks
DeepStack: raises $800 to $800
Nate_@NateMeyvis: folds
Uncalled bet ($800) returned to DeepStack
DeepStack collected $800 from the pot
*** SUMMARY ***
Total pot $800 | Rake $0
Board [9c Js 5h]
Seat 1: DeepStack (button) (small blind) collected ($800)
Seat 2: Nate_@NateMeyvis (big blind) folded on the Flop

PokerStars Hand #1001400023: Tournament #15, Mar29_2017-at-14_52_20 Hold'em No Limit ($100/$200 USD) - 2017/03/29 16:52:42 ET
Table 'ACPC Match' 2-max Seat #2 is the button
Seat 1: DeepStack ($21050 in chips)
Seat 2: Nate_@NateMeyvis ($18950 in chips)
Nate_@NateMeyvis: posts small blind $100
DeepStack: posts big blind $200
*** HOLE CARDS ***
Dealt to DeepStack [3c 9h]
Dealt to Nate_@NateMeyvis [Qs 4s]
Nate_@NateMeyvis: raises $400 to $600
DeepStack: folds
Uncalled bet ($400) returned to Nate_@NateMeyvis
Nate_@NateMeyvis collected $400 from the pot
*** SUMMARY ***
Total pot $400 | Rake $0
Seat 1: DeepStack (big blind) folded before the Flop
Seat 2: Nate_@NateMeyvis (button) (small blind) collected ($400)

PokerStars Hand #1001400024: Tournament #15, Mar29_2017-at-14_52_20 Hold'em No Limit ($100/$200 USD) - 2017/03/29 16:52:43 ET
Table 'ACPC Match' 2-max Seat #1 is the button
Seat 1: DeepStack ($20850 in chips)
Seat 2: Nate_@NateMeyvis ($19150 in chips)
DeepStack: posts small blind $100
Nate_@NateMeyvis: posts big blind $200
*** HOLE CARDS ***
Dealt to DeepStack [2s 9c]
Dealt to Nate_@NateMeyvis [6d 6c]
DeepStack: folds
Uncalled bet ($100) returned to Nate_@NateMeyvis
Nate_@NateMeyvis collected $200 from the pot
*** SUMMARY ***
Total pot $200 | Rake $0
Seat 1: DeepStack (button) (small blind) folded before the Flop
Seat 2: Nate_@NateMeyvis (big blind) collected ($200)

PokerStars Hand #1001400025: Tournament #15, Mar29_2017-at-14_52_20 Hold'em No Limit ($100/$200 USD) - 2017/03/29 16:52:44 ET
Table 'ACPC Match' 2-max Seat #2 is the button
Seat 1: DeepStack ($20750 in chips)
Seat 2: Nate_@NateMeyvis ($19250 in chips)
Nate_@NateMeyvis: posts small blind $100
DeepStack: posts big blind $200
*** HOLE CARDS ***
Dealt to DeepStack [9d 5s]
Dealt to Nate_@NateMeyvis [2c 2d]
Nate_@NateMeyvis: raises $400 to $600
DeepStack: folds
Uncalled bet ($400) returned to Nate_@NateMeyvis
Nate_@NateMeyvis collected $400 from the pot
*** SUMMARY ***
Total pot $400 | Rake $0
Seat 1: DeepStack (big blind) folded before the Flop
Seat 2: Nate_@NateMeyvis (button) (small blind) collected ($400)

PokerStars Hand #1001400026: Tournament #15, Mar29_2017-at-14_52_20 Hold'em No Limit ($100/$200 USD) - 2017/03/29 16:52:45 ET
Table 'ACPC Match' 2-max Seat #1 is the button
Seat 1: DeepStack ($20550 in chips)
Seat 2: Nate_@NateMeyvis ($19450 in chips)
DeepStack: posts small blind $100
Nate_@NateMeyvis: posts big blind $200
*** HOLE CARDS ***
Dealt to DeepStack [Js Jh]
Dealt to Nate_@NateMeyvis [9h 2c]
DeepStack: raises $400 to $600
Nate_@NateMeyvis: folds
Uncalled bet ($400) returned to DeepStack
DeepStack collected $400 from the pot
*** SUMMARY ***
Total pot $400 | Rake $0
Seat 1: DeepStack (button) (small blind) collected ($400)
Seat 2: Nate_@NateMeyvis (big blind) folded before the Flop

PokerStars Hand #1001400027: Tournament #15, Mar29_2017-at-14_52_20 Hold'em No Limit ($100/$200 USD) - 2017/03/29 16:52:46 ET
Table 'ACPC Match' 2-max Seat #2 is the button
Seat 1: DeepStack ($20750 in chips)
Seat 2: Nate_@NateMeyvis ($19250 in chips)
Nate_@NateMeyvis: posts small blind $100
DeepStack: posts big blind $200
*** HOLE CARDS ***
Dealt to DeepStack [Ad 2h]
Dealt to Nate_@NateMeyvis [6d 3d]
Nate_@NateMeyvis: raises $400 to $600
DeepStack: calls $400
*** FLOP **** [Js 4s 7h]
DeepStack: checks
Nate_@NateMeyvis: raises $900 to $900
DeepStack: folds
Uncalled bet ($900) returned to Nate_@NateMeyvis
Nate_@NateMeyvis collected $1200 from the pot
*** SUMMARY ***
Total pot $1200 | Rake $0
Board [Js 4s 7h]
Seat 1: DeepStack (big blind) folded on the Flop
Seat 2: Nate_@NateMeyvis (button) (small blind) collected ($1200)

PokerStars Hand #1001400028: Tournament #15, Mar29_2017-at-14_52_20 Hold'em No Limit ($100/$200 USD) - 2017/03/29 16:52:47 ET
Table 'ACPC Match' 2-max Seat #1 is the button
Seat 1: DeepStack ($20150 in chips)
Seat 2: Nate_@NateMeyvis ($19850 in chips)
DeepStack: posts small blind $100
Nate_@NateMeyvis: posts big blind $200
*** HOLE CARDS ***
Dealt to DeepStack [As 7d]
Dealt to Nate_@NateMeyvis [Ad Ts]
DeepStack: raises $200 to $400
Nate_@NateMeyvis: calls $200
*** FLOP **** [4c Kh Ks]
Nate_@NateMeyvis: checks
DeepStack: checks
*** TURN **** [7s]
Nate_@NateMeyvis: bets $400
DeepStack: raises $800 to $1200
Nate_@NateMeyvis: folds
Uncalled bet ($800) returned to DeepStack
DeepStack collected $1600 from the pot
*** SUMMARY ***
Total pot $1600 | Rake $0
Board [4c Kh Ks 7s]
Seat 1: DeepStack (button) (small blind) collected ($1600)
Seat 2: Nate_@NateMeyvis (big blind) folded on the Turn

PokerStars Hand #1001400029: Tournament #15, Mar29_2017-at-14_52_20 Hold'em No Limit ($100/$200 USD) - 2017/03/29 16:52:48 ET
Table 'ACPC Match' 2-max Seat #2 is the button
Seat 1: DeepStack ($20950 in chips)
Seat 2: Nate_@NateMeyvis ($19050 in chips)
Nate_@NateMeyvis: posts small blind $100
DeepStack: posts big blind $200
*** HOLE CARDS ***
Dealt to DeepStack [4d 8s]
Dealt to Nate_@NateMeyvis [Jh Tc]
Nate_@NateMeyvis: raises $400 to $600
DeepStack: folds
Uncalled bet ($400) returned to Nate_@NateMeyvis
Nate_@NateMeyvis collected $400 from the pot
*** SUMMARY ***
Total pot $400 | Rake $0
Seat 1: DeepStack (big blind) folded before the Flop
Seat 2: Nate_@NateMeyvis (button) (small blind) collected ($400)

PokerStars Hand #1001400030: Tournament #15, Mar29_2017-at-14_52_20 Hold'em No Limit ($100/$200 USD) - 2017/03/29 16:52:49 ET
Table 'ACPC Match' 2-max Seat #1 is the button
Seat 1: DeepStack ($20750 in chips)
Seat 2: Nate_@NateMeyvis ($19250 in chips)
DeepStack: posts small blind $100
Nate_@NateMeyvis: posts big blind $200
*** HOLE CARDS ***
Dealt to DeepStack [8d Ts]
Dealt to Nate_@NateMeyvis [Kd Qh]
DeepStack: raises $400 to $600
Nate_@NateMeyvis: calls $400
*** FLOP **** [7s 7h Qs]
Nate_@NateMeyvis: checks
DeepStack: raises $600 to $600
Nate_@NateMeyvis: calls $600
*** TURN **** [3d]
Nate_@NateMeyvis: checks
DeepStack: checks
*** RIVER **** [5h]
Nate_@NateMeyvis: bets $1800
DeepStack: folds
Uncalled bet ($1800) returned to Nate_@NateMeyvis
Nate_@NateMeyvis collected $2400 from the pot
*** SUMMARY ***
Total pot $2400 | Rake $0
Board [7s 7h Qs 3d 5h]
Seat 1: DeepStack (button) (small blind) folded on the River
Seat 2: Nate_@NateMeyvis (big blind) collected ($2400)

PokerStars Hand #1001400031: Tournament #15, Mar29_2017-at-14_52_20 Hold'em No Limit ($150/$300 USD) - 2017/03/29 16:52:50 ET
Table 'ACPC Match' 2-max Seat #2 is the button
Seat 1: DeepStack ($19550 in chips)
Seat 2: Nate_@NateMeyvis ($20450 in chips)
Nate_@NateMeyvis: posts small blind $150
DeepStack: posts big blind $300
*** HOLE CARDS ***
Dealt to DeepStack [9h 4c]
Dealt to Nate_@NateMeyvis [2d 9s]
Nate_@NateMeyvis: folds
Uncalled bet ($150) returned to DeepStack
DeepStack collected $300 from the pot
*** SUMMARY ***
Total pot $300 | Rake $0
Seat 1: DeepStack (big blind) collected ($300)
Seat 2: Nate_@NateMeyvis (button) (small blind) folded before the Flop

PokerStars Hand #1001400032: Tournament #15, Mar29_2017-at-14_52_20 Hold'em No Limit ($150/$300 USD) - 2017/03/29 16:52:51 ET
Table 'ACPC Match' 2-max Seat #1 is the button
Seat 1: DeepStack ($19700 in chips)
Seat 2: Nate_@NateMeyvis ($20300 in chips)
DeepStack: posts small blind $150
Nate_@NateMeyvis: posts big blind $300
*** HOLE CARDS ***
Dealt to DeepStack [Kh 7h]
Dealt to Nate_@NateMeyvis [6s 3d]
DeepStack: raises $300 to $600
Nate_@NateMeyvis: folds
Uncalled bet ($300) returned to DeepStack
DeepStack collected $600 from the pot
*** SUMMARY ***
Total pot $600 | Rake $0
Seat 1: DeepStack (button) (small blind) collected ($600)
Seat 2: Nate_@NateMeyvis (big blind) folded before the Flop

PokerStars Hand #1001400033: Tournament #15, Mar29_2017-at-14_52_20 Hold'em No Limit ($150/$300 USD) - 2017/03/29 16:52:52 ET
Table 'ACPC Match' 2-max Seat #2 is the button
Seat 1: DeepStack ($20000 in chips)
Seat 2: Nate_@NateMeyvis ($20000 in chips)
Nate_@NateMeyvis: posts small blind $150
DeepStack: posts big blind $300
*** HOLE CARDS ***
Dealt to DeepStack [6d Js]
Dealt to Nate_@NateMeyvis [Ts 4s]
Nate_@NateMeyvis: raises $450 to $750
DeepStack: folds
Uncalled bet ($450) returned to Nate_@NateMeyvis
Nate_@NateMeyvis collected $600 from the pot
*** SUMMARY ***
Total pot $600 | Rake $0
Seat 1: DeepStack (big blind) folded before the Flop
Seat 2: Nate_@NateMeyvis (button) (small blind) collected ($600)

PokerStars Hand #1001400034: Tournament #15, Mar29_2017-at-14_52_20 Hold'em No Limit ($150/$300 USD) - 2017/03/29 16:52:53 ET
Table 'ACPC Match' 2-max Seat #1 is the button
Seat 1: DeepStack ($19700 in chips)
Seat 2: Nate_@NateMeyvis ($20300 in chips)
DeepStack: posts small blind $150
Nate_@NateMeyvis: posts big blind $300
*** HOLE CARDS ***
Dealt to DeepStack [5s 6h]
Dealt to Nate_@NateMeyvis [Kh 8s]
DeepStack: raises $300 to $600
Nate_@NateMeyvis: calls $300
*** FLOP **** [6c Ad Jc]
Nate_@NateMeyvis: checks
DeepStack: raises $600 to $600
Nate_@NateMeyvis: folds
Uncalled bet ($600) returned to DeepStack
DeepStack collected $1200 from the pot
*** SUMMARY ***
Total pot $1200 | Rake $0
Board [6c Ad Jc]
Seat 1: DeepStack (button) (small blind) collected ($1200)
Seat 2: Nate_@NateMeyvis (big blind) folded on the Flop

PokerStars Hand #1001400035: Tournament #15, Mar29_2017-at-14_52_20 Hold'em No Limit ($150/$300 USD) - 2017/03/29 16:52:54 ET
Table 'ACPC Match' 2-max Seat #2 is the button
Seat 1: DeepStack ($20300 in chips)
Seat 2: Nate_@NateMeyvis ($19700 in chips)
Nate_@NateMeyvis: posts small blind $150
DeepStack: posts big blind $300
*** HOLE CARDS ***
Dealt to DeepStack [Qs 6h]
Dealt to Nate_@NateMeyvis [4d 6d]
Nate_@NateMeyvis: raises $450 to $750
DeepStack: calls $450
*** FLOP **** [8c Ac 5s]
DeepStack: checks
Nate_@NateMeyvis: raises $750 to $750
DeepStack: folds
Uncalled bet ($750) returned to Nate_@NateMeyvis
Nate_@NateMeyvis collected $1500 from the pot
*** SUMMARY ***
Total pot $1500 | Rake $0
Board [8c Ac 5s]
Seat 1: DeepStack (big blind) folded on the Flop
Seat 2: Nate_@NateMeyvis (button) (small blind) collected ($1500)

PokerStars Hand #1001400036: Tournament #15, Mar29_2017-at-14_52_20 Hold'em No Limit ($150/$300 USD) - 2017/03/29 16:52:55 ET
Table 'ACPC Match' 2-max Seat #1 is the button
Seat 1: DeepStack ($19550 in chips)
Seat 2: Nate_@NateMeyvis ($20450 in chips)
DeepStack: posts small blind $150
Nate_@NateMeyvis: posts big blind $300
*** HOLE CARDS ***
Dealt to DeepStack [7d Qs]
Dealt to Nate_@NateMeyvis [Qc 2c]
DeepStack: raises $300 to $600
Nate_@NateMeyvis: calls $300
*** FLOP **** [Kh Jh 8c]
Nate_@NateMeyvis: checks
DeepStack: checks
*** TURN **** [4s]
Nate_@NateMeyvis: checks
DeepStack: raises $600 to $600
Nate_@NateMeyvis: folds
Uncalled bet ($600) returned to DeepStack
DeepStack collected $1200 from the pot
*** SUMMARY ***
Total pot $1200 | Rake $0
Board [Kh Jh 8c 4s]
Seat 1: DeepStack (button) (small blind) collected ($1200)
Seat 2: Nate_@NateMeyvis (big blind) folded on the Turn

PokerStars Hand #1001400037: Tournament #15, Mar29_2017-at-14_52_20 Hold'em No Limit ($150/$300 USD) - 2017/03/29 16:52:56 ET
Table 'ACPC Match' 2-max Seat #2 is the button
Seat 1: DeepStack ($20150 in chips)
Seat 2: Nate_@NateMeyvis ($19850 in chips)
Nate_@NateMeyvis: posts small blind $150
DeepStack: posts big blind $300
*** HOLE CARDS ***
Dealt to DeepStack [8s Qd]
Dealt to Nate_@NateMeyvis [Ks 7h]
Nate_@NateMeyvis: raises $450 to $750
DeepStack: calls $450
*** FLOP **** [2d 3d 4d]
DeepStack: checks
Nate_@NateMeyvis: checks
*** TURN **** [6d]
DeepStack: bets $750
Nate_@NateMeyvis: folds
Uncalled bet ($750) returned to DeepStack
DeepStack collected $1500 from the pot
*** SUMMARY ***
Total pot $1500 | Rake $0
Board [2d 3d 4d 6d]
Seat 1: DeepStack (big blind) collected ($1500)
Seat 2: Nate_@NateMeyvis (button) (small blind) folded on the Turn

PokerStars Hand #1001400038: Tournament #15, Mar29_2017-at-14_52_20 Hold'em No Limit ($150/$300 USD) - 2017/03/29 16:52:57 ET
Table 'ACPC Match' 2-max Seat #1 is the button
Seat 1: DeepStack ($20900 in chips)
Seat 2: Nate_@NateMeyvis ($19100 in chips)
DeepStack: posts small blind $150
Nate_@NateMeyvis: posts big blind $300
*** HOLE CARDS ***
Dealt to DeepStack [6d 6c]
Dealt to Nate_@NateMeyvis [Qs Qd]
DeepStack: raises $300 to $600
Nate_@NateMeyvis: raises $1200 to $1800
DeepStack: calls $1200
*** FLOP **** [7s Th 5c]
Nate_@NateMeyvis: bets $2100
DeepStack: calls $2100
*** TURN **** [6s]
Nate_@NateMeyvis: bets $4250
DeepStack: raises $10950 to $15200
Nate_@NateMeyvis: calls $10950 and is all-in
*** RIVER **** [9h]
*** SHOW DOWN ***
DeepStack: shows [6d 6c] (three of a kind, Sixes)
Nate_@NateMeyvis: shows [Qs Qd] (a pair of Queens)
DeepStack collected $38200 from pot
*** SUMMARY ***
Total pot $38200 | Rake $0
Board [7s Th 5c 6s 9h]
Seat 1: DeepStack (button) (small blind) showed [6d 6c] and won ($38200) with three of a kind, Sixes
Seat 2: Nate_@NateMeyvis (big blind) showed [Qs Qd] and lost with a pair of Queens
