PokerStars Hand #1001600001: Tournament #17, Mar29_2017-at-16_15_32 Hold'em No Limit ($50/$100 USD) - 2017/03/29 18:15:32 ET
Table 'ACPC Match' 2-max Seat #2 is the button
Seat 1: DeepStack ($20000 in chips)
Seat 2: Nate_@NateMeyvis ($20000 in chips)
Nate_@NateMeyvis: posts small blind $50
DeepStack: posts big blind $100
*** HOLE CARDS ***
Dealt to DeepStack [Tc Kd]
Dealt to Nate_@NateMeyvis [Ts 9h]
Nate_@NateMeyvis: raises $200 to $300
DeepStack: raises $600 to $900
Nate_@NateMeyvis: calls $600
*** FLOP **** [6c Jc 2h]
DeepStack: bets $900
Nate_@NateMeyvis: folds
Uncalled bet ($900) returned to DeepStack
DeepStack collected $1800 from the pot
*** SUMMARY ***
Total pot $1800 | Rake $0
Board [6c Jc 2h]
Seat 1: DeepStack (big blind) collected ($1800)
Seat 2: Nate_@NateMeyvis (button) (small blind) folded on the Flop

PokerStars Hand #1001600002: Tournament #17, Mar29_2017-at-16_15_32 Hold'em No Limit ($50/$100 USD) - 2017/03/29 18:15:33 ET
Table 'ACPC Match' 2-max Seat #1 is the button
Seat 1: DeepStack ($20900 in chips)
Seat 2: Nate_@NateMeyvis ($19100 in chips)
DeepStack: posts small blind $50
Nate_@NateMeyvis: posts big blind $100
*** HOLE CARDS ***
Dealt to DeepStack [3s 8c]
Dealt to Nate_@NateMeyvis [6c 2d]
DeepStack: folds
Uncalled bet ($50) returned to Nate_@NateMeyvis
Nate_@NateMeyvis collected $100 from the pot
*** SUMMARY ***
Total pot $100 | Rake $0
Seat 1: DeepStack (button) (small blind) folded before the Flop
Seat 2: Nate_@NateMeyvis (big blind) collected ($100)

PokerStars Hand #1001600003: Tournament #17, Mar29_2017-at-16_15_32 Hold'em No Limit ($50/$100 USD) - 2017/03/29 18:15:34 ET
Table 'ACPC Match' 2-max Seat #2 is the button
Seat 1: DeepStack ($20850 in chips)
Seat 2: Nate_@NateMeyvis ($19150 in chips)
Nate_@NateMeyvis: posts small blind $50
DeepStack: posts big blind $100
*** HOLE CARDS ***
Dealt to DeepStack [9c Ah]
Dealt to Nate_@NateMeyvis [Kd 2d]
Nate_@NateMeyvis: raises $200 to $300
DeepStack: calls $200
*** FLOP **** [4h 7d 3c]
DeepStack: checks
Nate_@NateMeyvis: checks
*** TURN **** [7s]
DeepStack: checks
Nate_@NateMeyvis: checks
*** RIVER **** [Tc]
DeepStack: checks
Nate_@NateMeyvis: checks
*** SHOW DOWN ***
DeepStack: shows [9c Ah] (a pair of Sevens)
Nate_@NateMeyvis: shows [Kd 2d] (a pair of Sevens)
DeepStack collected $600 from pot
*** SUMMARY ***
Total pot $600 | Rake $0
Board [4h 7d 3c 7s Tc]
Seat 1: DeepStack (big blind) showed [9c Ah] and won ($600) with a pair of Sevens
Seat 2: Nate_@NateMeyvis (button) (small blind) showed [Kd 2d] and lost with a pair of Sevens

PokerStars Hand #1001600004: Tournament #17, Mar29_2017-at-16_15_32 Hold'em No Limit ($50/$100 USD) - 2017/03/29 18:15:35 ET
Table 'ACPC Match' 2-max Seat #1 is the button
Seat 1: DeepStack ($21150 in chips)
Seat 2: Nate_@NateMeyvis ($18850 in chips)
DeepStack: posts small blind $50
Nate_@NateMeyvis: posts big blind $100
*** HOLE CARDS ***
Dealt to DeepStack [Qc Kh]
Dealt to Nate_@NateMeyvis [Jh 7h]
DeepStack: raises $200 to $300
Nate_@NateMeyvis: calls $200
*** FLOP **** [Ah 5c Th]
Nate_@NateMeyvis: checks
DeepStack: raises $600 to $600
Nate_@NateMeyvis: calls $600
*** TURN **** [2h]
Nate_@NateMeyvis: checks
DeepStack: checks
*** RIVER **** [9c]
Nate_@NateMeyvis: bets $900
DeepStack: folds
Uncalled bet ($900) returned to Nate_@NateMeyvis
Nate_@NateMeyvis collected $1800 from the pot
*** SUMMARY ***
Total pot $1800 | Rake $0
Board [Ah 5c Th 2h 9c]
Seat 1: DeepStack (button) (small blind) folded on the River
Seat 2: Nate_@NateMeyvis (big blind) collected ($1800)

PokerStars Hand #1001600005: Tournament #17, Mar29_2017-at-16_15_32 Hold'em No Limit ($50/$100 USD) - 2017/03/29 18:15:36 ET
Table 'ACPC Match' 2-max Seat #2 is the button
Seat 1: DeepStack ($20250 in chips)
Seat 2: Nate_@NateMeyvis ($19750 in chips)
Nate_@NateMeyvis: posts small blind $50
DeepStack: posts big blind $100
*** HOLE CARDS ***
Dealt to DeepStack [3s Kh]
Dealt to Nate_@NateMeyvis [8d 8h]
Nate_@NateMeyvis: raises $200 to $300
DeepStack: folds
Uncalled bet ($200) returned to Nate_@NateMeyvis
Nate_@NateMeyvis collected $200 from the pot
*** SUMMARY ***
Total pot $200 | Rake $0
Seat 1: DeepStack (big blind) folded before the Flop
Seat 2: Nate_@NateMeyvis (button) (small blind) collected ($200)

PokerStars Hand #1001600006: Tournament #17, Mar29_2017-at-16_15_32 Hold'em No Limit ($50/$100 USD) - 2017/03/29 18:15:37 ET
Table 'ACPC Match' 2-max Seat #1 is the button
Seat 1: DeepStack ($20150 in chips)
Seat 2: Nate_@NateMeyvis ($19850 in chips)
DeepStack: posts small blind $50
Nate_@NateMeyvis: posts big blind $100
*** HOLE CARDS ***
Dealt to DeepStack [4s Ts]
Dealt to Nate_@NateMeyvis [4h Jh]
DeepStack: raises $200 to $300
Nate_@NateMeyvis: folds
Uncalled bet ($200) returned to DeepStack
DeepStack collected $200 from the pot
*** SUMMARY ***
Total pot $200 | Rake $0
Seat 1: DeepStack (button) (small blind) collected ($200)
Seat 2: Nate_@NateMeyvis (big blind) folded before the Flop

PokerStars Hand #1001600007: Tournament #17, Mar29_2017-at-16_15_32 Hold'em No Limit ($50/$100 USD) - 2017/03/29 18:15:38 ET
Table 'ACPC Match' 2-max Seat #2 is the button
Seat 1: DeepStack ($20250 in chips)
Seat 2: Nate_@NateMeyvis ($19750 in chips)
Nate_@NateMeyvis: posts small blind $50
DeepStack: posts big blind $100
*** HOLE CARDS ***
Dealt to DeepStack [9s 3h]
Dealt to Nate_@NateMeyvis [Ts Jd]
Nate_@NateMeyvis: raises $200 to $300
DeepStack: folds
Uncalled bet ($200) returned to Nate_@NateMeyvis
Nate_@NateMeyvis collected $200 from the pot
*** SUMMARY ***
Total pot $200 | Rake $0
Seat 1: DeepStack (big blind) folded before the Flop
Seat 2: Nate_@NateMeyvis (button) (small blind) collected ($200)

PokerStars Hand #1001600008: Tournament #17, Mar29_2017-at-16_15_32 Hold'em No Limit ($50/$100 USD) - 2017/03/29 18:15:39 ET
Table 'ACPC Match' 2-max Seat #1 is the button
Seat 1: DeepStack ($20150 in chips)
Seat 2: Nate_@NateMeyvis ($19850 in chips)
DeepStack: posts small blind $50
Nate_@NateMeyvis: posts big blind $100
*** HOLE CARDS ***
Dealt to DeepStack [2d Qd]
Dealt to Nate_@NateMeyvis [7s 2h]
DeepStack: calls $50
Nate_@NateMeyvis: checks
*** FLOP **** [6c 5s 7d]
Nate_@NateMeyvis: checks
DeepStack: checks
*** TURN **** [2s]
Nate_@NateMeyvis: bets $150
DeepStack: folds
Uncalled bet ($150) returned to Nate_@NateMeyvis
Nate_@NateMeyvis collected $200 from the pot
*** SUMMARY ***
Total pot $200 | Rake $0
Board [6c 5s 7d 2s]
Seat 1: DeepStack (button) (small blind) folded on the Turn
Seat 2: Nate_@NateMeyvis (big blind) collected ($200)

PokerStars Hand #1001600009: Tournament #17, Mar29_2017-at-16_15_32 Hold'em No Limit ($50/$100 USD) - 2017/03/29 18:15:40 ET
Table 'ACPC Match' 2-max Seat #2 is the button
Seat 1: DeepStack ($20050 in chips)
Seat 2: Nate_@NateMeyvis ($19950 in chips)
Nate_@NateMeyvis: posts small blind $50
DeepStack: posts big blind $100
*** HOLE CARDS ***
Dealt to DeepStack [4h 2h]
Dealt to Nate_@NateMeyvis [Kc 6d]
Nate_@NateMeyvis: raises $200 to $300
DeepStack: calls $200
*** FLOP **** [8s 6c Qd]
DeepStack: checks
Nate_@NateMeyvis: raises $450 to $450
DeepStack: folds
Uncalled bet ($450) returned to Nate_@NateMeyvis
Nate_@NateMeyvis collected $600 from the pot
*** SUMMARY ***
Total pot $600 | Rake $0
Board [8s 6c Qd]
Seat 1: DeepStack (big blind) folded on the Flop
Seat 2: Nate_@NateMeyvis (button) (small blind) collected ($600)

PokerStars Hand #1001600010: Tournament #17, Mar29_2017-at-16_15_32 Hold'em No Limit ($50/$100 USD) - 2017/03/29 18:15:41 ET
Table 'ACPC Match' 2-max Seat #1 is the button
Seat 1: DeepStack ($19750 in chips)
Seat 2: Nate_@NateMeyvis ($20250 in chips)
DeepStack: posts small blind $50
Nate_@NateMeyvis: posts big blind $100
*** HOLE CARDS ***
Dealt to DeepStack [6c 3d]
Dealt to Nate_@NateMeyvis [5d 6d]
DeepStack: calls $50
Nate_@NateMeyvis: checks
*** FLOP **** [2d Qc 4d]
Nate_@NateMeyvis: checks
DeepStack: raises $100 to $100
Nate_@NateMeyvis: calls $100
*** TURN **** [9s]
Nate_@NateMeyvis: checks
DeepStack: checks
*** RIVER **** [Td]
Nate_@NateMeyvis: bets $300
DeepStack: folds
Uncalled bet ($300) returned to Nate_@NateMeyvis
Nate_@NateMeyvis collected $400 from the pot
*** SUMMARY ***
Total pot $400 | Rake $0
Board [2d Qc 4d 9s Td]
Seat 1: DeepStack (button) (small blind) folded on the River
Seat 2: Nate_@NateMeyvis (big blind) collected ($400)

PokerStars Hand #1001600011: Tournament #17, Mar29_2017-at-16_15_32 Hold'em No Limit ($75/$150 USD) - 2017/03/29 18:15:42 ET
Table 'ACPC Match' 2-max Seat #2 is the button
Seat 1: DeepStack ($19550 in chips)
Seat 2: Nate_@NateMeyvis ($20450 in chips)
Nate_@NateMeyvis: posts small blind $75
DeepStack: posts big blind $150
*** HOLE CARDS ***
Dealt to DeepStack [7h 5h]
Dealt to Nate_@NateMeyvis [2c Ah]
Nate_@NateMeyvis: raises $300 to $450
DeepStack: calls $300
*** FLOP **** [9d 9s Qs]
DeepStack: checks
Nate_@NateMeyvis: checks
*** TURN **** [3d]
DeepStack: checks
Nate_@NateMeyvis: checks
*** RIVER **** [6h]
DeepStack: checks
Nate_@NateMeyvis: checks
*** SHOW DOWN ***
DeepStack: shows [7h 5h] (a pair of Nines)
Nate_@NateMeyvis: shows [2c Ah] (a pair of Nines)
Nate_@NateMeyvis collected $900 from pot
*** SUMMARY ***
Total pot $900 | Rake $0
Board [9d 9s Qs 3d 6h]
Seat 1: DeepStack (big blind) showed [7h 5h] and lost with a pair of Nines
Seat 2: Nate_@NateMeyvis (button) (small blind) showed [2c Ah] and won ($900) with a pair of Nines

PokerStars Hand #1001600012: Tournament #17, Mar29_2017-at-16_15_32 Hold'em No Limit ($75/$150 USD) - 2017/03/29 18:15:43 ET
Table 'ACPC Match' 2-max Seat #1 is the button
Seat 1: DeepStack ($19100 in chips)
Seat 2: Nate_@NateMeyvis ($20900 in chips)
DeepStack: posts small blind $75
Nate_@NateMeyvis: posts big blind $150
*** HOLE CARDS ***
Dealt to DeepStack [2c Jh]
Dealt to Nate_@NateMeyvis [9s Kd]
DeepStack: calls $75
Nate_@NateMeyvis: checks
*** FLOP **** [6c 3h 5c]
Nate_@NateMeyvis: checks
DeepStack: checks
*** TURN **** [Ac]
Nate_@NateMeyvis: checks
DeepStack: raises $150 to $150
Nate_@NateMeyvis: calls $150
*** RIVER **** [7h]
Nate_@NateMeyvis: checks
DeepStack: raises $600 to $600
Nate_@NateMeyvis: folds
Uncalled bet ($600) returned to DeepStack
DeepStack collected $600 from the pot
*** SUMMARY ***
Total pot $600 | Rake $0
Board [6c 3h 5c Ac 7h]
Seat 1: DeepStack (button) (small blind) collected ($600)
Seat 2: Nate_@NateMeyvis (big blind) folded on the River

PokerStars Hand #1001600013: Tournament #17, Mar29_2017-at-16_15_32 Hold'em No Limit ($75/$150 USD) - 2017/03/29 18:15:44 ET
Table 'ACPC Match' 2-max Seat #2 is the button
Seat 1: DeepStack ($19400 in chips)
Seat 2: Nate_@NateMeyvis ($20600 in chips)
Nate_@NateMeyvis: posts small blind $75
DeepStack: posts big blind $150
*** HOLE CARDS ***
Dealt to DeepStack [3h 2s]
Dealt to Nate_@NateMeyvis [3s Td]
Nate_@NateMeyvis: folds
Uncalled bet ($75) returned to DeepStack
DeepStack collected $150 from the pot
*** SUMMARY ***
Total pot $150 | Rake $0
Seat 1: DeepStack (big blind) collected ($150)
Seat 2: Nate_@NateMeyvis (button) (small blind) folded before the Flop

PokerStars Hand #1001600014: Tournament #17, Mar29_2017-at-16_15_32 Hold'em No Limit ($75/$150 USD) - 2017/03/29 18:15:45 ET
Table 'ACPC Match' 2-max Seat #1 is the button
Seat 1: DeepStack ($19475 in chips)
Seat 2: Nate_@NateMeyvis ($20525 in chips)
DeepStack: posts small blind $75
Nate_@NateMeyvis: posts big blind $150
*** HOLE CARDS ***
Dealt to DeepStack [6h Td]
Dealt to Nate_@NateMeyvis [2d Ks]
DeepStack: raises $300 to $450
Nate_@NateMeyvis: folds
Uncalled bet ($300) returned to DeepStack
DeepStack collected $300 from the pot
*** SUMMARY ***
Total pot $300 | Rake $0
Seat 1: DeepStack (button) (small blind) collected ($300)
Seat 2: Nate_@NateMeyvis (big blind) folded before the Flop

PokerStars Hand #1001600015: Tournament #17, Mar29_2017-at-16_15_32 Hold'em No Limit ($75/$150 USD) - 2017/03/29 18:15:46 ET
Table 'ACPC Match' 2-max Seat #2 is the button
Seat 1: DeepStack ($19625 in chips)
Seat 2: Nate_@NateMeyvis ($20375 in chips)
Nate_@NateMeyvis: posts small blind $75
DeepStack: posts big blind $150
*** HOLE CARDS ***
Dealt to DeepStack [Ts Kd]
Dealt to Nate_@NateMeyvis [8c 3s]
Nate_@NateMeyvis: folds
Uncalled bet ($75) returned to DeepStack
DeepStack collected $150 from the pot
*** SUMMARY ***
Total pot $150 | Rake $0
Seat 1: DeepStack (big blind) collected ($150)
Seat 2: Nate_@NateMeyvis (button) (small blind) folded before the Flop

PokerStars Hand #1001600016: Tournament #17, Mar29_2017-at-16_15_32 Hold'em No Limit ($75/$150 USD) - 2017/03/29 18:15:47 ET
Table 'ACPC Match' 2-max Seat #1 is the button
Seat 1: DeepStack ($19700 in chips)
Seat 2: Nate_@NateMeyvis ($20300 in chips)
DeepStack: posts small blind $75
Nate_@NateMeyvis: posts big blind $150
*** HOLE CARDS ***
Dealt to DeepStack [Th Qh]
Dealt to Nate_@NateMeyvis [Qs Ah]
DeepStack: raises $150 to $300
Nate_@NateMeyvis: calls $150
*** FLOP **** [7d 8d Jh]
Nate_@NateMeyvis: checks
DeepStack: raises $300 to $300
Nate_@NateMeyvis: calls $300
*** TURN **** [3h]
Nate_@NateMeyvis: checks
DeepStack: checks
*** RIVER **** [Jd]
Nate_@NateMeyvis: checks
DeepStack: checks
*** SHOW DOWN ***
Nate_@NateMeyvis: shows [Qs Ah] (a pair of Jacks)
DeepStack: shows [Th Qh] (a pair of Jacks)
Nate_@NateMeyvis collected $1200 from pot
*** SUMMARY ***
Total pot $1200 | Rake $0
Board [7d 8d Jh 3h Jd]
Seat 1: DeepStack (button) (small blind) showed [Th Qh] and lost with a pair of Jacks
Seat 2: Nate_@NateMeyvis (big blind) showed [Qs Ah] and won ($1200) with a pair of Jacks

PokerStars Hand #1001600017: Tournament #17, Mar29_2017-at-16_15_32 Hold'em No Limit ($75/$150 USD) - 2017/03/29 18:15:48 ET
Table 'ACPC Match' 2-max Seat #2 is the button
Seat 1: DeepStack ($19100 in chips)
Seat 2: Nate_@NateMeyvis ($20900 in chips)
Nate_@NateMeyvis: posts small blind $75
DeepStack: posts big blind $150
*** HOLE CARDS ***
Dealt to DeepStack [4s 8d]
Dealt to Nate_@NateMeyvis [Jd 7s]
Nate_@NateMeyvis: raises $300 to $450
DeepStack: folds
Uncalled bet ($300) returned to Nate_@NateMeyvis
Nate_@NateMeyvis collected $300 from the pot
*** SUMMARY ***
Total pot $300 | Rake $0
Seat 1: DeepStack (big blind) folded before the Flop
Seat 2: Nate_@NateMeyvis (button) (small blind) collected ($300)

PokerStars Hand #1001600018: Tournament #17, Mar29_2017-at-16_15_32 Hold'em No Limit ($75/$150 USD) - 2017/03/29 18:15:49 ET
Table 'ACPC Match' 2-max Seat #1 is the button
Seat 1: DeepStack ($18950 in chips)
Seat 2: Nate_@NateMeyvis ($21050 in chips)
DeepStack: posts small blind $75
Nate_@NateMeyvis: posts big blind $150
*** HOLE CARDS ***
Dealt to DeepStack [Ts 3s]
Dealt to Nate_@NateMeyvis [Ks Kh]
DeepStack: raises $150 to $300
Nate_@NateMeyvis: raises $1050 to $1350
DeepStack: folds
Uncalled bet ($1050) returned to Nate_@NateMeyvis
Nate_@NateMeyvis collected $600 from the pot
*** SUMMARY ***
Total pot $600 | Rake $0
Seat 1: DeepStack (button) (small blind) folded before the Flop
Seat 2: Nate_@NateMeyvis (big blind) collected ($600)

PokerStars Hand #1001600019: Tournament #17, Mar29_2017-at-16_15_32 Hold'em No Limit ($75/$150 USD) - 2017/03/29 18:15:50 ET
Table 'ACPC Match' 2-max Seat #2 is the button
Seat 1: DeepStack ($18650 in chips)
Seat 2: Nate_@NateMeyvis ($21350 in chips)
Nate_@NateMeyvis: posts small blind $75
DeepStack: posts big blind $150
*** HOLE CARDS ***
Dealt to DeepStack [8c 5d]
Dealt to Nate_@NateMeyvis [7d 6s]
Nate_@NateMeyvis: raises $300 to $450
DeepStack: folds
Uncalled bet ($300) returned to Nate_@NateMeyvis
Nate_@NateMeyvis collected $300 from the pot
*** SUMMARY ***
Total pot $300 | Rake $0
Seat 1: DeepStack (big blind) folded before the Flop
Seat 2: Nate_@NateMeyvis (button) (small blind) collected ($300)

PokerStars Hand #1001600020: Tournament #17, Mar29_2017-at-16_15_32 Hold'em No Limit ($75/$150 USD) - 2017/03/29 18:15:51 ET
Table 'ACPC Match' 2-max Seat #1 is the button
Seat 1: DeepStack ($18500 in chips)
Seat 2: Nate_@NateMeyvis ($21500 in chips)
DeepStack: posts small blind $75
Nate_@NateMeyvis: posts big blind $150
*** HOLE CARDS ***
Dealt to DeepStack [9d Ad]
Dealt to Nate_@NateMeyvis [Kh 3s]
DeepStack: raises $300 to $450
Nate_@NateMeyvis: folds
Uncalled bet ($300) returned to DeepStack
DeepStack collected $300 from the pot
*** SUMMARY ***
Total pot $300 | Rake $0
Seat 1: DeepStack (button) (small blind) collected ($300)
Seat 2: Nate_@NateMeyvis (big blind) folded before the Flop

PokerStars Hand #1001600021: Tournament #17, Mar29_2017-at-16_15_32 Hold'em No Limit ($100/$200 USD) - 2017/03/29 18:15:52 ET
Table 'ACPC Match' 2-max Seat #2 is the button
Seat 1: DeepStack ($18650 in chips)
Seat 2: Nate_@NateMeyvis ($21350 in chips)
Nate_@NateMeyvis: posts small blind $100
DeepStack: posts big blind $200
*** HOLE CARDS ***
Dealt to DeepStack [Ac 4s]
Dealt to Nate_@NateMeyvis [9c 5d]
Nate_@NateMeyvis: folds
Uncalled bet ($100) returned to DeepStack
DeepStack collected $200 from the pot
*** SUMMARY ***
Total pot $200 | Rake $0
Seat 1: DeepStack (big blind) collected ($200)
Seat 2: Nate_@NateMeyvis (button) (small blind) folded before the Flop

PokerStars Hand #1001600022: Tournament #17, Mar29_2017-at-16_15_32 Hold'em No Limit ($100/$200 USD) - 2017/03/29 18:15:53 ET
Table 'ACPC Match' 2-max Seat #1 is the button
Seat 1: DeepStack ($18750 in chips)
Seat 2: Nate_@NateMeyvis ($21250 in chips)
DeepStack: posts small blind $100
Nate_@NateMeyvis: posts big blind $200
*** HOLE CARDS ***
Dealt to DeepStack [5d Kh]
Dealt to Nate_@NateMeyvis [Kd 8s]
DeepStack: raises $200 to $400
Nate_@NateMeyvis: calls $200
*** FLOP **** [6s 4h 6d]
Nate_@NateMeyvis: checks
DeepStack: raises $400 to $400
Nate_@NateMeyvis: folds
Uncalled bet ($400) returned to DeepStack
DeepStack collected $800 from the pot
*** SUMMARY ***
Total pot $800 | Rake $0
Board [6s 4h 6d]
Seat 1: DeepStack (button) (small blind) collected ($800)
Seat 2: Nate_@NateMeyvis (big blind) folded on the Flop

PokerStars Hand #1001600023: Tournament #17, Mar29_2017-at-16_15_32 Hold'em No Limit ($100/$200 USD) - 2017/03/29 18:15:54 ET
Table 'ACPC Match' 2-max Seat #2 is the button
Seat 1: DeepStack ($19150 in chips)
Seat 2: Nate_@NateMeyvis ($20850 in chips)
Nate_@NateMeyvis: posts small blind $100
DeepStack: posts big blind $200
*** HOLE CARDS ***
Dealt to DeepStack [Td Ac]
Dealt to Nate_@NateMeyvis [Kc Kh]
Nate_@NateMeyvis: raises $400 to $600
DeepStack: raises $1200 to $1800
Nate_@NateMeyvis: raises $2950 to $4750
DeepStack: folds
Uncalled bet ($2950) returned to Nate_@NateMeyvis
Nate_@NateMeyvis collected $3600 from the pot
*** SUMMARY ***
Total pot $3600 | Rake $0
Seat 1: DeepStack (big blind) folded before the Flop
Seat 2: Nate_@NateMeyvis (button) (small blind) collected ($3600)

PokerStars Hand #1001600024: Tournament #17, Mar29_2017-at-16_15_32 Hold'em No Limit ($100/$200 USD) - 2017/03/29 18:15:55 ET
Table 'ACPC Match' 2-max Seat #1 is the button
Seat 1: DeepStack ($17350 in chips)
Seat 2: Nate_@NateMeyvis ($22650 in chips)
DeepStack: posts small blind $100
Nate_@NateMeyvis: posts big blind $200
*** HOLE CARDS ***
Dealt to DeepStack [Ts 2s]
Dealt to Nate_@NateMeyvis [3h As]
DeepStack: raises $200 to $400
Nate_@NateMeyvis: calls $200
*** FLOP **** [8c 4d 3d]
Nate_@NateMeyvis: checks
DeepStack: raises $400 to $400
Nate_@NateMeyvis: calls $400
*** TURN **** [Jh]
Nate_@NateMeyvis: checks
DeepStack: raises $1600 to $1600
Nate_@NateMeyvis: folds
Uncalled bet ($1600) returned to DeepStack
DeepStack collected $1600 from the pot
*** SUMMARY ***
Total pot $1600 | Rake $0
Board [8c 4d 3d Jh]
Seat 1: DeepStack (button) (small blind) collected ($1600)
Seat 2: Nate_@NateMeyvis (big blind) folded on the Turn

PokerStars Hand #1001600025: Tournament #17, Mar29_2017-at-16_15_32 Hold'em No Limit ($100/$200 USD) - 2017/03/29 18:15:56 ET
Table 'ACPC Match' 2-max Seat #2 is the button
Seat 1: DeepStack ($18150 in chips)
Seat 2: Nate_@NateMeyvis ($21850 in chips)
Nate_@NateMeyvis: posts small blind $100
DeepStack: posts big blind $200
*** HOLE CARDS ***
Dealt to DeepStack [Qd 2s]
Dealt to Nate_@NateMeyvis [4s 5d]
Nate_@NateMeyvis: raises $400 to $600
DeepStack: folds
Uncalled bet ($400) returned to Nate_@NateMeyvis
Nate_@NateMeyvis collected $400 from the pot
*** SUMMARY ***
Total pot $400 | Rake $0
Seat 1: DeepStack (big blind) folded before the Flop
Seat 2: Nate_@NateMeyvis (button) (small blind) collected ($400)

PokerStars Hand #1001600026: Tournament #17, Mar29_2017-at-16_15_32 Hold'em No Limit ($100/$200 USD) - 2017/03/29 18:15:57 ET
Table 'ACPC Match' 2-max Seat #1 is the button
Seat 1: DeepStack ($17950 in chips)
Seat 2: Nate_@NateMeyvis ($22050 in chips)
DeepStack: posts small blind $100
Nate_@NateMeyvis: posts big blind $200
*** HOLE CARDS ***
Dealt to DeepStack [5s Ac]
Dealt to Nate_@NateMeyvis [7d Kh]
DeepStack: raises $200 to $400
Nate_@NateMeyvis: calls $200
*** FLOP **** [Jd Kc 3h]
Nate_@NateMeyvis: checks
DeepStack: checks
*** TURN **** [4h]
Nate_@NateMeyvis: bets $600
DeepStack: raises $2000 to $2600
Nate_@NateMeyvis: calls $2000
*** RIVER **** [7s]
Nate_@NateMeyvis: checks
DeepStack: raises $14950 to $14950 and is all-in
Nate_@NateMeyvis: folds
Uncalled bet ($14950) returned to DeepStack
DeepStack collected $6000 from the pot
*** SUMMARY ***
Total pot $6000 | Rake $0
Board [Jd Kc 3h 4h 7s]
Seat 1: DeepStack (button) (small blind) collected ($6000)
Seat 2: Nate_@NateMeyvis (big blind) folded on the River

PokerStars Hand #1001600027: Tournament #17, Mar29_2017-at-16_15_32 Hold'em No Limit ($100/$200 USD) - 2017/03/29 18:15:58 ET
Table 'ACPC Match' 2-max Seat #2 is the button
Seat 1: DeepStack ($20950 in chips)
Seat 2: Nate_@NateMeyvis ($19050 in chips)
Nate_@NateMeyvis: posts small blind $100
DeepStack: posts big blind $200
*** HOLE CARDS ***
Dealt to DeepStack [Qc 7h]
Dealt to Nate_@NateMeyvis [Tc 2c]
Nate_@NateMeyvis: raises $400 to $600
DeepStack: folds
Uncalled bet ($400) returned to Nate_@NateMeyvis
Nate_@NateMeyvis collected $400 from the pot
*** SUMMARY ***
Total pot $400 | Rake $0
Seat 1: DeepStack (big blind) folded before the Flop
Seat 2: Nate_@NateMeyvis (button) (small blind) collected ($400)

PokerStars Hand #1001600028: Tournament #17, Mar29_2017-at-16_15_32 Hold'em No Limit ($100/$200 USD) - 2017/03/29 18:15:59 ET
Table 'ACPC Match' 2-max Seat #1 is the button
Seat 1: DeepStack ($20750 in chips)
Seat 2: Nate_@NateMeyvis ($19250 in chips)
DeepStack: posts small blind $100
Nate_@NateMeyvis: posts big blind $200
*** HOLE CARDS ***
Dealt to DeepStack [6d Ad]
Dealt to Nate_@NateMeyvis [9d Jc]
DeepStack: raises $200 to $400
Nate_@NateMeyvis: calls $200
*** FLOP **** [9c Kc 4c]
Nate_@NateMeyvis: checks
DeepStack: checks
*** TURN **** [6s]
Nate_@NateMeyvis: bets $400
DeepStack: calls $400
*** RIVER **** [3c]
Nate_@NateMeyvis: bets $800
DeepStack: raises $1600 to $2400
Nate_@NateMeyvis: folds
Uncalled bet ($1600) returned to DeepStack
DeepStack collected $3200 from the pot
*** SUMMARY ***
Total pot $3200 | Rake $0
Board [9c Kc 4c 6s 3c]
Seat 1: DeepStack (button) (small blind) collected ($3200)
Seat 2: Nate_@NateMeyvis (big blind) folded on the River

PokerStars Hand #1001600029: Tournament #17, Mar29_2017-at-16_15_32 Hold'em No Limit ($100/$200 USD) - 2017/03/29 18:16:00 ET
Table 'ACPC Match' 2-max Seat #2 is the button
Seat 1: DeepStack ($22350 in chips)
Seat 2: Nate_@NateMeyvis ($17650 in chips)
Nate_@NateMeyvis: posts small blind $100
DeepStack: posts big blind $200
*** HOLE CARDS ***
Dealt to DeepStack [Jh 3d]
Dealt to Nate_@NateMeyvis [7d 3s]
Nate_@NateMeyvis: folds
Uncalled bet ($100) returned to DeepStack
DeepStack collected $200 from the pot
*** SUMMARY ***
Total pot $200 | Rake $0
Seat 1: DeepStack (big blind) collected ($200)
Seat 2: Nate_@NateMeyvis (button) (small blind) folded before the Flop

PokerStars Hand #1001600030: Tournament #17, Mar29_2017-at-16_15_32 Hold'em No Limit ($100/$200 USD) - 2017/03/29 18:16:01 ET
Table 'ACPC Match' 2-max Seat #1 is the button
Seat 1: DeepStack ($22450 in chips)
Seat 2: Nate_@NateMeyvis ($17550 in chips)
DeepStack: posts small blind $100
Nate_@NateMeyvis: posts big blind $200
*** HOLE CARDS ***
Dealt to DeepStack [Qs Qc]
Dealt to Nate_@NateMeyvis [3s 7s]
DeepStack: raises $400 to $600
Nate_@NateMeyvis: folds
Uncalled bet ($400) returned to DeepStack
DeepStack collected $400 from the pot
*** SUMMARY ***
Total pot $400 | Rake $0
Seat 1: DeepStack (button) (small blind) collected ($400)
Seat 2: Nate_@NateMeyvis (big blind) folded before the Flop

PokerStars Hand #1001600031: Tournament #17, Mar29_2017-at-16_15_32 Hold'em No Limit ($150/$300 USD) - 2017/03/29 18:16:02 ET
Table 'ACPC Match' 2-max Seat #2 is the button
Seat 1: DeepStack ($22650 in chips)
Seat 2: Nate_@NateMeyvis ($17350 in chips)
Nate_@NateMeyvis: posts small blind $150
DeepStack: posts big blind $300
*** HOLE CARDS ***
Dealt to DeepStack [7d Tc]
Dealt to Nate_@NateMeyvis [4s Jd]
Nate_@NateMeyvis: folds
Uncalled bet ($150) returned to DeepStack
DeepStack collected $300 from the pot
*** SUMMARY ***
Total pot $300 | Rake $0
Seat 1: DeepStack (big blind) collected ($300)
Seat 2: Nate_@NateMeyvis (button) (small blind) folded before the Flop

PokerStars Hand #1001600032: Tournament #17, Mar29_2017-at-16_15_32 Hold'em No Limit ($150/$300 USD) - 2017/03/29 18:16:03 ET
Table 'ACPC Match' 2-max Seat #1 is the button
Seat 1: DeepStack ($22800 in chips)
Seat 2: Nate_@NateMeyvis ($17200 in chips)
DeepStack: posts small blind $150
Nate_@NateMeyvis: posts big blind $300
*** HOLE CARDS ***
Dealt to DeepStack [2d 2s]
Dealt to Nate_@NateMeyvis [9s 9d]
DeepStack: raises $300 to $600
Nate_@NateMeyvis: calls $300
*** FLOP **** [8h Qh 7s]
Nate_@NateMeyvis: checks
DeepStack: checks
*** TURN **** [8c]
Nate_@NateMeyvis: checks
DeepStack: checks
*** RIVER **** [Jh]
Nate_@NateMeyvis: checks
DeepStack: checks
*** SHOW DOWN ***
Nate_@NateMeyvis: shows [9s 9d] (two pair, Nines and Eights)
DeepStack: shows [2d 2s] (two pair, Eights and Deuces)
Nate_@NateMeyvis collected $1200 from pot
*** SUMMARY ***
Total pot $1200 | Rake $0
Board [8h Qh 7s 8c Jh]
Seat 1: DeepStack (button) (small blind) showed [2d 2s] and lost with two pair, Eights and Deuces
Seat 2: Nate_@NateMeyvis (big blind) showed [9s 9d] and won ($1200) with two pair, Nines and Eights

PokerStars Hand #1001600033: Tournament #17, Mar29_2017-at-16_15_32 Hold'em No Limit ($150/$300 USD) - 2017/03/29 18:16:04 ET
Table 'ACPC Match' 2-max Seat #2 is the button
Seat 1: DeepStack ($22200 in chips)
Seat 2: Nate_@NateMeyvis ($17800 in chips)
Nate_@NateMeyvis: posts small blind $150
DeepStack: posts big blind $300
*** HOLE CARDS ***
Dealt to DeepStack [9s 8s]
Dealt to Nate_@NateMeyvis [Kh 8d]
Nate_@NateMeyvis: raises $450 to $750
DeepStack: raises $1500 to $2250
Nate_@NateMeyvis: folds
Uncalled bet ($1500) returned to DeepStack
DeepStack collected $1500 from the pot
*** SUMMARY ***
Total pot $1500 | Rake $0
Seat 1: DeepStack (big blind) collected ($1500)
Seat 2: Nate_@NateMeyvis (button) (small blind) folded before the Flop

PokerStars Hand #1001600034: Tournament #17, Mar29_2017-at-16_15_32 Hold'em No Limit ($150/$300 USD) - 2017/03/29 18:16:05 ET
Table 'ACPC Match' 2-max Seat #1 is the button
Seat 1: DeepStack ($22950 in chips)
Seat 2: Nate_@NateMeyvis ($17050 in chips)
DeepStack: posts small blind $150
Nate_@NateMeyvis: posts big blind $300
*** HOLE CARDS ***
Dealt to DeepStack [Qc 2h]
Dealt to Nate_@NateMeyvis [6h 4d]
DeepStack: raises $300 to $600
Nate_@NateMeyvis: calls $300
*** FLOP **** [Jh 2d 5c]
Nate_@NateMeyvis: checks
DeepStack: raises $600 to $600
Nate_@NateMeyvis: folds
Uncalled bet ($600) returned to DeepStack
DeepStack collected $1200 from the pot
*** SUMMARY ***
Total pot $1200 | Rake $0
Board [Jh 2d 5c]
Seat 1: DeepStack (button) (small blind) collected ($1200)
Seat 2: Nate_@NateMeyvis (big blind) folded on the Flop

PokerStars Hand #1001600035: Tournament #17, Mar29_2017-at-16_15_32 Hold'em No Limit ($150/$300 USD) - 2017/03/29 18:16:06 ET
Table 'ACPC Match' 2-max Seat #2 is the button
Seat 1: DeepStack ($23550 in chips)
Seat 2: Nate_@NateMeyvis ($16450 in chips)
Nate_@NateMeyvis: posts small blind $150
DeepStack: posts big blind $300
*** HOLE CARDS ***
Dealt to DeepStack [7c 9c]
Dealt to Nate_@NateMeyvis [4c 4s]
Nate_@NateMeyvis: raises $450 to $750
DeepStack: raises $1500 to $2250
Nate_@NateMeyvis: folds
Uncalled bet ($1500) returned to DeepStack
DeepStack collected $1500 from the pot
*** SUMMARY ***
Total pot $1500 | Rake $0
Seat 1: DeepStack (big blind) collected ($1500)
Seat 2: Nate_@NateMeyvis (button) (small blind) folded before the Flop

PokerStars Hand #1001600036: Tournament #17, Mar29_2017-at-16_15_32 Hold'em No Limit ($150/$300 USD) - 2017/03/29 18:16:07 ET
Table 'ACPC Match' 2-max Seat #1 is the button
Seat 1: DeepStack ($24300 in chips)
Seat 2: Nate_@NateMeyvis ($15700 in chips)
DeepStack: posts small blind $150
Nate_@NateMeyvis: posts big blind $300
*** HOLE CARDS ***
Dealt to DeepStack [5c 4s]
Dealt to Nate_@NateMeyvis [Jd 3d]
DeepStack: raises $300 to $600
Nate_@NateMeyvis: calls $300
*** FLOP **** [8s 8h Jh]
Nate_@NateMeyvis: checks
DeepStack: checks
*** TURN **** [Tc]
Nate_@NateMeyvis: checks
DeepStack: checks
*** RIVER **** [7d]
Nate_@NateMeyvis: checks
DeepStack: raises $1200 to $1200
Nate_@NateMeyvis: calls $1200
*** SHOW DOWN ***
DeepStack: shows [5c 4s] (a pair of Eights)
Nate_@NateMeyvis: shows [Jd 3d] (two pair, Jacks and Eights)
Nate_@NateMeyvis collected $3600 from pot
*** SUMMARY ***
Total pot $3600 | Rake $0
Board [8s 8h Jh Tc 7d]
Seat 1: DeepStack (button) (small blind) showed [5c 4s] and lost with a pair of Eights
Seat 2: Nate_@NateMeyvis (big blind) showed [Jd 3d] and won ($3600) with two pair, Jacks and Eights

PokerStars Hand #1001600037: Tournament #17, Mar29_2017-at-16_15_32 Hold'em No Limit ($150/$300 USD) - 2017/03/29 18:16:08 ET
Table 'ACPC Match' 2-max Seat #2 is the button
Seat 1: DeepStack ($22500 in chips)
Seat 2: Nate_@NateMeyvis ($17500 in chips)
Nate_@NateMeyvis: posts small blind $150
DeepStack: posts big blind $300
*** HOLE CARDS ***
Dealt to DeepStack [5d 5h]
Dealt to Nate_@NateMeyvis [Ac 2s]
Nate_@NateMeyvis: raises $450 to $750
DeepStack: raises $1500 to $2250
Nate_@NateMeyvis: folds
Uncalled bet ($1500) returned to DeepStack
DeepStack collected $1500 from the pot
*** SUMMARY ***
Total pot $1500 | Rake $0
Seat 1: DeepStack (big blind) collected ($1500)
Seat 2: Nate_@NateMeyvis (button) (small blind) folded before the Flop

PokerStars Hand #1001600038: Tournament #17, Mar29_2017-at-16_15_32 Hold'em No Limit ($150/$300 USD) - 2017/03/29 18:16:09 ET
Table 'ACPC Match' 2-max Seat #1 is the button
Seat 1: DeepStack ($23250 in chips)
Seat 2: Nate_@NateMeyvis ($16750 in chips)
DeepStack: posts small blind $150
Nate_@NateMeyvis: posts big blind $300
*** HOLE CARDS ***
Dealt to DeepStack [3c Ks]
Dealt to Nate_@NateMeyvis [Qh 8d]
DeepStack: raises $300 to $600
Nate_@NateMeyvis: calls $300
*** FLOP **** [8c Qc 6d]
Nate_@NateMeyvis: checks
DeepStack: raises $1200 to $1200
Nate_@NateMeyvis: calls $1200
*** TURN **** [Kc]
Nate_@NateMeyvis: checks
DeepStack: raises $1800 to $1800
Nate_@NateMeyvis: calls $1800
*** RIVER **** [5c]
Nate_@NateMeyvis: checks
DeepStack: checks
*** SHOW DOWN ***
Nate_@NateMeyvis: shows [Qh 8d] (two pair, Queens and Eights)
DeepStack: shows [3c Ks] (flush, King high)
DeepStack collected $7200 from pot
*** SUMMARY ***
Total pot $7200 | Rake $0
Board [8c Qc 6d Kc 5c]
Seat 1: DeepStack (button) (small blind) showed [3c Ks] and won ($7200) with flush, King high
Seat 2: Nate_@NateMeyvis (big blind) showed [Qh 8d] and lost with two pair, Queens and Eights

PokerStars Hand #1001600039: Tournament #17, Mar29_2017-at-16_15_32 Hold'em No Limit ($150/$300 USD) - 2017/03/29 18:16:10 ET
Table 'ACPC Match' 2-max Seat #2 is the button
Seat 1: DeepStack ($26850 in chips)
Seat 2: Nate_@NateMeyvis ($13150 in chips)
Nate_@NateMeyvis: posts small blind $150
DeepStack: posts big blind $300
*** HOLE CARDS ***
Dealt to DeepStack [7d 5h]
Dealt to Nate_@NateMeyvis [2s Ac]
Nate_@NateMeyvis: raises $450 to $750
DeepStack: calls $450
*** FLOP **** [4c Tc 6s]
DeepStack: checks
Nate_@NateMeyvis: checks
*** TURN **** [6h]
DeepStack: bets $1499
Nate_@NateMeyvis: folds
Uncalled bet ($1499) returned to DeepStack
DeepStack collected $1500 from the pot
*** SUMMARY ***
Total pot $1500 | Rake $0
Board [4c Tc 6s 6h]
Seat 1: DeepStack (big blind) collected ($1500)
Seat 2: Nate_@NateMeyvis (button) (small blind) folded on the Turn

PokerStars Hand #1001600040: Tournament #17, Mar29_2017-at-16_15_32 Hold'em No Limit ($150/$300 USD) - 2017/03/29 18:16:11 ET
Table 'ACPC Match' 2-max Seat #1 is the button
Seat 1: DeepStack ($27600 in chips)
Seat 2: Nate_@NateMeyvis ($12400 in chips)
DeepStack: posts small blind $150
Nate_@NateMeyvis: posts big blind $300
*** HOLE CARDS ***
Dealt to DeepStack [2h 4d]
Dealt to Nate_@NateMeyvis [Kd 9h]
DeepStack: folds
Uncalled bet ($150) returned to Nate_@NateMeyvis
Nate_@NateMeyvis collected $300 from the pot
*** SUMMARY ***
Total pot $300 | Rake $0
Seat 1: DeepStack (button) (small blind) folded before the Flop
Seat 2: Nate_@NateMeyvis (big blind) collected ($300)

PokerStars Hand #1001600041: Tournament #17, Mar29_2017-at-16_15_32 Hold'em No Limit ($200/$400 USD) - 2017/03/29 18:16:12 ET
Table 'ACPC Match' 2-max Seat #2 is the button
Seat 1: DeepStack ($27450 in chips)
Seat 2: Nate_@NateMeyvis ($12550 in chips)
Nate_@NateMeyvis: posts small blind $200
DeepStack: posts big blind $400
*** HOLE CARDS ***
Dealt to DeepStack [6s Th]
Dealt to Nate_@NateMeyvis [5s 3d]
Nate_@NateMeyvis: calls $200
DeepStack: checks
*** FLOP **** [Jc 6d Qh]
DeepStack: checks
Nate_@NateMeyvis: raises $400 to $400
DeepStack: calls $400
*** TURN **** [As]
DeepStack: checks
Nate_@NateMeyvis: checks
*** RIVER **** [Ts]
DeepStack: bets $800
Nate_@NateMeyvis: folds
Uncalled bet ($800) returned to DeepStack
DeepStack collected $1600 from the pot
*** SUMMARY ***
Total pot $1600 | Rake $0
Board [Jc 6d Qh As Ts]
Seat 1: DeepStack (big blind) collected ($1600)
Seat 2: Nate_@NateMeyvis (button) (small blind) folded on the River

PokerStars Hand #1001600042: Tournament #17, Mar29_2017-at-16_15_32 Hold'em No Limit ($200/$400 USD) - 2017/03/29 18:16:13 ET
Table 'ACPC Match' 2-max Seat #1 is the button
Seat 1: DeepStack ($28250 in chips)
Seat 2: Nate_@NateMeyvis ($11750 in chips)
DeepStack: posts small blind $200
Nate_@NateMeyvis: posts big blind $400
*** HOLE CARDS ***
Dealt to DeepStack [2h Qc]
Dealt to Nate_@NateMeyvis [Js 6s]
DeepStack: calls $200
Nate_@NateMeyvis: checks
*** FLOP **** [3d 4h 5d]
Nate_@NateMeyvis: checks
DeepStack: raises $400 to $400
Nate_@NateMeyvis: calls $400
*** TURN **** [9s]
Nate_@NateMeyvis: checks
DeepStack: checks
*** RIVER **** [Ts]
Nate_@NateMeyvis: bets $1200
DeepStack: folds
Uncalled bet ($1200) returned to Nate_@NateMeyvis
Nate_@NateMeyvis collected $1600 from the pot
*** SUMMARY ***
Total pot $1600 | Rake $0
Board [3d 4h 5d 9s Ts]
Seat 1: DeepStack (button) (small blind) folded on the River
Seat 2: Nate_@NateMeyvis (big blind) collected ($1600)

PokerStars Hand #1001600043: Tournament #17, Mar29_2017-at-16_15_32 Hold'em No Limit ($200/$400 USD) - 2017/03/29 18:16:14 ET
Table 'ACPC Match' 2-max Seat #2 is the button
Seat 1: DeepStack ($27450 in chips)
Seat 2: Nate_@NateMeyvis ($12550 in chips)
Nate_@NateMeyvis: posts small blind $200
DeepStack: posts big blind $400
*** HOLE CARDS ***
Dealt to DeepStack [3c Kd]
Dealt to Nate_@NateMeyvis [3h 7s]
Nate_@NateMeyvis: folds
Uncalled bet ($200) returned to DeepStack
DeepStack collected $400 from the pot
*** SUMMARY ***
Total pot $400 | Rake $0
Seat 1: DeepStack (big blind) collected ($400)
Seat 2: Nate_@NateMeyvis (button) (small blind) folded before the Flop

PokerStars Hand #1001600044: Tournament #17, Mar29_2017-at-16_15_32 Hold'em No Limit ($200/$400 USD) - 2017/03/29 18:16:15 ET
Table 'ACPC Match' 2-max Seat #1 is the button
Seat 1: DeepStack ($27650 in chips)
Seat 2: Nate_@NateMeyvis ($12350 in chips)
DeepStack: posts small blind $200
Nate_@NateMeyvis: posts big blind $400
*** HOLE CARDS ***
Dealt to DeepStack [8d 9s]
Dealt to Nate_@NateMeyvis [8c Qs]
DeepStack: calls $200
Nate_@NateMeyvis: checks
*** FLOP **** [3s Qc Jd]
Nate_@NateMeyvis: checks
DeepStack: raises $400 to $400
Nate_@NateMeyvis: calls $400
*** TURN **** [Ah]
Nate_@NateMeyvis: checks
DeepStack: raises $800 to $800
Nate_@NateMeyvis: calls $800
*** RIVER **** [Ac]
Nate_@NateMeyvis: checks
DeepStack: checks
*** SHOW DOWN ***
Nate_@NateMeyvis: shows [8c Qs] (two pair, Aces and Queens)
DeepStack: shows [8d 9s] (a pair of Aces)
Nate_@NateMeyvis collected $3200 from pot
*** SUMMARY ***
Total pot $3200 | Rake $0
Board [3s Qc Jd Ah Ac]
Seat 1: DeepStack (button) (small blind) showed [8d 9s] and lost with a pair of Aces
Seat 2: Nate_@NateMeyvis (big blind) showed [8c Qs] and won ($3200) with two pair, Aces and Queens

PokerStars Hand #1001600045: Tournament #17, Mar29_2017-at-16_15_32 Hold'em No Limit ($200/$400 USD) - 2017/03/29 18:16:16 ET
Table 'ACPC Match' 2-max Seat #2 is the button
Seat 1: DeepStack ($26050 in chips)
Seat 2: Nate_@NateMeyvis ($13950 in chips)
Nate_@NateMeyvis: posts small blind $200
DeepStack: posts big blind $400
*** HOLE CARDS ***
Dealt to DeepStack [7c Td]
Dealt to Nate_@NateMeyvis [Qd 7s]
Nate_@NateMeyvis: raises $600 to $1000
DeepStack: raises $2000 to $3000
Nate_@NateMeyvis: folds
Uncalled bet ($2000) returned to DeepStack
DeepStack collected $2000 from the pot
*** SUMMARY ***
Total pot $2000 | Rake $0
Seat 1: DeepStack (big blind) collected ($2000)
Seat 2: Nate_@NateMeyvis (button) (small blind) folded before the Flop

PokerStars Hand #1001600046: Tournament #17, Mar29_2017-at-16_15_32 Hold'em No Limit ($200/$400 USD) - 2017/03/29 18:16:17 ET
Table 'ACPC Match' 2-max Seat #1 is the button
Seat 1: DeepStack ($27050 in chips)
Seat 2: Nate_@NateMeyvis ($12950 in chips)
DeepStack: posts small blind $200
Nate_@NateMeyvis: posts big blind $400
*** HOLE CARDS ***
Dealt to DeepStack [Kd 3c]
Dealt to Nate_@NateMeyvis [7s Ac]
DeepStack: raises $400 to $800
Nate_@NateMeyvis: calls $400
*** FLOP **** [8h 4h 7c]
Nate_@NateMeyvis: checks
DeepStack: checks
*** TURN **** [2d]
Nate_@NateMeyvis: bets $800
DeepStack: folds
Uncalled bet ($800) returned to Nate_@NateMeyvis
Nate_@NateMeyvis collected $1600 from the pot
*** SUMMARY ***
Total pot $1600 | Rake $0
Board [8h 4h 7c 2d]
Seat 1: DeepStack (button) (small blind) folded on the Turn
Seat 2: Nate_@NateMeyvis (big blind) collected ($1600)

PokerStars Hand #1001600047: Tournament #17, Mar29_2017-at-16_15_32 Hold'em No Limit ($200/$400 USD) - 2017/03/29 18:16:18 ET
Table 'ACPC Match' 2-max Seat #2 is the button
Seat 1: DeepStack ($26250 in chips)
Seat 2: Nate_@NateMeyvis ($13750 in chips)
Nate_@NateMeyvis: posts small blind $200
DeepStack: posts big blind $400
*** HOLE CARDS ***
Dealt to DeepStack [Kd Td]
Dealt to Nate_@NateMeyvis [9s Ks]
Nate_@NateMeyvis: raises $600 to $1000
DeepStack: calls $600
*** FLOP **** [3c 2d 2s]
DeepStack: checks
Nate_@NateMeyvis: raises $1000 to $1000
DeepStack: calls $1000
*** TURN **** [Js]
DeepStack: checks
Nate_@NateMeyvis: raises $2750 to $2750
DeepStack: folds
Uncalled bet ($2750) returned to Nate_@NateMeyvis
Nate_@NateMeyvis collected $4000 from the pot
*** SUMMARY ***
Total pot $4000 | Rake $0
Board [3c 2d 2s Js]
Seat 1: DeepStack (big blind) folded on the Turn
Seat 2: Nate_@NateMeyvis (button) (small blind) collected ($4000)

PokerStars Hand #1001600048: Tournament #17, Mar29_2017-at-16_15_32 Hold'em No Limit ($200/$400 USD) - 2017/03/29 18:16:19 ET
Table 'ACPC Match' 2-max Seat #1 is the button
Seat 1: DeepStack ($24250 in chips)
Seat 2: Nate_@NateMeyvis ($15750 in chips)
DeepStack: posts small blind $200
Nate_@NateMeyvis: posts big blind $400
*** HOLE CARDS ***
Dealt to DeepStack [Ad 2h]
Dealt to Nate_@NateMeyvis [7c 3h]
DeepStack: raises $400 to $800
Nate_@NateMeyvis: folds
Uncalled bet ($400) returned to DeepStack
DeepStack collected $800 from the pot
*** SUMMARY ***
Total pot $800 | Rake $0
Seat 1: DeepStack (button) (small blind) collected ($800)
Seat 2: Nate_@NateMeyvis (big blind) folded before the Flop

PokerStars Hand #1001600049: Tournament #17, Mar29_2017-at-16_15_32 Hold'em No Limit ($200/$400 USD) - 2017/03/29 18:16:20 ET
Table 'ACPC Match' 2-max Seat #2 is the button
Seat 1: DeepStack ($24650 in chips)
Seat 2: Nate_@NateMeyvis ($15350 in chips)
Nate_@NateMeyvis: posts small blind $200
DeepStack: posts big blind $400
*** HOLE CARDS ***
Dealt to DeepStack [Jc Kd]
Dealt to Nate_@NateMeyvis [9s 3s]
Nate_@NateMeyvis: calls $200
DeepStack: raises $800 to $1200
Nate_@NateMeyvis: folds
Uncalled bet ($800) returned to DeepStack
DeepStack collected $800 from the pot
*** SUMMARY ***
Total pot $800 | Rake $0
Seat 1: DeepStack (big blind) collected ($800)
Seat 2: Nate_@NateMeyvis (button) (small blind) folded before the Flop

PokerStars Hand #1001600050: Tournament #17, Mar29_2017-at-16_15_32 Hold'em No Limit ($200/$400 USD) - 2017/03/29 18:16:21 ET
Table 'ACPC Match' 2-max Seat #1 is the button
Seat 1: DeepStack ($25050 in chips)
Seat 2: Nate_@NateMeyvis ($14950 in chips)
DeepStack: posts small blind $200
Nate_@NateMeyvis: posts big blind $400
*** HOLE CARDS ***
Dealt to DeepStack [3c 9h]
Dealt to Nate_@NateMeyvis [3h Kd]
DeepStack: folds
Uncalled bet ($200) returned to Nate_@NateMeyvis
Nate_@NateMeyvis collected $400 from the pot
*** SUMMARY ***
Total pot $400 | Rake $0
Seat 1: DeepStack (button) (small blind) folded before the Flop
Seat 2: Nate_@NateMeyvis (big blind) collected ($400)

PokerStars Hand #1001600051: Tournament #17, Mar29_2017-at-16_15_32 Hold'em No Limit ($300/$600 USD) - 2017/03/29 18:16:22 ET
Table 'ACPC Match' 2-max Seat #2 is the button
Seat 1: DeepStack ($24850 in chips)
Seat 2: Nate_@NateMeyvis ($15150 in chips)
Nate_@NateMeyvis: posts small blind $300
DeepStack: posts big blind $600
*** HOLE CARDS ***
Dealt to DeepStack [3d 7s]
Dealt to Nate_@NateMeyvis [Ac Kh]
Nate_@NateMeyvis: raises $600 to $1200
DeepStack: folds
Uncalled bet ($600) returned to Nate_@NateMeyvis
Nate_@NateMeyvis collected $1200 from the pot
*** SUMMARY ***
Total pot $1200 | Rake $0
Seat 1: DeepStack (big blind) folded before the Flop
Seat 2: Nate_@NateMeyvis (button) (small blind) collected ($1200)

PokerStars Hand #1001600052: Tournament #17, Mar29_2017-at-16_15_32 Hold'em No Limit ($300/$600 USD) - 2017/03/29 18:16:23 ET
Table 'ACPC Match' 2-max Seat #1 is the button
Seat 1: DeepStack ($24250 in chips)
Seat 2: Nate_@NateMeyvis ($15750 in chips)
DeepStack: posts small blind $300
Nate_@NateMeyvis: posts big blind $600
*** HOLE CARDS ***
Dealt to DeepStack [Td Js]
Dealt to Nate_@NateMeyvis [6h Qh]
DeepStack: calls $300
Nate_@NateMeyvis: checks
*** FLOP **** [7h Qd 2h]
Nate_@NateMeyvis: checks
DeepStack: raises $600 to $600
Nate_@NateMeyvis: raises $1300 to $1900
DeepStack: folds
Uncalled bet ($1300) returned to Nate_@NateMeyvis
Nate_@NateMeyvis collected $2400 from the pot
*** SUMMARY ***
Total pot $2400 | Rake $0
Board [7h Qd 2h]
Seat 1: DeepStack (button) (small blind) folded on the Flop
Seat 2: Nate_@NateMeyvis (big blind) collected ($2400)

PokerStars Hand #1001600053: Tournament #17, Mar29_2017-at-16_15_32 Hold'em No Limit ($300/$600 USD) - 2017/03/29 18:16:24 ET
Table 'ACPC Match' 2-max Seat #2 is the button
Seat 1: DeepStack ($23050 in chips)
Seat 2: Nate_@NateMeyvis ($16950 in chips)
Nate_@NateMeyvis: posts small blind $300
DeepStack: posts big blind $600
*** HOLE CARDS ***
Dealt to DeepStack [5h 2c]
Dealt to Nate_@NateMeyvis [3h 7d]
Nate_@NateMeyvis: calls $300
DeepStack: checks
*** FLOP **** [Jc 2s 4s]
DeepStack: checks
Nate_@NateMeyvis: raises $600 to $600
DeepStack: raises $1200 to $1800
Nate_@NateMeyvis: folds
Uncalled bet ($1200) returned to DeepStack
DeepStack collected $2400 from the pot
*** SUMMARY ***
Total pot $2400 | Rake $0
Board [Jc 2s 4s]
Seat 1: DeepStack (big blind) collected ($2400)
Seat 2: Nate_@NateMeyvis (button) (small blind) folded on the Flop

PokerStars Hand #1001600054: Tournament #17, Mar29_2017-at-16_15_32 Hold'em No Limit ($300/$600 USD) - 2017/03/29 18:16:25 ET
Table 'ACPC Match' 2-max Seat #1 is the button
Seat 1: DeepStack ($24250 in chips)
Seat 2: Nate_@NateMeyvis ($15750 in chips)
DeepStack: posts small blind $300
Nate_@NateMeyvis: posts big blind $600
*** HOLE CARDS ***
Dealt to DeepStack [9c 8d]
Dealt to Nate_@NateMeyvis [5s Ks]
DeepStack: raises $600 to $1200
Nate_@NateMeyvis: calls $600
*** FLOP **** [Jc 4s Kd]
Nate_@NateMeyvis: checks
DeepStack: raises $1200 to $1200
Nate_@NateMeyvis: calls $1200
*** TURN **** [Qs]
Nate_@NateMeyvis: checks
DeepStack: raises $2400 to $2400
Nate_@NateMeyvis: calls $2400
*** RIVER **** [Jd]
Nate_@NateMeyvis: checks
DeepStack: checks
*** SHOW DOWN ***
Nate_@NateMeyvis: shows [5s Ks] (two pair, Kings and Jacks)
DeepStack: shows [9c 8d] (a pair of Jacks)
Nate_@NateMeyvis collected $9600 from pot
*** SUMMARY ***
Total pot $9600 | Rake $0
Board [Jc 4s Kd Qs Jd]
Seat 1: DeepStack (button) (small blind) showed [9c 8d] and lost with a pair of Jacks
Seat 2: Nate_@NateMeyvis (big blind) showed [5s Ks] and won ($9600) with two pair, Kings and Jacks

PokerStars Hand #1001600055: Tournament #17, Mar29_2017-at-16_15_32 Hold'em No Limit ($300/$600 USD) - 2017/03/29 18:16:26 ET
Table 'ACPC Match' 2-max Seat #2 is the button
Seat 1: DeepStack ($19450 in chips)
Seat 2: Nate_@NateMeyvis ($20550 in chips)
Nate_@NateMeyvis: posts small blind $300
DeepStack: posts big blind $600
*** HOLE CARDS ***
Dealt to DeepStack [Ah 2c]
Dealt to Nate_@NateMeyvis [2h 9c]
Nate_@NateMeyvis: folds
Uncalled bet ($300) returned to DeepStack
DeepStack collected $600 from the pot
*** SUMMARY ***
Total pot $600 | Rake $0
Seat 1: DeepStack (big blind) collected ($600)
Seat 2: Nate_@NateMeyvis (button) (small blind) folded before the Flop

PokerStars Hand #1001600056: Tournament #17, Mar29_2017-at-16_15_32 Hold'em No Limit ($300/$600 USD) - 2017/03/29 18:16:27 ET
Table 'ACPC Match' 2-max Seat #1 is the button
Seat 1: DeepStack ($19750 in chips)
Seat 2: Nate_@NateMeyvis ($20250 in chips)
DeepStack: posts small blind $300
Nate_@NateMeyvis: posts big blind $600
*** HOLE CARDS ***
Dealt to DeepStack [4s Qh]
Dealt to Nate_@NateMeyvis [5d 7h]
DeepStack: raises $600 to $1200
Nate_@NateMeyvis: folds
Uncalled bet ($600) returned to DeepStack
DeepStack collected $1200 from the pot
*** SUMMARY ***
Total pot $1200 | Rake $0
Seat 1: DeepStack (button) (small blind) collected ($1200)
Seat 2: Nate_@NateMeyvis (big blind) folded before the Flop

PokerStars Hand #1001600057: Tournament #17, Mar29_2017-at-16_15_32 Hold'em No Limit ($300/$600 USD) - 2017/03/29 18:16:28 ET
Table 'ACPC Match' 2-max Seat #2 is the button
Seat 1: DeepStack ($20350 in chips)
Seat 2: Nate_@NateMeyvis ($19650 in chips)
Nate_@NateMeyvis: posts small blind $300
DeepStack: posts big blind $600
*** HOLE CARDS ***
Dealt to DeepStack [2s Ad]
Dealt to Nate_@NateMeyvis [2c 8c]
Nate_@NateMeyvis: calls $300
DeepStack: checks
*** FLOP **** [3d Kc Jh]
DeepStack: checks
Nate_@NateMeyvis: raises $600 to $600
DeepStack: calls $600
*** TURN **** [Ks]
DeepStack: checks
Nate_@NateMeyvis: checks
*** RIVER **** [Qh]
DeepStack: checks
Nate_@NateMeyvis: raises $1200 to $1200
DeepStack: calls $1200
*** SHOW DOWN ***
Nate_@NateMeyvis: shows [2c 8c] (a pair of Kings)
DeepStack: shows [2s Ad] (a pair of Kings)
DeepStack collected $4800 from pot
*** SUMMARY ***
Total pot $4800 | Rake $0
Board [3d Kc Jh Ks Qh]
Seat 1: DeepStack (big blind) showed [2s Ad] and won ($4800) with a pair of Kings
Seat 2: Nate_@NateMeyvis (button) (small blind) showed [2c 8c] and lost with a pair of Kings

PokerStars Hand #1001600058: Tournament #17, Mar29_2017-at-16_15_32 Hold'em No Limit ($300/$600 USD) - 2017/03/29 18:16:29 ET
Table 'ACPC Match' 2-max Seat #1 is the button
Seat 1: DeepStack ($22750 in chips)
Seat 2: Nate_@NateMeyvis ($17250 in chips)
DeepStack: posts small blind $300
Nate_@NateMeyvis: posts big blind $600
*** HOLE CARDS ***
Dealt to DeepStack [2s Kc]
Dealt to Nate_@NateMeyvis [Tc 6d]
DeepStack: calls $300
Nate_@NateMeyvis: checks
*** FLOP **** [Js Kh Jc]
Nate_@NateMeyvis: checks
DeepStack: checks
*** TURN **** [9s]
Nate_@NateMeyvis: checks
DeepStack: checks
*** RIVER **** [7c]
Nate_@NateMeyvis: checks
DeepStack: raises $1200 to $1200
Nate_@NateMeyvis: folds
Uncalled bet ($1200) returned to DeepStack
DeepStack collected $1200 from the pot
*** SUMMARY ***
Total pot $1200 | Rake $0
Board [Js Kh Jc 9s 7c]
Seat 1: DeepStack (button) (small blind) collected ($1200)
Seat 2: Nate_@NateMeyvis (big blind) folded on the River

PokerStars Hand #1001600059: Tournament #17, Mar29_2017-at-16_15_32 Hold'em No Limit ($300/$600 USD) - 2017/03/29 18:16:30 ET
Table 'ACPC Match' 2-max Seat #2 is the button
Seat 1: DeepStack ($23350 in chips)
Seat 2: Nate_@NateMeyvis ($16650 in chips)
Nate_@NateMeyvis: posts small blind $300
DeepStack: posts big blind $600
*** HOLE CARDS ***
Dealt to DeepStack [Js Jh]
Dealt to Nate_@NateMeyvis [8s 5d]
Nate_@NateMeyvis: calls $300
DeepStack: raises $1200 to $1800
Nate_@NateMeyvis: folds
Uncalled bet ($1200) returned to DeepStack
DeepStack collected $1200 from the pot
*** SUMMARY ***
Total pot $1200 | Rake $0
Seat 1: DeepStack (big blind) collected ($1200)
Seat 2: Nate_@NateMeyvis (button) (small blind) folded before the Flop

PokerStars Hand #1001600060: Tournament #17, Mar29_2017-at-16_15_32 Hold'em No Limit ($300/$600 USD) - 2017/03/29 18:16:31 ET
Table 'ACPC Match' 2-max Seat #1 is the button
Seat 1: DeepStack ($23950 in chips)
Seat 2: Nate_@NateMeyvis ($16050 in chips)
DeepStack: posts small blind $300
Nate_@NateMeyvis: posts big blind $600
*** HOLE CARDS ***
Dealt to DeepStack [Ah Js]
Dealt to Nate_@NateMeyvis [6h 3d]
DeepStack: calls $300
Nate_@NateMeyvis: checks
*** FLOP **** [4c Ac Jd]
Nate_@NateMeyvis: checks
DeepStack: raises $1200 to $1200
Nate_@NateMeyvis: folds
Uncalled bet ($1200) returned to DeepStack
DeepStack collected $1200 from the pot
*** SUMMARY ***
Total pot $1200 | Rake $0
Board [4c Ac Jd]
Seat 1: DeepStack (button) (small blind) collected ($1200)
Seat 2: Nate_@NateMeyvis (big blind) folded on the Flop

PokerStars Hand #1001600061: Tournament #17, Mar29_2017-at-16_15_32 Hold'em No Limit ($400/$800 USD) - 2017/03/29 18:16:32 ET
Table 'ACPC Match' 2-max Seat #2 is the button
Seat 1: DeepStack ($24550 in chips)
Seat 2: Nate_@NateMeyvis ($15450 in chips)
Nate_@NateMeyvis: posts small blind $400
DeepStack: posts big blind $800
*** HOLE CARDS ***
Dealt to DeepStack [3h 2h]
Dealt to Nate_@NateMeyvis [Kc Kh]
Nate_@NateMeyvis: raises $800 to $1600
DeepStack: calls $800
*** FLOP **** [Ah 7h 5s]
DeepStack: checks
Nate_@NateMeyvis: checks
*** TURN **** [7c]
DeepStack: bets $1600
Nate_@NateMeyvis: calls $1600
*** RIVER **** [9s]
DeepStack: checks
Nate_@NateMeyvis: checks
*** SHOW DOWN ***
DeepStack: shows [3h 2h] (a pair of Sevens)
Nate_@NateMeyvis: shows [Kc Kh] (two pair, Kings and Sevens)
Nate_@NateMeyvis collected $6400 from pot
*** SUMMARY ***
Total pot $6400 | Rake $0
Board [Ah 7h 5s 7c 9s]
Seat 1: DeepStack (big blind) showed [3h 2h] and lost with a pair of Sevens
Seat 2: Nate_@NateMeyvis (button) (small blind) showed [Kc Kh] and won ($6400) with two pair, Kings and Sevens

PokerStars Hand #1001600062: Tournament #17, Mar29_2017-at-16_15_32 Hold'em No Limit ($400/$800 USD) - 2017/03/29 18:16:33 ET
Table 'ACPC Match' 2-max Seat #1 is the button
Seat 1: DeepStack ($21350 in chips)
Seat 2: Nate_@NateMeyvis ($18650 in chips)
DeepStack: posts small blind $400
Nate_@NateMeyvis: posts big blind $800
*** HOLE CARDS ***
Dealt to DeepStack [Ah Kc]
Dealt to Nate_@NateMeyvis [6h 2h]
DeepStack: raises $800 to $1600
Nate_@NateMeyvis: folds
Uncalled bet ($800) returned to DeepStack
DeepStack collected $1600 from the pot
*** SUMMARY ***
Total pot $1600 | Rake $0
Seat 1: DeepStack (button) (small blind) collected ($1600)
Seat 2: Nate_@NateMeyvis (big blind) folded before the Flop

PokerStars Hand #1001600063: Tournament #17, Mar29_2017-at-16_15_32 Hold'em No Limit ($400/$800 USD) - 2017/03/29 18:16:34 ET
Table 'ACPC Match' 2-max Seat #2 is the button
Seat 1: DeepStack ($22150 in chips)
Seat 2: Nate_@NateMeyvis ($17850 in chips)
Nate_@NateMeyvis: posts small blind $400
DeepStack: posts big blind $800
*** HOLE CARDS ***
Dealt to DeepStack [Th Qd]
Dealt to Nate_@NateMeyvis [Kc 3h]
Nate_@NateMeyvis: raises $800 to $1600
DeepStack: calls $800
*** FLOP **** [9h 2c Qc]
DeepStack: checks
Nate_@NateMeyvis: checks
*** TURN **** [Ad]
DeepStack: checks
Nate_@NateMeyvis: checks
*** RIVER **** [4c]
DeepStack: bets $3200
Nate_@NateMeyvis: folds
Uncalled bet ($3200) returned to DeepStack
DeepStack collected $3200 from the pot
*** SUMMARY ***
Total pot $3200 | Rake $0
Board [9h 2c Qc Ad 4c]
Seat 1: DeepStack (big blind) collected ($3200)
Seat 2: Nate_@NateMeyvis (button) (small blind) folded on the River

PokerStars Hand #1001600064: Tournament #17, Mar29_2017-at-16_15_32 Hold'em No Limit ($400/$800 USD) - 2017/03/29 18:16:35 ET
Table 'ACPC Match' 2-max Seat #1 is the button
Seat 1: DeepStack ($23750 in chips)
Seat 2: Nate_@NateMeyvis ($16250 in chips)
DeepStack: posts small blind $400
Nate_@NateMeyvis: posts big blind $800
*** HOLE CARDS ***
Dealt to DeepStack [Qs 7c]
Dealt to Nate_@NateMeyvis [3s 7s]
DeepStack: calls $400
Nate_@NateMeyvis: checks
*** FLOP **** [5h Tc 8h]
Nate_@NateMeyvis: checks
DeepStack: raises $800 to $800
Nate_@NateMeyvis: folds
Uncalled bet ($800) returned to DeepStack
DeepStack collected $1600 from the pot
*** SUMMARY ***
Total pot $1600 | Rake $0
Board [5h Tc 8h]
Seat 1: DeepStack (button) (small blind) collected ($1600)
Seat 2: Nate_@NateMeyvis (big blind) folded on the Flop

PokerStars Hand #1001600065: Tournament #17, Mar29_2017-at-16_15_32 Hold'em No Limit ($400/$800 USD) - 2017/03/29 18:16:36 ET
Table 'ACPC Match' 2-max Seat #2 is the button
Seat 1: DeepStack ($24550 in chips)
Seat 2: Nate_@NateMeyvis ($15450 in chips)
Nate_@NateMeyvis: posts small blind $400
DeepStack: posts big blind $800
*** HOLE CARDS ***
Dealt to DeepStack [Ac 9s]
Dealt to Nate_@NateMeyvis [4h Kh]
Nate_@NateMeyvis: raises $800 to $1600
DeepStack: raises $13850 to $15450
Nate_@NateMeyvis: folds
Uncalled bet ($13850) returned to DeepStack
DeepStack collected $3200 from the pot
*** SUMMARY ***
Total pot $3200 | Rake $0
Seat 1: DeepStack (big blind) collected ($3200)
Seat 2: Nate_@NateMeyvis (button) (small blind) folded before the Flop

PokerStars Hand #1001600066: Tournament #17, Mar29_2017-at-16_15_32 Hold'em No Limit ($400/$800 USD) - 2017/03/29 18:16:37 ET
Table 'ACPC Match' 2-max Seat #1 is the button
Seat 1: DeepStack ($26150 in chips)
Seat 2: Nate_@NateMeyvis ($13850 in chips)
DeepStack: posts small blind $400
Nate_@NateMeyvis: posts big blind $800
*** HOLE CARDS ***
Dealt to DeepStack [5c Ts]
Dealt to Nate_@NateMeyvis [5s Qh]
DeepStack: calls $400
Nate_@NateMeyvis: checks
*** FLOP **** [Ad Th 7d]
Nate_@NateMeyvis: checks
DeepStack: raises $800 to $800
Nate_@NateMeyvis: folds
Uncalled bet ($800) returned to DeepStack
DeepStack collected $1600 from the pot
*** SUMMARY ***
Total pot $1600 | Rake $0
Board [Ad Th 7d]
Seat 1: DeepStack (button) (small blind) collected ($1600)
Seat 2: Nate_@NateMeyvis (big blind) folded on the Flop

PokerStars Hand #1001600067: Tournament #17, Mar29_2017-at-16_15_32 Hold'em No Limit ($400/$800 USD) - 2017/03/29 18:16:38 ET
Table 'ACPC Match' 2-max Seat #2 is the button
Seat 1: DeepStack ($26950 in chips)
Seat 2: Nate_@NateMeyvis ($13050 in chips)
Nate_@NateMeyvis: posts small blind $400
DeepStack: posts big blind $800
*** HOLE CARDS ***
Dealt to DeepStack [Ah 5h]
Dealt to Nate_@NateMeyvis [5s 9s]
Nate_@NateMeyvis: calls $400
DeepStack: checks
*** FLOP **** [Qd 4h 5c]
DeepStack: checks
Nate_@NateMeyvis: raises $800 to $800
DeepStack: calls $800
*** TURN **** [2c]
DeepStack: bets $1600
Nate_@NateMeyvis: calls $1600
*** RIVER **** [Kc]
DeepStack: checks
Nate_@NateMeyvis: checks
*** SHOW DOWN ***
DeepStack: shows [Ah 5h] (a pair of Fives)
Nate_@NateMeyvis: shows [5s 9s] (a pair of Fives)
DeepStack collected $6400 from pot
*** SUMMARY ***
Total pot $6400 | Rake $0
Board [Qd 4h 5c 2c Kc]
Seat 1: DeepStack (big blind) showed [Ah 5h] and won ($6400) with a pair of Fives
Seat 2: Nate_@NateMeyvis (button) (small blind) showed [5s 9s] and lost with a pair of Fives

PokerStars Hand #1001600068: Tournament #17, Mar29_2017-at-16_15_32 Hold'em No Limit ($400/$800 USD) - 2017/03/29 18:16:39 ET
Table 'ACPC Match' 2-max Seat #1 is the button
Seat 1: DeepStack ($30150 in chips)
Seat 2: Nate_@NateMeyvis ($9850 in chips)
DeepStack: posts small blind $400
Nate_@NateMeyvis: posts big blind $800
*** HOLE CARDS ***
Dealt to DeepStack [2s 4d]
Dealt to Nate_@NateMeyvis [Td 5h]
DeepStack: folds
Uncalled bet ($400) returned to Nate_@NateMeyvis
Nate_@NateMeyvis collected $800 from the pot
*** SUMMARY ***
Total pot $800 | Rake $0
Seat 1: DeepStack (button) (small blind) folded before the Flop
Seat 2: Nate_@NateMeyvis (big blind) collected ($800)

PokerStars Hand #1001600069: Tournament #17, Mar29_2017-at-16_15_32 Hold'em No Limit ($400/$800 USD) - 2017/03/29 18:16:40 ET
Table 'ACPC Match' 2-max Seat #2 is the button
Seat 1: DeepStack ($29750 in chips)
Seat 2: Nate_@NateMeyvis ($10250 in chips)
Nate_@NateMeyvis: posts small blind $400
DeepStack: posts big blind $800
*** HOLE CARDS ***
Dealt to DeepStack [9s 6s]
Dealt to Nate_@NateMeyvis [Jh 7s]
Nate_@NateMeyvis: raises $9450 to $10250 and is all-in
DeepStack: folds
Uncalled bet ($9450) returned to Nate_@NateMeyvis
Nate_@NateMeyvis collected $1600 from the pot
*** SUMMARY ***
Total pot $1600 | Rake $0
Seat 1: DeepStack (big blind) folded before the Flop
Seat 2: Nate_@NateMeyvis (button) (small blind) collected ($1600)

PokerStars Hand #1001600070: Tournament #17, Mar29_2017-at-16_15_32 Hold'em No Limit ($400/$800 USD) - 2017/03/29 18:16:41 ET
Table 'ACPC Match' 2-max Seat #1 is the button
Seat 1: DeepStack ($28950 in chips)
Seat 2: Nate_@NateMeyvis ($11050 in chips)
DeepStack: posts small blind $400
Nate_@NateMeyvis: posts big blind $800
*** HOLE CARDS ***
Dealt to DeepStack [Qc Kd]
Dealt to Nate_@NateMeyvis [3h 6s]
DeepStack: calls $400
Nate_@NateMeyvis: checks
*** FLOP **** [2h 5d 5h]
Nate_@NateMeyvis: checks
DeepStack: raises $800 to $800
Nate_@NateMeyvis: raises $9450 to $10250 and is all-in
DeepStack: folds
Uncalled bet ($9450) returned to Nate_@NateMeyvis
Nate_@NateMeyvis collected $3200 from the pot
*** SUMMARY ***
Total pot $3200 | Rake $0
Board [2h 5d 5h]
Seat 1: DeepStack (button) (small blind) folded on the Flop
Seat 2: Nate_@NateMeyvis (big blind) collected ($3200)

PokerStars Hand #1001600071: Tournament #17, Mar29_2017-at-16_15_32 Hold'em No Limit ($500/$1000 USD) - 2017/03/29 18:16:42 ET
Table 'ACPC Match' 2-max Seat #2 is the button
Seat 1: DeepStack ($27350 in chips)
Seat 2: Nate_@NateMeyvis ($12650 in chips)
Nate_@NateMeyvis: posts small blind $500
DeepStack: posts big blind $1000
*** HOLE CARDS ***
Dealt to DeepStack [9s Jh]
Dealt to Nate_@NateMeyvis [Ts 2s]
Nate_@NateMeyvis: calls $500
DeepStack: checks
*** FLOP **** [Qh Ac 7s]
DeepStack: checks
Nate_@NateMeyvis: raises $1000 to $1000
DeepStack: calls $1000
*** TURN **** [4h]
DeepStack: checks
Nate_@NateMeyvis: checks
*** RIVER **** [5d]
DeepStack: checks
Nate_@NateMeyvis: checks
*** SHOW DOWN ***
DeepStack: shows [9s Jh] (Ace high)
Nate_@NateMeyvis: shows [Ts 2s] (Ace high)
DeepStack collected $4000 from pot
*** SUMMARY ***
Total pot $4000 | Rake $0
Board [Qh Ac 7s 4h 5d]
Seat 1: DeepStack (big blind) showed [9s Jh] and won ($4000) with Ace high
Seat 2: Nate_@NateMeyvis (button) (small blind) showed [Ts 2s] and lost with Ace high

PokerStars Hand #1001600072: Tournament #17, Mar29_2017-at-16_15_32 Hold'em No Limit ($500/$1000 USD) - 2017/03/29 18:16:43 ET
Table 'ACPC Match' 2-max Seat #1 is the button
Seat 1: DeepStack ($29350 in chips)
Seat 2: Nate_@NateMeyvis ($10650 in chips)
DeepStack: posts small blind $500
Nate_@NateMeyvis: posts big blind $1000
*** HOLE CARDS ***
Dealt to DeepStack [7s 3d]
Dealt to Nate_@NateMeyvis [Jc 8d]
DeepStack: folds
Uncalled bet ($500) returned to Nate_@NateMeyvis
Nate_@NateMeyvis collected $1000 from the pot
*** SUMMARY ***
Total pot $1000 | Rake $0
Seat 1: DeepStack (button) (small blind) folded before the Flop
Seat 2: Nate_@NateMeyvis (big blind) collected ($1000)

PokerStars Hand #1001600073: Tournament #17, Mar29_2017-at-16_15_32 Hold'em No Limit ($500/$1000 USD) - 2017/03/29 18:16:44 ET
Table 'ACPC Match' 2-max Seat #2 is the button
Seat 1: DeepStack ($28850 in chips)
Seat 2: Nate_@NateMeyvis ($11150 in chips)
Nate_@NateMeyvis: posts small blind $500
DeepStack: posts big blind $1000
*** HOLE CARDS ***
Dealt to DeepStack [7h Kh]
Dealt to Nate_@NateMeyvis [Ts 6s]
Nate_@NateMeyvis: calls $500
DeepStack: checks
*** FLOP **** [3s 6c 4s]
DeepStack: checks
Nate_@NateMeyvis: raises $1000 to $1000
DeepStack: calls $1000
*** TURN **** [2s]
DeepStack: checks
Nate_@NateMeyvis: raises $2000 to $2000
DeepStack: folds
Uncalled bet ($2000) returned to Nate_@NateMeyvis
Nate_@NateMeyvis collected $4000 from the pot
*** SUMMARY ***
Total pot $4000 | Rake $0
Board [3s 6c 4s 2s]
Seat 1: DeepStack (big blind) folded on the Turn
Seat 2: Nate_@NateMeyvis (button) (small blind) collected ($4000)

PokerStars Hand #1001600074: Tournament #17, Mar29_2017-at-16_15_32 Hold'em No Limit ($500/$1000 USD) - 2017/03/29 18:16:45 ET
Table 'ACPC Match' 2-max Seat #1 is the button
Seat 1: DeepStack ($26850 in chips)
Seat 2: Nate_@NateMeyvis ($13150 in chips)
DeepStack: posts small blind $500
Nate_@NateMeyvis: posts big blind $1000
*** HOLE CARDS ***
Dealt to DeepStack [8h 6s]
Dealt to Nate_@NateMeyvis [3s 4s]
DeepStack: calls $500
Nate_@NateMeyvis: checks
*** FLOP **** [8d 7h 6d]
Nate_@NateMeyvis: checks
DeepStack: raises $1000 to $1000
Nate_@NateMeyvis: folds
Uncalled bet ($1000) returned to DeepStack
DeepStack collected $2000 from the pot
*** SUMMARY ***
Total pot $2000 | Rake $0
Board [8d 7h 6d]
Seat 1: DeepStack (button) (small blind) collected ($2000)
Seat 2: Nate_@NateMeyvis (big blind) folded on the Flop

PokerStars Hand #1001600075: Tournament #17, Mar29_2017-at-16_15_32 Hold'em No Limit ($500/$1000 USD) - 2017/03/29 18:16:46 ET
Table 'ACPC Match' 2-max Seat #2 is the button
Seat 1: DeepStack ($27850 in chips)
Seat 2: Nate_@NateMeyvis ($12150 in chips)
Nate_@NateMeyvis: posts small blind $500
DeepStack: posts big blind $1000
*** HOLE CARDS ***
Dealt to DeepStack [Js 4c]
Dealt to Nate_@NateMeyvis [Ks 2d]
Nate_@NateMeyvis: raises $11150 to $12150 and is all-in
DeepStack: folds
Uncalled bet ($11150) returned to Nate_@NateMeyvis
Nate_@NateMeyvis collected $2000 from the pot
*** SUMMARY ***
Total pot $2000 | Rake $0
Seat 1: DeepStack (big blind) folded before the Flop
Seat 2: Nate_@NateMeyvis (button) (small blind) collected ($2000)

PokerStars Hand #1001600076: Tournament #17, Mar29_2017-at-16_15_32 Hold'em No Limit ($500/$1000 USD) - 2017/03/29 18:16:47 ET
Table 'ACPC Match' 2-max Seat #1 is the button
Seat 1: DeepStack ($26850 in chips)
Seat 2: Nate_@NateMeyvis ($13150 in chips)
DeepStack: posts small blind $500
Nate_@NateMeyvis: posts big blind $1000
*** HOLE CARDS ***
Dealt to DeepStack [9s Ac]
Dealt to Nate_@NateMeyvis [5h 2h]
DeepStack: raises $12150 to $13150
Nate_@NateMeyvis: folds
Uncalled bet ($12150) returned to DeepStack
DeepStack collected $2000 from the pot
*** SUMMARY ***
Total pot $2000 | Rake $0
Seat 1: DeepStack (button) (small blind) collected ($2000)
Seat 2: Nate_@NateMeyvis (big blind) folded before the Flop

PokerStars Hand #1001600077: Tournament #17, Mar29_2017-at-16_15_32 Hold'em No Limit ($500/$1000 USD) - 2017/03/29 18:16:48 ET
Table 'ACPC Match' 2-max Seat #2 is the button
Seat 1: DeepStack ($27850 in chips)
Seat 2: Nate_@NateMeyvis ($12150 in chips)
Nate_@NateMeyvis: posts small blind $500
DeepStack: posts big blind $1000
*** HOLE CARDS ***
Dealt to DeepStack [3s 4s]
Dealt to Nate_@NateMeyvis [6h 3h]
Nate_@NateMeyvis: folds
Uncalled bet ($500) returned to DeepStack
DeepStack collected $1000 from the pot
*** SUMMARY ***
Total pot $1000 | Rake $0
Seat 1: DeepStack (big blind) collected ($1000)
Seat 2: Nate_@NateMeyvis (button) (small blind) folded before the Flop

PokerStars Hand #1001600078: Tournament #17, Mar29_2017-at-16_15_32 Hold'em No Limit ($500/$1000 USD) - 2017/03/29 18:16:49 ET
Table 'ACPC Match' 2-max Seat #1 is the button
Seat 1: DeepStack ($28350 in chips)
Seat 2: Nate_@NateMeyvis ($11650 in chips)
DeepStack: posts small blind $500
Nate_@NateMeyvis: posts big blind $1000
*** HOLE CARDS ***
Dealt to DeepStack [Td 3s]
Dealt to Nate_@NateMeyvis [5d 6h]
DeepStack: calls $500
Nate_@NateMeyvis: checks
*** FLOP **** [9h 4c 8c]
Nate_@NateMeyvis: checks
DeepStack: checks
*** TURN **** [8h]
Nate_@NateMeyvis: bets $1300
DeepStack: folds
Uncalled bet ($1300) returned to Nate_@NateMeyvis
Nate_@NateMeyvis collected $2000 from the pot
*** SUMMARY ***
Total pot $2000 | Rake $0
Board [9h 4c 8c 8h]
Seat 1: DeepStack (button) (small blind) folded on the Turn
Seat 2: Nate_@NateMeyvis (big blind) collected ($2000)

PokerStars Hand #1001600079: Tournament #17, Mar29_2017-at-16_15_32 Hold'em No Limit ($500/$1000 USD) - 2017/03/29 18:16:50 ET
Table 'ACPC Match' 2-max Seat #2 is the button
Seat 1: DeepStack ($27350 in chips)
Seat 2: Nate_@NateMeyvis ($12650 in chips)
Nate_@NateMeyvis: posts small blind $500
DeepStack: posts big blind $1000
*** HOLE CARDS ***
Dealt to DeepStack [6c Jc]
Dealt to Nate_@NateMeyvis [9s 2h]
Nate_@NateMeyvis: folds
Uncalled bet ($500) returned to DeepStack
DeepStack collected $1000 from the pot
*** SUMMARY ***
Total pot $1000 | Rake $0
Seat 1: DeepStack (big blind) collected ($1000)
Seat 2: Nate_@NateMeyvis (button) (small blind) folded before the Flop

PokerStars Hand #1001600080: Tournament #17, Mar29_2017-at-16_15_32 Hold'em No Limit ($500/$1000 USD) - 2017/03/29 18:16:51 ET
Table 'ACPC Match' 2-max Seat #1 is the button
Seat 1: DeepStack ($27850 in chips)
Seat 2: Nate_@NateMeyvis ($12150 in chips)
DeepStack: posts small blind $500
Nate_@NateMeyvis: posts big blind $1000
*** HOLE CARDS ***
Dealt to DeepStack [7s 4c]
Dealt to Nate_@NateMeyvis [2h 4h]
DeepStack: calls $500
Nate_@NateMeyvis: checks
*** FLOP **** [Jh Qs 9c]
Nate_@NateMeyvis: checks
DeepStack: checks
*** TURN **** [Ad]
Nate_@NateMeyvis: checks
DeepStack: raises $2000 to $2000
Nate_@NateMeyvis: folds
Uncalled bet ($2000) returned to DeepStack
DeepStack collected $2000 from the pot
*** SUMMARY ***
Total pot $2000 | Rake $0
Board [Jh Qs 9c Ad]
Seat 1: DeepStack (button) (small blind) collected ($2000)
Seat 2: Nate_@NateMeyvis (big blind) folded on the Turn

PokerStars Hand #1001600081: Tournament #17, Mar29_2017-at-16_15_32 Hold'em No Limit ($750/$1500 USD) - 2017/03/29 18:16:52 ET
Table 'ACPC Match' 2-max Seat #2 is the button
Seat 1: DeepStack ($28850 in chips)
Seat 2: Nate_@NateMeyvis ($11150 in chips)
Nate_@NateMeyvis: posts small blind $750
DeepStack: posts big blind $1500
*** HOLE CARDS ***
Dealt to DeepStack [Kc Jh]
Dealt to Nate_@NateMeyvis [3d 2d]
Nate_@NateMeyvis: folds
Uncalled bet ($750) returned to DeepStack
DeepStack collected $1500 from the pot
*** SUMMARY ***
Total pot $1500 | Rake $0
Seat 1: DeepStack (big blind) collected ($1500)
Seat 2: Nate_@NateMeyvis (button) (small blind) folded before the Flop

PokerStars Hand #1001600082: Tournament #17, Mar29_2017-at-16_15_32 Hold'em No Limit ($750/$1500 USD) - 2017/03/29 18:16:53 ET
Table 'ACPC Match' 2-max Seat #1 is the button
Seat 1: DeepStack ($29600 in chips)
Seat 2: Nate_@NateMeyvis ($10400 in chips)
DeepStack: posts small blind $750
Nate_@NateMeyvis: posts big blind $1500
*** HOLE CARDS ***
Dealt to DeepStack [Ah 7s]
Dealt to Nate_@NateMeyvis [5h Tc]
DeepStack: raises $8900 to $10400
Nate_@NateMeyvis: folds
Uncalled bet ($8900) returned to DeepStack
DeepStack collected $3000 from the pot
*** SUMMARY ***
Total pot $3000 | Rake $0
Seat 1: DeepStack (button) (small blind) collected ($3000)
Seat 2: Nate_@NateMeyvis (big blind) folded before the Flop

PokerStars Hand #1001600083: Tournament #17, Mar29_2017-at-16_15_32 Hold'em No Limit ($750/$1500 USD) - 2017/03/29 18:16:54 ET
Table 'ACPC Match' 2-max Seat #2 is the button
Seat 1: DeepStack ($31100 in chips)
Seat 2: Nate_@NateMeyvis ($8900 in chips)
Nate_@NateMeyvis: posts small blind $750
DeepStack: posts big blind $1500
*** HOLE CARDS ***
Dealt to DeepStack [6h 8c]
Dealt to Nate_@NateMeyvis [Kc Ts]
Nate_@NateMeyvis: raises $7400 to $8900 and is all-in
DeepStack: folds
Uncalled bet ($7400) returned to Nate_@NateMeyvis
Nate_@NateMeyvis collected $3000 from the pot
*** SUMMARY ***
Total pot $3000 | Rake $0
Seat 1: DeepStack (big blind) folded before the Flop
Seat 2: Nate_@NateMeyvis (button) (small blind) collected ($3000)

PokerStars Hand #1001600084: Tournament #17, Mar29_2017-at-16_15_32 Hold'em No Limit ($750/$1500 USD) - 2017/03/29 18:16:55 ET
Table 'ACPC Match' 2-max Seat #1 is the button
Seat 1: DeepStack ($29600 in chips)
Seat 2: Nate_@NateMeyvis ($10400 in chips)
DeepStack: posts small blind $750
Nate_@NateMeyvis: posts big blind $1500
*** HOLE CARDS ***
Dealt to DeepStack [Js 6s]
Dealt to Nate_@NateMeyvis [Tc Qh]
DeepStack: raises $1500 to $3000
Nate_@NateMeyvis: raises $7400 to $10400 and is all-in
DeepStack: calls $7400
*** FLOP **** [4h 6c Jc]
*** TURN **** [Jh]
*** RIVER **** [Ks]
*** SHOW DOWN ***
Nate_@NateMeyvis: shows [Tc Qh] (a pair of Jacks)
DeepStack: shows [Js 6s] (full house, Jacks and Sixes)
DeepStack collected $20800 from pot
*** SUMMARY ***
Total pot $20800 | Rake $0
Board [4h 6c Jc Jh Ks]
Seat 1: DeepStack (button) (small blind) showed [Js 6s] and won ($20800) with full house, Jacks and Sixes
Seat 2: Nate_@NateMeyvis (big blind) showed [Tc Qh] and lost with a pair of Jacks
