PokerStars Hand #1001700001: Tournament #18, Mar29_2017-at-17_4_17 Hold'em No Limit ($50/$100 USD) - 2017/03/29 19:04:17 ET
Table 'ACPC Match' 2-max Seat #2 is the button
Seat 1: DeepStack ($20000 in chips)
Seat 2: Andrew_@ThinkingPoker ($20000 in chips)
Andrew_@ThinkingPoker: posts small blind $50
DeepStack: posts big blind $100
*** HOLE CARDS ***
Dealt to DeepStack [3d 2h]
Dealt to Andrew_@ThinkingPoker [8c Ac]
Andrew_@ThinkingPoker: raises $200 to $300
DeepStack: folds
Uncalled bet ($200) returned to Andrew_@ThinkingPoker
Andrew_@ThinkingPoker collected $200 from the pot
*** SUMMARY ***
Total pot $200 | Rake $0
Seat 1: DeepStack (big blind) folded before the Flop
Seat 2: Andrew_@ThinkingPoker (button) (small blind) collected ($200)

PokerStars Hand #1001700002: Tournament #18, Mar29_2017-at-17_4_17 Hold'em No Limit ($50/$100 USD) - 2017/03/29 19:04:18 ET
Table 'ACPC Match' 2-max Seat #1 is the button
Seat 1: DeepStack ($19900 in chips)
Seat 2: Andrew_@ThinkingPoker ($20100 in chips)
DeepStack: posts small blind $50
Andrew_@ThinkingPoker: posts big blind $100
*** HOLE CARDS ***
Dealt to DeepStack [2s 4h]
Dealt to Andrew_@ThinkingPoker [3s Jc]
DeepStack: folds
Uncalled bet ($50) returned to Andrew_@ThinkingPoker
Andrew_@ThinkingPoker collected $100 from the pot
*** SUMMARY ***
Total pot $100 | Rake $0
Seat 1: DeepStack (button) (small blind) folded before the Flop
Seat 2: Andrew_@ThinkingPoker (big blind) collected ($100)

PokerStars Hand #1001700003: Tournament #18, Mar29_2017-at-17_4_17 Hold'em No Limit ($50/$100 USD) - 2017/03/29 19:04:19 ET
Table 'ACPC Match' 2-max Seat #2 is the button
Seat 1: DeepStack ($19850 in chips)
Seat 2: Andrew_@ThinkingPoker ($20150 in chips)
Andrew_@ThinkingPoker: posts small blind $50
DeepStack: posts big blind $100
*** HOLE CARDS ***
Dealt to DeepStack [8h As]
Dealt to Andrew_@ThinkingPoker [Kh 7h]
Andrew_@ThinkingPoker: raises $200 to $300
DeepStack: calls $200
*** FLOP **** [Kc Jc Ks]
DeepStack: checks
Andrew_@ThinkingPoker: raises $300 to $300
DeepStack: calls $300
*** TURN **** [Ts]
DeepStack: checks
Andrew_@ThinkingPoker: raises $800 to $800
DeepStack: folds
Uncalled bet ($800) returned to Andrew_@ThinkingPoker
Andrew_@ThinkingPoker collected $1200 from the pot
*** SUMMARY ***
Total pot $1200 | Rake $0
Board [Kc Jc Ks Ts]
Seat 1: DeepStack (big blind) folded on the Turn
Seat 2: Andrew_@ThinkingPoker (button) (small blind) collected ($1200)

PokerStars Hand #1001700004: Tournament #18, Mar29_2017-at-17_4_17 Hold'em No Limit ($50/$100 USD) - 2017/03/29 19:04:20 ET
Table 'ACPC Match' 2-max Seat #1 is the button
Seat 1: DeepStack ($19250 in chips)
Seat 2: Andrew_@ThinkingPoker ($20750 in chips)
DeepStack: posts small blind $50
Andrew_@ThinkingPoker: posts big blind $100
*** HOLE CARDS ***
Dealt to DeepStack [3h Kc]
Dealt to Andrew_@ThinkingPoker [Td Jd]
DeepStack: calls $50
Andrew_@ThinkingPoker: raises $300 to $400
DeepStack: folds
Uncalled bet ($300) returned to Andrew_@ThinkingPoker
Andrew_@ThinkingPoker collected $200 from the pot
*** SUMMARY ***
Total pot $200 | Rake $0
Seat 1: DeepStack (button) (small blind) folded before the Flop
Seat 2: Andrew_@ThinkingPoker (big blind) collected ($200)

PokerStars Hand #1001700005: Tournament #18, Mar29_2017-at-17_4_17 Hold'em No Limit ($50/$100 USD) - 2017/03/29 19:04:21 ET
Table 'ACPC Match' 2-max Seat #2 is the button
Seat 1: DeepStack ($19150 in chips)
Seat 2: Andrew_@ThinkingPoker ($20850 in chips)
Andrew_@ThinkingPoker: posts small blind $50
DeepStack: posts big blind $100
*** HOLE CARDS ***
Dealt to DeepStack [Kh Jd]
Dealt to Andrew_@ThinkingPoker [3h 6h]
Andrew_@ThinkingPoker: raises $200 to $300
DeepStack: calls $200
*** FLOP **** [Ks 7d Js]
DeepStack: checks
Andrew_@ThinkingPoker: checks
*** TURN **** [3s]
DeepStack: bets $600
Andrew_@ThinkingPoker: folds
Uncalled bet ($600) returned to DeepStack
DeepStack collected $600 from the pot
*** SUMMARY ***
Total pot $600 | Rake $0
Board [Ks 7d Js 3s]
Seat 1: DeepStack (big blind) collected ($600)
Seat 2: Andrew_@ThinkingPoker (button) (small blind) folded on the Turn

PokerStars Hand #1001700006: Tournament #18, Mar29_2017-at-17_4_17 Hold'em No Limit ($50/$100 USD) - 2017/03/29 19:04:22 ET
Table 'ACPC Match' 2-max Seat #1 is the button
Seat 1: DeepStack ($19450 in chips)
Seat 2: Andrew_@ThinkingPoker ($20550 in chips)
DeepStack: posts small blind $50
Andrew_@ThinkingPoker: posts big blind $100
*** HOLE CARDS ***
Dealt to DeepStack [9h 9c]
Dealt to Andrew_@ThinkingPoker [9d 6h]
DeepStack: raises $100 to $200
Andrew_@ThinkingPoker: calls $100
*** FLOP **** [Ts Ks 6d]
Andrew_@ThinkingPoker: checks
DeepStack: checks
*** TURN **** [3c]
Andrew_@ThinkingPoker: checks
DeepStack: checks
*** RIVER **** [Qh]
Andrew_@ThinkingPoker: checks
DeepStack: checks
*** SHOW DOWN ***
Andrew_@ThinkingPoker: shows [9d 6h] (a pair of Sixes)
DeepStack: shows [9h 9c] (a pair of Nines)
DeepStack collected $400 from pot
*** SUMMARY ***
Total pot $400 | Rake $0
Board [Ts Ks 6d 3c Qh]
Seat 1: DeepStack (button) (small blind) showed [9h 9c] and won ($400) with a pair of Nines
Seat 2: Andrew_@ThinkingPoker (big blind) showed [9d 6h] and lost with a pair of Sixes

PokerStars Hand #1001700007: Tournament #18, Mar29_2017-at-17_4_17 Hold'em No Limit ($50/$100 USD) - 2017/03/29 19:04:23 ET
Table 'ACPC Match' 2-max Seat #2 is the button
Seat 1: DeepStack ($19650 in chips)
Seat 2: Andrew_@ThinkingPoker ($20350 in chips)
Andrew_@ThinkingPoker: posts small blind $50
DeepStack: posts big blind $100
*** HOLE CARDS ***
Dealt to DeepStack [8c 4h]
Dealt to Andrew_@ThinkingPoker [Qd 7d]
Andrew_@ThinkingPoker: raises $200 to $300
DeepStack: folds
Uncalled bet ($200) returned to Andrew_@ThinkingPoker
Andrew_@ThinkingPoker collected $200 from the pot
*** SUMMARY ***
Total pot $200 | Rake $0
Seat 1: DeepStack (big blind) folded before the Flop
Seat 2: Andrew_@ThinkingPoker (button) (small blind) collected ($200)

PokerStars Hand #1001700008: Tournament #18, Mar29_2017-at-17_4_17 Hold'em No Limit ($50/$100 USD) - 2017/03/29 19:04:24 ET
Table 'ACPC Match' 2-max Seat #1 is the button
Seat 1: DeepStack ($19550 in chips)
Seat 2: Andrew_@ThinkingPoker ($20450 in chips)
DeepStack: posts small blind $50
Andrew_@ThinkingPoker: posts big blind $100
*** HOLE CARDS ***
Dealt to DeepStack [3c 7s]
Dealt to Andrew_@ThinkingPoker [6d Ad]
DeepStack: folds
Uncalled bet ($50) returned to Andrew_@ThinkingPoker
Andrew_@ThinkingPoker collected $100 from the pot
*** SUMMARY ***
Total pot $100 | Rake $0
Seat 1: DeepStack (button) (small blind) folded before the Flop
Seat 2: Andrew_@ThinkingPoker (big blind) collected ($100)

PokerStars Hand #1001700009: Tournament #18, Mar29_2017-at-17_4_17 Hold'em No Limit ($50/$100 USD) - 2017/03/29 19:04:25 ET
Table 'ACPC Match' 2-max Seat #2 is the button
Seat 1: DeepStack ($19500 in chips)
Seat 2: Andrew_@ThinkingPoker ($20500 in chips)
Andrew_@ThinkingPoker: posts small blind $50
DeepStack: posts big blind $100
*** HOLE CARDS ***
Dealt to DeepStack [Ac 3s]
Dealt to Andrew_@ThinkingPoker [Th 4s]
Andrew_@ThinkingPoker: folds
Uncalled bet ($50) returned to DeepStack
DeepStack collected $100 from the pot
*** SUMMARY ***
Total pot $100 | Rake $0
Seat 1: DeepStack (big blind) collected ($100)
Seat 2: Andrew_@ThinkingPoker (button) (small blind) folded before the Flop

PokerStars Hand #1001700010: Tournament #18, Mar29_2017-at-17_4_17 Hold'em No Limit ($50/$100 USD) - 2017/03/29 19:04:26 ET
Table 'ACPC Match' 2-max Seat #1 is the button
Seat 1: DeepStack ($19550 in chips)
Seat 2: Andrew_@ThinkingPoker ($20450 in chips)
DeepStack: posts small blind $50
Andrew_@ThinkingPoker: posts big blind $100
*** HOLE CARDS ***
Dealt to DeepStack [Td 6c]
Dealt to Andrew_@ThinkingPoker [Qs Qd]
DeepStack: raises $100 to $200
Andrew_@ThinkingPoker: raises $600 to $800
DeepStack: folds
Uncalled bet ($600) returned to Andrew_@ThinkingPoker
Andrew_@ThinkingPoker collected $400 from the pot
*** SUMMARY ***
Total pot $400 | Rake $0
Seat 1: DeepStack (button) (small blind) folded before the Flop
Seat 2: Andrew_@ThinkingPoker (big blind) collected ($400)

PokerStars Hand #1001700011: Tournament #18, Mar29_2017-at-17_4_17 Hold'em No Limit ($75/$150 USD) - 2017/03/29 19:04:27 ET
Table 'ACPC Match' 2-max Seat #2 is the button
Seat 1: DeepStack ($19350 in chips)
Seat 2: Andrew_@ThinkingPoker ($20650 in chips)
Andrew_@ThinkingPoker: posts small blind $75
DeepStack: posts big blind $150
*** HOLE CARDS ***
Dealt to DeepStack [5s 8s]
Dealt to Andrew_@ThinkingPoker [Qc 6d]
Andrew_@ThinkingPoker: raises $300 to $450
DeepStack: calls $300
*** FLOP **** [2c 4h 5c]
DeepStack: checks
Andrew_@ThinkingPoker: checks
*** TURN **** [Ad]
DeepStack: bets $450
Andrew_@ThinkingPoker: calls $450
*** RIVER **** [As]
DeepStack: checks
Andrew_@ThinkingPoker: checks
*** SHOW DOWN ***
DeepStack: shows [5s 8s] (two pair, Aces and Fives)
Andrew_@ThinkingPoker: shows [Qc 6d] (a pair of Aces)
DeepStack collected $1800 from pot
*** SUMMARY ***
Total pot $1800 | Rake $0
Board [2c 4h 5c Ad As]
Seat 1: DeepStack (big blind) showed [5s 8s] and won ($1800) with two pair, Aces and Fives
Seat 2: Andrew_@ThinkingPoker (button) (small blind) showed [Qc 6d] and lost with a pair of Aces

PokerStars Hand #1001700012: Tournament #18, Mar29_2017-at-17_4_17 Hold'em No Limit ($75/$150 USD) - 2017/03/29 19:04:28 ET
Table 'ACPC Match' 2-max Seat #1 is the button
Seat 1: DeepStack ($20250 in chips)
Seat 2: Andrew_@ThinkingPoker ($19750 in chips)
DeepStack: posts small blind $75
Andrew_@ThinkingPoker: posts big blind $150
*** HOLE CARDS ***
Dealt to DeepStack [Qc 8d]
Dealt to Andrew_@ThinkingPoker [6s Kh]
DeepStack: raises $300 to $450
Andrew_@ThinkingPoker: folds
Uncalled bet ($300) returned to DeepStack
DeepStack collected $300 from the pot
*** SUMMARY ***
Total pot $300 | Rake $0
Seat 1: DeepStack (button) (small blind) collected ($300)
Seat 2: Andrew_@ThinkingPoker (big blind) folded before the Flop

PokerStars Hand #1001700013: Tournament #18, Mar29_2017-at-17_4_17 Hold'em No Limit ($75/$150 USD) - 2017/03/29 19:04:29 ET
Table 'ACPC Match' 2-max Seat #2 is the button
Seat 1: DeepStack ($20400 in chips)
Seat 2: Andrew_@ThinkingPoker ($19600 in chips)
Andrew_@ThinkingPoker: posts small blind $75
DeepStack: posts big blind $150
*** HOLE CARDS ***
Dealt to DeepStack [3h 7d]
Dealt to Andrew_@ThinkingPoker [Qs Kh]
Andrew_@ThinkingPoker: raises $300 to $450
DeepStack: folds
Uncalled bet ($300) returned to Andrew_@ThinkingPoker
Andrew_@ThinkingPoker collected $300 from the pot
*** SUMMARY ***
Total pot $300 | Rake $0
Seat 1: DeepStack (big blind) folded before the Flop
Seat 2: Andrew_@ThinkingPoker (button) (small blind) collected ($300)

PokerStars Hand #1001700014: Tournament #18, Mar29_2017-at-17_4_17 Hold'em No Limit ($75/$150 USD) - 2017/03/29 19:04:30 ET
Table 'ACPC Match' 2-max Seat #1 is the button
Seat 1: DeepStack ($20250 in chips)
Seat 2: Andrew_@ThinkingPoker ($19750 in chips)
DeepStack: posts small blind $75
Andrew_@ThinkingPoker: posts big blind $150
*** HOLE CARDS ***
Dealt to DeepStack [2s 9d]
Dealt to Andrew_@ThinkingPoker [9h 5h]
DeepStack: folds
Uncalled bet ($75) returned to Andrew_@ThinkingPoker
Andrew_@ThinkingPoker collected $150 from the pot
*** SUMMARY ***
Total pot $150 | Rake $0
Seat 1: DeepStack (button) (small blind) folded before the Flop
Seat 2: Andrew_@ThinkingPoker (big blind) collected ($150)

PokerStars Hand #1001700015: Tournament #18, Mar29_2017-at-17_4_17 Hold'em No Limit ($75/$150 USD) - 2017/03/29 19:04:31 ET
Table 'ACPC Match' 2-max Seat #2 is the button
Seat 1: DeepStack ($20175 in chips)
Seat 2: Andrew_@ThinkingPoker ($19825 in chips)
Andrew_@ThinkingPoker: posts small blind $75
DeepStack: posts big blind $150
*** HOLE CARDS ***
Dealt to DeepStack [3h Kc]
Dealt to Andrew_@ThinkingPoker [Ah Js]
Andrew_@ThinkingPoker: raises $300 to $450
DeepStack: folds
Uncalled bet ($300) returned to Andrew_@ThinkingPoker
Andrew_@ThinkingPoker collected $300 from the pot
*** SUMMARY ***
Total pot $300 | Rake $0
Seat 1: DeepStack (big blind) folded before the Flop
Seat 2: Andrew_@ThinkingPoker (button) (small blind) collected ($300)

PokerStars Hand #1001700016: Tournament #18, Mar29_2017-at-17_4_17 Hold'em No Limit ($75/$150 USD) - 2017/03/29 19:04:32 ET
Table 'ACPC Match' 2-max Seat #1 is the button
Seat 1: DeepStack ($20025 in chips)
Seat 2: Andrew_@ThinkingPoker ($19975 in chips)
DeepStack: posts small blind $75
Andrew_@ThinkingPoker: posts big blind $150
*** HOLE CARDS ***
Dealt to DeepStack [6s Ac]
Dealt to Andrew_@ThinkingPoker [Qh Kh]
DeepStack: raises $300 to $450
Andrew_@ThinkingPoker: raises $1200 to $1650
DeepStack: folds
Uncalled bet ($1200) returned to Andrew_@ThinkingPoker
Andrew_@ThinkingPoker collected $900 from the pot
*** SUMMARY ***
Total pot $900 | Rake $0
Seat 1: DeepStack (button) (small blind) folded before the Flop
Seat 2: Andrew_@ThinkingPoker (big blind) collected ($900)

PokerStars Hand #1001700017: Tournament #18, Mar29_2017-at-17_4_17 Hold'em No Limit ($75/$150 USD) - 2017/03/29 19:04:33 ET
Table 'ACPC Match' 2-max Seat #2 is the button
Seat 1: DeepStack ($19575 in chips)
Seat 2: Andrew_@ThinkingPoker ($20425 in chips)
Andrew_@ThinkingPoker: posts small blind $75
DeepStack: posts big blind $150
*** HOLE CARDS ***
Dealt to DeepStack [7d 4s]
Dealt to Andrew_@ThinkingPoker [6c Jc]
Andrew_@ThinkingPoker: raises $300 to $450
DeepStack: folds
Uncalled bet ($300) returned to Andrew_@ThinkingPoker
Andrew_@ThinkingPoker collected $300 from the pot
*** SUMMARY ***
Total pot $300 | Rake $0
Seat 1: DeepStack (big blind) folded before the Flop
Seat 2: Andrew_@ThinkingPoker (button) (small blind) collected ($300)

PokerStars Hand #1001700018: Tournament #18, Mar29_2017-at-17_4_17 Hold'em No Limit ($75/$150 USD) - 2017/03/29 19:04:34 ET
Table 'ACPC Match' 2-max Seat #1 is the button
Seat 1: DeepStack ($19425 in chips)
Seat 2: Andrew_@ThinkingPoker ($20575 in chips)
DeepStack: posts small blind $75
Andrew_@ThinkingPoker: posts big blind $150
*** HOLE CARDS ***
Dealt to DeepStack [7d Ac]
Dealt to Andrew_@ThinkingPoker [As Kd]
DeepStack: raises $300 to $450
Andrew_@ThinkingPoker: raises $1200 to $1650
DeepStack: folds
Uncalled bet ($1200) returned to Andrew_@ThinkingPoker
Andrew_@ThinkingPoker collected $900 from the pot
*** SUMMARY ***
Total pot $900 | Rake $0
Seat 1: DeepStack (button) (small blind) folded before the Flop
Seat 2: Andrew_@ThinkingPoker (big blind) collected ($900)

PokerStars Hand #1001700019: Tournament #18, Mar29_2017-at-17_4_17 Hold'em No Limit ($75/$150 USD) - 2017/03/29 19:04:35 ET
Table 'ACPC Match' 2-max Seat #2 is the button
Seat 1: DeepStack ($18975 in chips)
Seat 2: Andrew_@ThinkingPoker ($21025 in chips)
Andrew_@ThinkingPoker: posts small blind $75
DeepStack: posts big blind $150
*** HOLE CARDS ***
Dealt to DeepStack [2h 2s]
Dealt to Andrew_@ThinkingPoker [4d 8h]
Andrew_@ThinkingPoker: folds
Uncalled bet ($75) returned to DeepStack
DeepStack collected $150 from the pot
*** SUMMARY ***
Total pot $150 | Rake $0
Seat 1: DeepStack (big blind) collected ($150)
Seat 2: Andrew_@ThinkingPoker (button) (small blind) folded before the Flop

PokerStars Hand #1001700020: Tournament #18, Mar29_2017-at-17_4_17 Hold'em No Limit ($75/$150 USD) - 2017/03/29 19:04:36 ET
Table 'ACPC Match' 2-max Seat #1 is the button
Seat 1: DeepStack ($19050 in chips)
Seat 2: Andrew_@ThinkingPoker ($20950 in chips)
DeepStack: posts small blind $75
Andrew_@ThinkingPoker: posts big blind $150
*** HOLE CARDS ***
Dealt to DeepStack [6s 7s]
Dealt to Andrew_@ThinkingPoker [Qc Jd]
DeepStack: raises $300 to $450
Andrew_@ThinkingPoker: calls $300
*** FLOP **** [4d Qh Qs]
Andrew_@ThinkingPoker: checks
DeepStack: raises $450 to $450
Andrew_@ThinkingPoker: raises $750 to $1200
DeepStack: raises $1650 to $2850
Andrew_@ThinkingPoker: calls $1650
*** TURN **** [2c]
Andrew_@ThinkingPoker: checks
DeepStack: checks
*** RIVER **** [2s]
Andrew_@ThinkingPoker: bets $1850
DeepStack: folds
Uncalled bet ($1850) returned to Andrew_@ThinkingPoker
Andrew_@ThinkingPoker collected $6600 from the pot
*** SUMMARY ***
Total pot $6600 | Rake $0
Board [4d Qh Qs 2c 2s]
Seat 1: DeepStack (button) (small blind) folded on the River
Seat 2: Andrew_@ThinkingPoker (big blind) collected ($6600)

PokerStars Hand #1001700021: Tournament #18, Mar29_2017-at-17_4_17 Hold'em No Limit ($100/$200 USD) - 2017/03/29 19:04:37 ET
Table 'ACPC Match' 2-max Seat #2 is the button
Seat 1: DeepStack ($15750 in chips)
Seat 2: Andrew_@ThinkingPoker ($24250 in chips)
Andrew_@ThinkingPoker: posts small blind $100
DeepStack: posts big blind $200
*** HOLE CARDS ***
Dealt to DeepStack [Ad 6s]
Dealt to Andrew_@ThinkingPoker [Qh 4h]
Andrew_@ThinkingPoker: raises $400 to $600
DeepStack: calls $400
*** FLOP **** [3s Kd 6d]
DeepStack: checks
Andrew_@ThinkingPoker: checks
*** TURN **** [Ac]
DeepStack: checks
Andrew_@ThinkingPoker: checks
*** RIVER **** [Qs]
DeepStack: checks
Andrew_@ThinkingPoker: checks
*** SHOW DOWN ***
DeepStack: shows [Ad 6s] (two pair, Aces and Sixes)
Andrew_@ThinkingPoker: shows [Qh 4h] (a pair of Queens)
DeepStack collected $1200 from pot
*** SUMMARY ***
Total pot $1200 | Rake $0
Board [3s Kd 6d Ac Qs]
Seat 1: DeepStack (big blind) showed [Ad 6s] and won ($1200) with two pair, Aces and Sixes
Seat 2: Andrew_@ThinkingPoker (button) (small blind) showed [Qh 4h] and lost with a pair of Queens

PokerStars Hand #1001700022: Tournament #18, Mar29_2017-at-17_4_17 Hold'em No Limit ($100/$200 USD) - 2017/03/29 19:04:38 ET
Table 'ACPC Match' 2-max Seat #1 is the button
Seat 1: DeepStack ($16350 in chips)
Seat 2: Andrew_@ThinkingPoker ($23650 in chips)
DeepStack: posts small blind $100
Andrew_@ThinkingPoker: posts big blind $200
*** HOLE CARDS ***
Dealt to DeepStack [7h 5s]
Dealt to Andrew_@ThinkingPoker [8d Ad]
DeepStack: raises $400 to $600
Andrew_@ThinkingPoker: calls $400
*** FLOP **** [Qd 3c 4d]
Andrew_@ThinkingPoker: checks
DeepStack: checks
*** TURN **** [7s]
Andrew_@ThinkingPoker: checks
DeepStack: raises $600 to $600
Andrew_@ThinkingPoker: calls $600
*** RIVER **** [6d]
Andrew_@ThinkingPoker: checks
DeepStack: raises $4800 to $4800
Andrew_@ThinkingPoker: raises $17650 to $22450 and is all-in
DeepStack: folds
Uncalled bet ($17650) returned to Andrew_@ThinkingPoker
Andrew_@ThinkingPoker collected $12000 from the pot
*** SUMMARY ***
Total pot $12000 | Rake $0
Board [Qd 3c 4d 7s 6d]
Seat 1: DeepStack (button) (small blind) folded on the River
Seat 2: Andrew_@ThinkingPoker (big blind) collected ($12000)

PokerStars Hand #1001700023: Tournament #18, Mar29_2017-at-17_4_17 Hold'em No Limit ($100/$200 USD) - 2017/03/29 19:04:39 ET
Table 'ACPC Match' 2-max Seat #2 is the button
Seat 1: DeepStack ($10350 in chips)
Seat 2: Andrew_@ThinkingPoker ($29650 in chips)
Andrew_@ThinkingPoker: posts small blind $100
DeepStack: posts big blind $200
*** HOLE CARDS ***
Dealt to DeepStack [5s 8s]
Dealt to Andrew_@ThinkingPoker [9h Ac]
Andrew_@ThinkingPoker: raises $400 to $600
DeepStack: calls $400
*** FLOP **** [2c Jd Jc]
DeepStack: checks
Andrew_@ThinkingPoker: checks
*** TURN **** [As]
DeepStack: checks
Andrew_@ThinkingPoker: raises $400 to $400
DeepStack: folds
Uncalled bet ($400) returned to Andrew_@ThinkingPoker
Andrew_@ThinkingPoker collected $1200 from the pot
*** SUMMARY ***
Total pot $1200 | Rake $0
Board [2c Jd Jc As]
Seat 1: DeepStack (big blind) folded on the Turn
Seat 2: Andrew_@ThinkingPoker (button) (small blind) collected ($1200)

PokerStars Hand #1001700024: Tournament #18, Mar29_2017-at-17_4_17 Hold'em No Limit ($100/$200 USD) - 2017/03/29 19:04:40 ET
Table 'ACPC Match' 2-max Seat #1 is the button
Seat 1: DeepStack ($9750 in chips)
Seat 2: Andrew_@ThinkingPoker ($30250 in chips)
DeepStack: posts small blind $100
Andrew_@ThinkingPoker: posts big blind $200
*** HOLE CARDS ***
Dealt to DeepStack [5s 2d]
Dealt to Andrew_@ThinkingPoker [8s 8h]
DeepStack: folds
Uncalled bet ($100) returned to Andrew_@ThinkingPoker
Andrew_@ThinkingPoker collected $200 from the pot
*** SUMMARY ***
Total pot $200 | Rake $0
Seat 1: DeepStack (button) (small blind) folded before the Flop
Seat 2: Andrew_@ThinkingPoker (big blind) collected ($200)

PokerStars Hand #1001700025: Tournament #18, Mar29_2017-at-17_4_17 Hold'em No Limit ($100/$200 USD) - 2017/03/29 19:04:41 ET
Table 'ACPC Match' 2-max Seat #2 is the button
Seat 1: DeepStack ($9650 in chips)
Seat 2: Andrew_@ThinkingPoker ($30350 in chips)
Andrew_@ThinkingPoker: posts small blind $100
DeepStack: posts big blind $200
*** HOLE CARDS ***
Dealt to DeepStack [8h 5h]
Dealt to Andrew_@ThinkingPoker [8c Kh]
Andrew_@ThinkingPoker: raises $400 to $600
DeepStack: calls $400
*** FLOP **** [9h 4c 8s]
DeepStack: checks
Andrew_@ThinkingPoker: raises $800 to $800
DeepStack: calls $800
*** TURN **** [Qd]
DeepStack: checks
Andrew_@ThinkingPoker: checks
*** RIVER **** [7h]
DeepStack: checks
Andrew_@ThinkingPoker: checks
*** SHOW DOWN ***
DeepStack: shows [8h 5h] (a pair of Eights)
Andrew_@ThinkingPoker: shows [8c Kh] (a pair of Eights)
Andrew_@ThinkingPoker collected $2800 from pot
*** SUMMARY ***
Total pot $2800 | Rake $0
Board [9h 4c 8s Qd 7h]
Seat 1: DeepStack (big blind) showed [8h 5h] and lost with a pair of Eights
Seat 2: Andrew_@ThinkingPoker (button) (small blind) showed [8c Kh] and won ($2800) with a pair of Eights

PokerStars Hand #1001700026: Tournament #18, Mar29_2017-at-17_4_17 Hold'em No Limit ($100/$200 USD) - 2017/03/29 19:04:42 ET
Table 'ACPC Match' 2-max Seat #1 is the button
Seat 1: DeepStack ($8250 in chips)
Seat 2: Andrew_@ThinkingPoker ($31750 in chips)
DeepStack: posts small blind $100
Andrew_@ThinkingPoker: posts big blind $200
*** HOLE CARDS ***
Dealt to DeepStack [4h Td]
Dealt to Andrew_@ThinkingPoker [As Ad]
DeepStack: raises $200 to $400
Andrew_@ThinkingPoker: raises $1000 to $1400
DeepStack: folds
Uncalled bet ($1000) returned to Andrew_@ThinkingPoker
Andrew_@ThinkingPoker collected $800 from the pot
*** SUMMARY ***
Total pot $800 | Rake $0
Seat 1: DeepStack (button) (small blind) folded before the Flop
Seat 2: Andrew_@ThinkingPoker (big blind) collected ($800)

PokerStars Hand #1001700027: Tournament #18, Mar29_2017-at-17_4_17 Hold'em No Limit ($100/$200 USD) - 2017/03/29 19:04:43 ET
Table 'ACPC Match' 2-max Seat #2 is the button
Seat 1: DeepStack ($7850 in chips)
Seat 2: Andrew_@ThinkingPoker ($32150 in chips)
Andrew_@ThinkingPoker: posts small blind $100
DeepStack: posts big blind $200
*** HOLE CARDS ***
Dealt to DeepStack [4s 7c]
Dealt to Andrew_@ThinkingPoker [Ad 8s]
Andrew_@ThinkingPoker: raises $400 to $600
DeepStack: folds
Uncalled bet ($400) returned to Andrew_@ThinkingPoker
Andrew_@ThinkingPoker collected $400 from the pot
*** SUMMARY ***
Total pot $400 | Rake $0
Seat 1: DeepStack (big blind) folded before the Flop
Seat 2: Andrew_@ThinkingPoker (button) (small blind) collected ($400)

PokerStars Hand #1001700028: Tournament #18, Mar29_2017-at-17_4_17 Hold'em No Limit ($100/$200 USD) - 2017/03/29 19:04:44 ET
Table 'ACPC Match' 2-max Seat #1 is the button
Seat 1: DeepStack ($7650 in chips)
Seat 2: Andrew_@ThinkingPoker ($32350 in chips)
DeepStack: posts small blind $100
Andrew_@ThinkingPoker: posts big blind $200
*** HOLE CARDS ***
Dealt to DeepStack [2h Ad]
Dealt to Andrew_@ThinkingPoker [7h Ah]
DeepStack: calls $100
Andrew_@ThinkingPoker: raises $600 to $800
DeepStack: raises $6850 to $7650 and is all-in
Andrew_@ThinkingPoker: folds
Uncalled bet ($6850) returned to DeepStack
DeepStack collected $1600 from the pot
*** SUMMARY ***
Total pot $1600 | Rake $0
Seat 1: DeepStack (button) (small blind) collected ($1600)
Seat 2: Andrew_@ThinkingPoker (big blind) folded before the Flop

PokerStars Hand #1001700029: Tournament #18, Mar29_2017-at-17_4_17 Hold'em No Limit ($100/$200 USD) - 2017/03/29 19:04:45 ET
Table 'ACPC Match' 2-max Seat #2 is the button
Seat 1: DeepStack ($8450 in chips)
Seat 2: Andrew_@ThinkingPoker ($31550 in chips)
Andrew_@ThinkingPoker: posts small blind $100
DeepStack: posts big blind $200
*** HOLE CARDS ***
Dealt to DeepStack [9h Jc]
Dealt to Andrew_@ThinkingPoker [4c Jd]
Andrew_@ThinkingPoker: folds
Uncalled bet ($100) returned to DeepStack
DeepStack collected $200 from the pot
*** SUMMARY ***
Total pot $200 | Rake $0
Seat 1: DeepStack (big blind) collected ($200)
Seat 2: Andrew_@ThinkingPoker (button) (small blind) folded before the Flop

PokerStars Hand #1001700030: Tournament #18, Mar29_2017-at-17_4_17 Hold'em No Limit ($100/$200 USD) - 2017/03/29 19:04:46 ET
Table 'ACPC Match' 2-max Seat #1 is the button
Seat 1: DeepStack ($8550 in chips)
Seat 2: Andrew_@ThinkingPoker ($31450 in chips)
DeepStack: posts small blind $100
Andrew_@ThinkingPoker: posts big blind $200
*** HOLE CARDS ***
Dealt to DeepStack [Kd 7d]
Dealt to Andrew_@ThinkingPoker [5d 6c]
DeepStack: raises $200 to $400
Andrew_@ThinkingPoker: calls $200
*** FLOP **** [Qh 4s 2h]
Andrew_@ThinkingPoker: checks
DeepStack: checks
*** TURN **** [Ah]
Andrew_@ThinkingPoker: checks
DeepStack: checks
*** RIVER **** [Ts]
Andrew_@ThinkingPoker: bets $200
DeepStack: calls $200
*** SHOW DOWN ***
Andrew_@ThinkingPoker: shows [5d 6c] (Ace high)
DeepStack: shows [Kd 7d] (Ace high)
DeepStack collected $1200 from pot
*** SUMMARY ***
Total pot $1200 | Rake $0
Board [Qh 4s 2h Ah Ts]
Seat 1: DeepStack (button) (small blind) showed [Kd 7d] and won ($1200) with Ace high
Seat 2: Andrew_@ThinkingPoker (big blind) showed [5d 6c] and lost with Ace high

PokerStars Hand #1001700031: Tournament #18, Mar29_2017-at-17_4_17 Hold'em No Limit ($150/$300 USD) - 2017/03/29 19:04:47 ET
Table 'ACPC Match' 2-max Seat #2 is the button
Seat 1: DeepStack ($9150 in chips)
Seat 2: Andrew_@ThinkingPoker ($30850 in chips)
Andrew_@ThinkingPoker: posts small blind $150
DeepStack: posts big blind $300
*** HOLE CARDS ***
Dealt to DeepStack [7s 2c]
Dealt to Andrew_@ThinkingPoker [4d 2d]
Andrew_@ThinkingPoker: calls $150
DeepStack: checks
*** FLOP **** [Ah 7h 8s]
DeepStack: checks
Andrew_@ThinkingPoker: checks
*** TURN **** [6h]
DeepStack: checks
Andrew_@ThinkingPoker: checks
*** RIVER **** [Ad]
DeepStack: bets $300
Andrew_@ThinkingPoker: folds
Uncalled bet ($300) returned to DeepStack
DeepStack collected $600 from the pot
*** SUMMARY ***
Total pot $600 | Rake $0
Board [Ah 7h 8s 6h Ad]
Seat 1: DeepStack (big blind) collected ($600)
Seat 2: Andrew_@ThinkingPoker (button) (small blind) folded on the River

PokerStars Hand #1001700032: Tournament #18, Mar29_2017-at-17_4_17 Hold'em No Limit ($150/$300 USD) - 2017/03/29 19:04:48 ET
Table 'ACPC Match' 2-max Seat #1 is the button
Seat 1: DeepStack ($9450 in chips)
Seat 2: Andrew_@ThinkingPoker ($30550 in chips)
DeepStack: posts small blind $150
Andrew_@ThinkingPoker: posts big blind $300
*** HOLE CARDS ***
Dealt to DeepStack [Ad 3d]
Dealt to Andrew_@ThinkingPoker [9s Kc]
DeepStack: raises $300 to $600
Andrew_@ThinkingPoker: calls $300
*** FLOP **** [Qc Kd Kh]
Andrew_@ThinkingPoker: bets $600
DeepStack: calls $600
*** TURN **** [7h]
Andrew_@ThinkingPoker: bets $1200
DeepStack: folds
Uncalled bet ($1200) returned to Andrew_@ThinkingPoker
Andrew_@ThinkingPoker collected $2400 from the pot
*** SUMMARY ***
Total pot $2400 | Rake $0
Board [Qc Kd Kh 7h]
Seat 1: DeepStack (button) (small blind) folded on the Turn
Seat 2: Andrew_@ThinkingPoker (big blind) collected ($2400)

PokerStars Hand #1001700033: Tournament #18, Mar29_2017-at-17_4_17 Hold'em No Limit ($150/$300 USD) - 2017/03/29 19:04:49 ET
Table 'ACPC Match' 2-max Seat #2 is the button
Seat 1: DeepStack ($8250 in chips)
Seat 2: Andrew_@ThinkingPoker ($31750 in chips)
Andrew_@ThinkingPoker: posts small blind $150
DeepStack: posts big blind $300
*** HOLE CARDS ***
Dealt to DeepStack [Ad 6s]
Dealt to Andrew_@ThinkingPoker [Tc 5c]
Andrew_@ThinkingPoker: raises $300 to $600
DeepStack: calls $300
*** FLOP **** [Ah 2d 8s]
DeepStack: checks
Andrew_@ThinkingPoker: checks
*** TURN **** [8c]
DeepStack: bets $600
Andrew_@ThinkingPoker: folds
Uncalled bet ($600) returned to DeepStack
DeepStack collected $1200 from the pot
*** SUMMARY ***
Total pot $1200 | Rake $0
Board [Ah 2d 8s 8c]
Seat 1: DeepStack (big blind) collected ($1200)
Seat 2: Andrew_@ThinkingPoker (button) (small blind) folded on the Turn

PokerStars Hand #1001700034: Tournament #18, Mar29_2017-at-17_4_17 Hold'em No Limit ($150/$300 USD) - 2017/03/29 19:04:50 ET
Table 'ACPC Match' 2-max Seat #1 is the button
Seat 1: DeepStack ($8850 in chips)
Seat 2: Andrew_@ThinkingPoker ($31150 in chips)
DeepStack: posts small blind $150
Andrew_@ThinkingPoker: posts big blind $300
*** HOLE CARDS ***
Dealt to DeepStack [Kd Ac]
Dealt to Andrew_@ThinkingPoker [Tc Kc]
DeepStack: raises $600 to $900
Andrew_@ThinkingPoker: raises $30250 to $31150 and is all-in
DeepStack: calls $7950 and is all-in
Uncalled bet ($22300) returned to Andrew_@ThinkingPoker
*** FLOP **** [4s 6s Qs]
*** TURN **** [7s]
*** RIVER **** [6d]
*** SHOW DOWN ***
Andrew_@ThinkingPoker: shows [Tc Kc] (a pair of Sixes)
DeepStack: shows [Kd Ac] (a pair of Sixes)
DeepStack collected $17700 from pot
*** SUMMARY ***
Total pot $17700 | Rake $0
Board [4s 6s Qs 7s 6d]
Seat 1: DeepStack (button) (small blind) showed [Kd Ac] and won ($17700) with a pair of Sixes
Seat 2: Andrew_@ThinkingPoker (big blind) showed [Tc Kc] and lost with a pair of Sixes

PokerStars Hand #1001700035: Tournament #18, Mar29_2017-at-17_4_17 Hold'em No Limit ($150/$300 USD) - 2017/03/29 19:04:51 ET
Table 'ACPC Match' 2-max Seat #2 is the button
Seat 1: DeepStack ($17700 in chips)
Seat 2: Andrew_@ThinkingPoker ($22300 in chips)
Andrew_@ThinkingPoker: posts small blind $150
DeepStack: posts big blind $300
*** HOLE CARDS ***
Dealt to DeepStack [4s Ah]
Dealt to Andrew_@ThinkingPoker [3d 6d]
Andrew_@ThinkingPoker: raises $300 to $600
DeepStack: calls $300
*** FLOP **** [Qd Td 8d]
DeepStack: checks
Andrew_@ThinkingPoker: raises $600 to $600
DeepStack: folds
Uncalled bet ($600) returned to Andrew_@ThinkingPoker
Andrew_@ThinkingPoker collected $1200 from the pot
*** SUMMARY ***
Total pot $1200 | Rake $0
Board [Qd Td 8d]
Seat 1: DeepStack (big blind) folded on the Flop
Seat 2: Andrew_@ThinkingPoker (button) (small blind) collected ($1200)

PokerStars Hand #1001700036: Tournament #18, Mar29_2017-at-17_4_17 Hold'em No Limit ($150/$300 USD) - 2017/03/29 19:04:52 ET
Table 'ACPC Match' 2-max Seat #1 is the button
Seat 1: DeepStack ($17100 in chips)
Seat 2: Andrew_@ThinkingPoker ($22900 in chips)
DeepStack: posts small blind $150
Andrew_@ThinkingPoker: posts big blind $300
*** HOLE CARDS ***
Dealt to DeepStack [8s 9s]
Dealt to Andrew_@ThinkingPoker [8d 3h]
DeepStack: raises $300 to $600
Andrew_@ThinkingPoker: folds
Uncalled bet ($300) returned to DeepStack
DeepStack collected $600 from the pot
*** SUMMARY ***
Total pot $600 | Rake $0
Seat 1: DeepStack (button) (small blind) collected ($600)
Seat 2: Andrew_@ThinkingPoker (big blind) folded before the Flop

PokerStars Hand #1001700037: Tournament #18, Mar29_2017-at-17_4_17 Hold'em No Limit ($150/$300 USD) - 2017/03/29 19:04:53 ET
Table 'ACPC Match' 2-max Seat #2 is the button
Seat 1: DeepStack ($17400 in chips)
Seat 2: Andrew_@ThinkingPoker ($22600 in chips)
Andrew_@ThinkingPoker: posts small blind $150
DeepStack: posts big blind $300
*** HOLE CARDS ***
Dealt to DeepStack [Qh 4c]
Dealt to Andrew_@ThinkingPoker [2s 8c]
Andrew_@ThinkingPoker: folds
Uncalled bet ($150) returned to DeepStack
DeepStack collected $300 from the pot
*** SUMMARY ***
Total pot $300 | Rake $0
Seat 1: DeepStack (big blind) collected ($300)
Seat 2: Andrew_@ThinkingPoker (button) (small blind) folded before the Flop

PokerStars Hand #1001700038: Tournament #18, Mar29_2017-at-17_4_17 Hold'em No Limit ($150/$300 USD) - 2017/03/29 19:04:54 ET
Table 'ACPC Match' 2-max Seat #1 is the button
Seat 1: DeepStack ($17550 in chips)
Seat 2: Andrew_@ThinkingPoker ($22450 in chips)
DeepStack: posts small blind $150
Andrew_@ThinkingPoker: posts big blind $300
*** HOLE CARDS ***
Dealt to DeepStack [9c 8s]
Dealt to Andrew_@ThinkingPoker [6c Td]
DeepStack: raises $300 to $600
Andrew_@ThinkingPoker: folds
Uncalled bet ($300) returned to DeepStack
DeepStack collected $600 from the pot
*** SUMMARY ***
Total pot $600 | Rake $0
Seat 1: DeepStack (button) (small blind) collected ($600)
Seat 2: Andrew_@ThinkingPoker (big blind) folded before the Flop

PokerStars Hand #1001700039: Tournament #18, Mar29_2017-at-17_4_17 Hold'em No Limit ($150/$300 USD) - 2017/03/29 19:04:55 ET
Table 'ACPC Match' 2-max Seat #2 is the button
Seat 1: DeepStack ($17850 in chips)
Seat 2: Andrew_@ThinkingPoker ($22150 in chips)
Andrew_@ThinkingPoker: posts small blind $150
DeepStack: posts big blind $300
*** HOLE CARDS ***
Dealt to DeepStack [5h Ac]
Dealt to Andrew_@ThinkingPoker [2d 3h]
Andrew_@ThinkingPoker: folds
Uncalled bet ($150) returned to DeepStack
DeepStack collected $300 from the pot
*** SUMMARY ***
Total pot $300 | Rake $0
Seat 1: DeepStack (big blind) collected ($300)
Seat 2: Andrew_@ThinkingPoker (button) (small blind) folded before the Flop

PokerStars Hand #1001700040: Tournament #18, Mar29_2017-at-17_4_17 Hold'em No Limit ($150/$300 USD) - 2017/03/29 19:04:56 ET
Table 'ACPC Match' 2-max Seat #1 is the button
Seat 1: DeepStack ($18000 in chips)
Seat 2: Andrew_@ThinkingPoker ($22000 in chips)
DeepStack: posts small blind $150
Andrew_@ThinkingPoker: posts big blind $300
*** HOLE CARDS ***
Dealt to DeepStack [Qd Ac]
Dealt to Andrew_@ThinkingPoker [4c Qc]
DeepStack: raises $300 to $600
Andrew_@ThinkingPoker: calls $300
*** FLOP **** [Jc 9d 8s]
Andrew_@ThinkingPoker: bets $800
DeepStack: calls $800
*** TURN **** [4h]
Andrew_@ThinkingPoker: bets $3800
DeepStack: folds
Uncalled bet ($3800) returned to Andrew_@ThinkingPoker
Andrew_@ThinkingPoker collected $2800 from the pot
*** SUMMARY ***
Total pot $2800 | Rake $0
Board [Jc 9d 8s 4h]
Seat 1: DeepStack (button) (small blind) folded on the Turn
Seat 2: Andrew_@ThinkingPoker (big blind) collected ($2800)

PokerStars Hand #1001700041: Tournament #18, Mar29_2017-at-17_4_17 Hold'em No Limit ($200/$400 USD) - 2017/03/29 19:04:57 ET
Table 'ACPC Match' 2-max Seat #2 is the button
Seat 1: DeepStack ($16600 in chips)
Seat 2: Andrew_@ThinkingPoker ($23400 in chips)
Andrew_@ThinkingPoker: posts small blind $200
DeepStack: posts big blind $400
*** HOLE CARDS ***
Dealt to DeepStack [2d Qh]
Dealt to Andrew_@ThinkingPoker [Js 8c]
Andrew_@ThinkingPoker: raises $400 to $800
DeepStack: calls $400
*** FLOP **** [Jc 4c 7c]
DeepStack: checks
Andrew_@ThinkingPoker: checks
*** TURN **** [As]
DeepStack: checks
Andrew_@ThinkingPoker: checks
*** RIVER **** [2h]
DeepStack: checks
Andrew_@ThinkingPoker: raises $800 to $800
DeepStack: folds
Uncalled bet ($800) returned to Andrew_@ThinkingPoker
Andrew_@ThinkingPoker collected $1600 from the pot
*** SUMMARY ***
Total pot $1600 | Rake $0
Board [Jc 4c 7c As 2h]
Seat 1: DeepStack (big blind) folded on the River
Seat 2: Andrew_@ThinkingPoker (button) (small blind) collected ($1600)

PokerStars Hand #1001700042: Tournament #18, Mar29_2017-at-17_4_17 Hold'em No Limit ($200/$400 USD) - 2017/03/29 19:04:58 ET
Table 'ACPC Match' 2-max Seat #1 is the button
Seat 1: DeepStack ($15800 in chips)
Seat 2: Andrew_@ThinkingPoker ($24200 in chips)
DeepStack: posts small blind $200
Andrew_@ThinkingPoker: posts big blind $400
*** HOLE CARDS ***
Dealt to DeepStack [Kh 5s]
Dealt to Andrew_@ThinkingPoker [Qh 4s]
DeepStack: raises $400 to $800
Andrew_@ThinkingPoker: folds
Uncalled bet ($400) returned to DeepStack
DeepStack collected $800 from the pot
*** SUMMARY ***
Total pot $800 | Rake $0
Seat 1: DeepStack (button) (small blind) collected ($800)
Seat 2: Andrew_@ThinkingPoker (big blind) folded before the Flop

PokerStars Hand #1001700043: Tournament #18, Mar29_2017-at-17_4_17 Hold'em No Limit ($200/$400 USD) - 2017/03/29 19:04:59 ET
Table 'ACPC Match' 2-max Seat #2 is the button
Seat 1: DeepStack ($16200 in chips)
Seat 2: Andrew_@ThinkingPoker ($23800 in chips)
Andrew_@ThinkingPoker: posts small blind $200
DeepStack: posts big blind $400
*** HOLE CARDS ***
Dealt to DeepStack [3h 3s]
Dealt to Andrew_@ThinkingPoker [3c Ac]
Andrew_@ThinkingPoker: raises $600 to $1000
DeepStack: calls $600
*** FLOP **** [7d 9d 8s]
DeepStack: checks
Andrew_@ThinkingPoker: checks
*** TURN **** [2h]
DeepStack: checks
Andrew_@ThinkingPoker: checks
*** RIVER **** [8d]
DeepStack: checks
Andrew_@ThinkingPoker: checks
*** SHOW DOWN ***
DeepStack: shows [3h 3s] (two pair, Eights and Threes)
Andrew_@ThinkingPoker: shows [3c Ac] (a pair of Eights)
DeepStack collected $2000 from pot
*** SUMMARY ***
Total pot $2000 | Rake $0
Board [7d 9d 8s 2h 8d]
Seat 1: DeepStack (big blind) showed [3h 3s] and won ($2000) with two pair, Eights and Threes
Seat 2: Andrew_@ThinkingPoker (button) (small blind) showed [3c Ac] and lost with a pair of Eights

PokerStars Hand #1001700044: Tournament #18, Mar29_2017-at-17_4_17 Hold'em No Limit ($200/$400 USD) - 2017/03/29 19:05:00 ET
Table 'ACPC Match' 2-max Seat #1 is the button
Seat 1: DeepStack ($17200 in chips)
Seat 2: Andrew_@ThinkingPoker ($22800 in chips)
DeepStack: posts small blind $200
Andrew_@ThinkingPoker: posts big blind $400
*** HOLE CARDS ***
Dealt to DeepStack [9d Qd]
Dealt to Andrew_@ThinkingPoker [Jc Ks]
DeepStack: raises $400 to $800
Andrew_@ThinkingPoker: raises $1600 to $2400
DeepStack: calls $1600
*** FLOP **** [Kc 7c Ac]
Andrew_@ThinkingPoker: checks
DeepStack: checks
*** TURN **** [3d]
Andrew_@ThinkingPoker: checks
DeepStack: checks
*** RIVER **** [Ts]
Andrew_@ThinkingPoker: bets $1800
DeepStack: folds
Uncalled bet ($1800) returned to Andrew_@ThinkingPoker
Andrew_@ThinkingPoker collected $4800 from the pot
*** SUMMARY ***
Total pot $4800 | Rake $0
Board [Kc 7c Ac 3d Ts]
Seat 1: DeepStack (button) (small blind) folded on the River
Seat 2: Andrew_@ThinkingPoker (big blind) collected ($4800)

PokerStars Hand #1001700045: Tournament #18, Mar29_2017-at-17_4_17 Hold'em No Limit ($200/$400 USD) - 2017/03/29 19:05:01 ET
Table 'ACPC Match' 2-max Seat #2 is the button
Seat 1: DeepStack ($14800 in chips)
Seat 2: Andrew_@ThinkingPoker ($25200 in chips)
Andrew_@ThinkingPoker: posts small blind $200
DeepStack: posts big blind $400
*** HOLE CARDS ***
Dealt to DeepStack [3c 2c]
Dealt to Andrew_@ThinkingPoker [8d Ac]
Andrew_@ThinkingPoker: raises $600 to $1000
DeepStack: calls $600
*** FLOP **** [5c Td 7d]
DeepStack: checks
Andrew_@ThinkingPoker: checks
*** TURN **** [2s]
DeepStack: checks
Andrew_@ThinkingPoker: checks
*** RIVER **** [6c]
DeepStack: checks
Andrew_@ThinkingPoker: checks
*** SHOW DOWN ***
DeepStack: shows [3c 2c] (a pair of Deuces)
Andrew_@ThinkingPoker: shows [8d Ac] (Ace high)
DeepStack collected $2000 from pot
*** SUMMARY ***
Total pot $2000 | Rake $0
Board [5c Td 7d 2s 6c]
Seat 1: DeepStack (big blind) showed [3c 2c] and won ($2000) with a pair of Deuces
Seat 2: Andrew_@ThinkingPoker (button) (small blind) showed [8d Ac] and lost with Ace high

PokerStars Hand #1001700046: Tournament #18, Mar29_2017-at-17_4_17 Hold'em No Limit ($200/$400 USD) - 2017/03/29 19:05:02 ET
Table 'ACPC Match' 2-max Seat #1 is the button
Seat 1: DeepStack ($15800 in chips)
Seat 2: Andrew_@ThinkingPoker ($24200 in chips)
DeepStack: posts small blind $200
Andrew_@ThinkingPoker: posts big blind $400
*** HOLE CARDS ***
Dealt to DeepStack [5s 4s]
Dealt to Andrew_@ThinkingPoker [9c Td]
DeepStack: raises $400 to $800
Andrew_@ThinkingPoker: calls $400
*** FLOP **** [8h 7c 8s]
Andrew_@ThinkingPoker: checks
DeepStack: raises $1600 to $1600
Andrew_@ThinkingPoker: calls $1600
*** TURN **** [Ah]
Andrew_@ThinkingPoker: checks
DeepStack: checks
*** RIVER **** [Th]
Andrew_@ThinkingPoker: checks
DeepStack: checks
*** SHOW DOWN ***
Andrew_@ThinkingPoker: shows [9c Td] (two pair, Tens and Eights)
DeepStack: shows [5s 4s] (a pair of Eights)
Andrew_@ThinkingPoker collected $4800 from pot
*** SUMMARY ***
Total pot $4800 | Rake $0
Board [8h 7c 8s Ah Th]
Seat 1: DeepStack (button) (small blind) showed [5s 4s] and lost with a pair of Eights
Seat 2: Andrew_@ThinkingPoker (big blind) showed [9c Td] and won ($4800) with two pair, Tens and Eights

PokerStars Hand #1001700047: Tournament #18, Mar29_2017-at-17_4_17 Hold'em No Limit ($200/$400 USD) - 2017/03/29 19:05:03 ET
Table 'ACPC Match' 2-max Seat #2 is the button
Seat 1: DeepStack ($13400 in chips)
Seat 2: Andrew_@ThinkingPoker ($26600 in chips)
Andrew_@ThinkingPoker: posts small blind $200
DeepStack: posts big blind $400
*** HOLE CARDS ***
Dealt to DeepStack [7h 4h]
Dealt to Andrew_@ThinkingPoker [Ad 9h]
Andrew_@ThinkingPoker: raises $600 to $1000
DeepStack: calls $600
*** FLOP **** [Tc Qh 7s]
DeepStack: checks
Andrew_@ThinkingPoker: checks
*** TURN **** [5h]
DeepStack: checks
Andrew_@ThinkingPoker: checks
*** RIVER **** [Th]
DeepStack: bets $1000
Andrew_@ThinkingPoker: folds
Uncalled bet ($1000) returned to DeepStack
DeepStack collected $2000 from the pot
*** SUMMARY ***
Total pot $2000 | Rake $0
Board [Tc Qh 7s 5h Th]
Seat 1: DeepStack (big blind) collected ($2000)
Seat 2: Andrew_@ThinkingPoker (button) (small blind) folded on the River

PokerStars Hand #1001700048: Tournament #18, Mar29_2017-at-17_4_17 Hold'em No Limit ($200/$400 USD) - 2017/03/29 19:05:04 ET
Table 'ACPC Match' 2-max Seat #1 is the button
Seat 1: DeepStack ($14400 in chips)
Seat 2: Andrew_@ThinkingPoker ($25600 in chips)
DeepStack: posts small blind $200
Andrew_@ThinkingPoker: posts big blind $400
*** HOLE CARDS ***
Dealt to DeepStack [6c 5h]
Dealt to Andrew_@ThinkingPoker [4d Th]
DeepStack: raises $400 to $800
Andrew_@ThinkingPoker: folds
Uncalled bet ($400) returned to DeepStack
DeepStack collected $800 from the pot
*** SUMMARY ***
Total pot $800 | Rake $0
Seat 1: DeepStack (button) (small blind) collected ($800)
Seat 2: Andrew_@ThinkingPoker (big blind) folded before the Flop

PokerStars Hand #1001700049: Tournament #18, Mar29_2017-at-17_4_17 Hold'em No Limit ($200/$400 USD) - 2017/03/29 19:05:05 ET
Table 'ACPC Match' 2-max Seat #2 is the button
Seat 1: DeepStack ($14800 in chips)
Seat 2: Andrew_@ThinkingPoker ($25200 in chips)
Andrew_@ThinkingPoker: posts small blind $200
DeepStack: posts big blind $400
*** HOLE CARDS ***
Dealt to DeepStack [2c 8h]
Dealt to Andrew_@ThinkingPoker [5c Ks]
Andrew_@ThinkingPoker: raises $400 to $800
DeepStack: folds
Uncalled bet ($400) returned to Andrew_@ThinkingPoker
Andrew_@ThinkingPoker collected $800 from the pot
*** SUMMARY ***
Total pot $800 | Rake $0
Seat 1: DeepStack (big blind) folded before the Flop
Seat 2: Andrew_@ThinkingPoker (button) (small blind) collected ($800)

PokerStars Hand #1001700050: Tournament #18, Mar29_2017-at-17_4_17 Hold'em No Limit ($200/$400 USD) - 2017/03/29 19:05:06 ET
Table 'ACPC Match' 2-max Seat #1 is the button
Seat 1: DeepStack ($14400 in chips)
Seat 2: Andrew_@ThinkingPoker ($25600 in chips)
DeepStack: posts small blind $200
Andrew_@ThinkingPoker: posts big blind $400
*** HOLE CARDS ***
Dealt to DeepStack [8c 5h]
Dealt to Andrew_@ThinkingPoker [5s Ad]
DeepStack: raises $400 to $800
Andrew_@ThinkingPoker: calls $400
*** FLOP **** [6d Td 4s]
Andrew_@ThinkingPoker: checks
DeepStack: raises $1600 to $1600
Andrew_@ThinkingPoker: folds
Uncalled bet ($1600) returned to DeepStack
DeepStack collected $1600 from the pot
*** SUMMARY ***
Total pot $1600 | Rake $0
Board [6d Td 4s]
Seat 1: DeepStack (button) (small blind) collected ($1600)
Seat 2: Andrew_@ThinkingPoker (big blind) folded on the Flop

PokerStars Hand #1001700051: Tournament #18, Mar29_2017-at-17_4_17 Hold'em No Limit ($300/$600 USD) - 2017/03/29 19:05:07 ET
Table 'ACPC Match' 2-max Seat #2 is the button
Seat 1: DeepStack ($15200 in chips)
Seat 2: Andrew_@ThinkingPoker ($24800 in chips)
Andrew_@ThinkingPoker: posts small blind $300
DeepStack: posts big blind $600
*** HOLE CARDS ***
Dealt to DeepStack [2h 3h]
Dealt to Andrew_@ThinkingPoker [2c Jc]
Andrew_@ThinkingPoker: calls $300
DeepStack: checks
*** FLOP **** [Ts Qs 6h]
DeepStack: checks
Andrew_@ThinkingPoker: checks
*** TURN **** [2s]
DeepStack: checks
Andrew_@ThinkingPoker: raises $600 to $600
DeepStack: folds
Uncalled bet ($600) returned to Andrew_@ThinkingPoker
Andrew_@ThinkingPoker collected $1200 from the pot
*** SUMMARY ***
Total pot $1200 | Rake $0
Board [Ts Qs 6h 2s]
Seat 1: DeepStack (big blind) folded on the Turn
Seat 2: Andrew_@ThinkingPoker (button) (small blind) collected ($1200)

PokerStars Hand #1001700052: Tournament #18, Mar29_2017-at-17_4_17 Hold'em No Limit ($300/$600 USD) - 2017/03/29 19:05:08 ET
Table 'ACPC Match' 2-max Seat #1 is the button
Seat 1: DeepStack ($14600 in chips)
Seat 2: Andrew_@ThinkingPoker ($25400 in chips)
DeepStack: posts small blind $300
Andrew_@ThinkingPoker: posts big blind $600
*** HOLE CARDS ***
Dealt to DeepStack [3c 7s]
Dealt to Andrew_@ThinkingPoker [5d 6d]
DeepStack: calls $300
Andrew_@ThinkingPoker: checks
*** FLOP **** [Jh 8s 2h]
Andrew_@ThinkingPoker: checks
DeepStack: checks
*** TURN **** [9c]
Andrew_@ThinkingPoker: checks
DeepStack: checks
*** RIVER **** [4d]
Andrew_@ThinkingPoker: bets $600
DeepStack: folds
Uncalled bet ($600) returned to Andrew_@ThinkingPoker
Andrew_@ThinkingPoker collected $1200 from the pot
*** SUMMARY ***
Total pot $1200 | Rake $0
Board [Jh 8s 2h 9c 4d]
Seat 1: DeepStack (button) (small blind) folded on the River
Seat 2: Andrew_@ThinkingPoker (big blind) collected ($1200)

PokerStars Hand #1001700053: Tournament #18, Mar29_2017-at-17_4_17 Hold'em No Limit ($300/$600 USD) - 2017/03/29 19:05:09 ET
Table 'ACPC Match' 2-max Seat #2 is the button
Seat 1: DeepStack ($14000 in chips)
Seat 2: Andrew_@ThinkingPoker ($26000 in chips)
Andrew_@ThinkingPoker: posts small blind $300
DeepStack: posts big blind $600
*** HOLE CARDS ***
Dealt to DeepStack [Kc 8h]
Dealt to Andrew_@ThinkingPoker [6d As]
Andrew_@ThinkingPoker: raises $1200 to $1800
DeepStack: raises $1800 to $3600
Andrew_@ThinkingPoker: raises $11800 to $15400
DeepStack: folds
Uncalled bet ($11800) returned to Andrew_@ThinkingPoker
Andrew_@ThinkingPoker collected $7200 from the pot
*** SUMMARY ***
Total pot $7200 | Rake $0
Seat 1: DeepStack (big blind) folded before the Flop
Seat 2: Andrew_@ThinkingPoker (button) (small blind) collected ($7200)

PokerStars Hand #1001700054: Tournament #18, Mar29_2017-at-17_4_17 Hold'em No Limit ($300/$600 USD) - 2017/03/29 19:05:10 ET
Table 'ACPC Match' 2-max Seat #1 is the button
Seat 1: DeepStack ($10400 in chips)
Seat 2: Andrew_@ThinkingPoker ($29600 in chips)
DeepStack: posts small blind $300
Andrew_@ThinkingPoker: posts big blind $600
*** HOLE CARDS ***
Dealt to DeepStack [9h Qh]
Dealt to Andrew_@ThinkingPoker [Ah Jc]
DeepStack: calls $300
Andrew_@ThinkingPoker: raises $11400 to $12000
DeepStack: calls $9800 and is all-in
Uncalled bet ($1600) returned to Andrew_@ThinkingPoker
*** FLOP **** [5h 7c 9d]
*** TURN **** [Kh]
*** RIVER **** [Qd]
*** SHOW DOWN ***
Andrew_@ThinkingPoker: shows [Ah Jc] (Ace high)
DeepStack: shows [9h Qh] (two pair, Queens and Nines)
DeepStack collected $20800 from pot
*** SUMMARY ***
Total pot $20800 | Rake $0
Board [5h 7c 9d Kh Qd]
Seat 1: DeepStack (button) (small blind) showed [9h Qh] and won ($20800) with two pair, Queens and Nines
Seat 2: Andrew_@ThinkingPoker (big blind) showed [Ah Jc] and lost with Ace high

PokerStars Hand #1001700055: Tournament #18, Mar29_2017-at-17_4_17 Hold'em No Limit ($300/$600 USD) - 2017/03/29 19:05:11 ET
Table 'ACPC Match' 2-max Seat #2 is the button
Seat 1: DeepStack ($20800 in chips)
Seat 2: Andrew_@ThinkingPoker ($19200 in chips)
Andrew_@ThinkingPoker: posts small blind $300
DeepStack: posts big blind $600
*** HOLE CARDS ***
Dealt to DeepStack [Kh 3s]
Dealt to Andrew_@ThinkingPoker [Td 4h]
Andrew_@ThinkingPoker: folds
Uncalled bet ($300) returned to DeepStack
DeepStack collected $600 from the pot
*** SUMMARY ***
Total pot $600 | Rake $0
Seat 1: DeepStack (big blind) collected ($600)
Seat 2: Andrew_@ThinkingPoker (button) (small blind) folded before the Flop

PokerStars Hand #1001700056: Tournament #18, Mar29_2017-at-17_4_17 Hold'em No Limit ($300/$600 USD) - 2017/03/29 19:05:12 ET
Table 'ACPC Match' 2-max Seat #1 is the button
Seat 1: DeepStack ($21100 in chips)
Seat 2: Andrew_@ThinkingPoker ($18900 in chips)
DeepStack: posts small blind $300
Andrew_@ThinkingPoker: posts big blind $600
*** HOLE CARDS ***
Dealt to DeepStack [7d 9s]
Dealt to Andrew_@ThinkingPoker [Td 3h]
DeepStack: raises $600 to $1200
Andrew_@ThinkingPoker: folds
Uncalled bet ($600) returned to DeepStack
DeepStack collected $1200 from the pot
*** SUMMARY ***
Total pot $1200 | Rake $0
Seat 1: DeepStack (button) (small blind) collected ($1200)
Seat 2: Andrew_@ThinkingPoker (big blind) folded before the Flop

PokerStars Hand #1001700057: Tournament #18, Mar29_2017-at-17_4_17 Hold'em No Limit ($300/$600 USD) - 2017/03/29 19:05:13 ET
Table 'ACPC Match' 2-max Seat #2 is the button
Seat 1: DeepStack ($21700 in chips)
Seat 2: Andrew_@ThinkingPoker ($18300 in chips)
Andrew_@ThinkingPoker: posts small blind $300
DeepStack: posts big blind $600
*** HOLE CARDS ***
Dealt to DeepStack [7c As]
Dealt to Andrew_@ThinkingPoker [8d 3h]
Andrew_@ThinkingPoker: folds
Uncalled bet ($300) returned to DeepStack
DeepStack collected $600 from the pot
*** SUMMARY ***
Total pot $600 | Rake $0
Seat 1: DeepStack (big blind) collected ($600)
Seat 2: Andrew_@ThinkingPoker (button) (small blind) folded before the Flop

PokerStars Hand #1001700058: Tournament #18, Mar29_2017-at-17_4_17 Hold'em No Limit ($300/$600 USD) - 2017/03/29 19:05:14 ET
Table 'ACPC Match' 2-max Seat #1 is the button
Seat 1: DeepStack ($22000 in chips)
Seat 2: Andrew_@ThinkingPoker ($18000 in chips)
DeepStack: posts small blind $300
Andrew_@ThinkingPoker: posts big blind $600
*** HOLE CARDS ***
Dealt to DeepStack [8h Ac]
Dealt to Andrew_@ThinkingPoker [5d Kc]
DeepStack: calls $300
Andrew_@ThinkingPoker: checks
*** FLOP **** [Kd 9c 6d]
Andrew_@ThinkingPoker: checks
DeepStack: raises $600 to $600
Andrew_@ThinkingPoker: calls $600
*** TURN **** [7h]
Andrew_@ThinkingPoker: checks
DeepStack: raises $2400 to $2400
Andrew_@ThinkingPoker: calls $2400
*** RIVER **** [7d]
Andrew_@ThinkingPoker: checks
DeepStack: checks
*** SHOW DOWN ***
Andrew_@ThinkingPoker: shows [5d Kc] (two pair, Kings and Sevens)
DeepStack: shows [8h Ac] (a pair of Sevens)
Andrew_@ThinkingPoker collected $7200 from pot
*** SUMMARY ***
Total pot $7200 | Rake $0
Board [Kd 9c 6d 7h 7d]
Seat 1: DeepStack (button) (small blind) showed [8h Ac] and lost with a pair of Sevens
Seat 2: Andrew_@ThinkingPoker (big blind) showed [5d Kc] and won ($7200) with two pair, Kings and Sevens

PokerStars Hand #1001700059: Tournament #18, Mar29_2017-at-17_4_17 Hold'em No Limit ($300/$600 USD) - 2017/03/29 19:05:15 ET
Table 'ACPC Match' 2-max Seat #2 is the button
Seat 1: DeepStack ($18400 in chips)
Seat 2: Andrew_@ThinkingPoker ($21600 in chips)
Andrew_@ThinkingPoker: posts small blind $300
DeepStack: posts big blind $600
*** HOLE CARDS ***
Dealt to DeepStack [Ts Ks]
Dealt to Andrew_@ThinkingPoker [8d Qd]
Andrew_@ThinkingPoker: raises $900 to $1500
DeepStack: calls $900
*** FLOP **** [Jh Th 4h]
DeepStack: checks
Andrew_@ThinkingPoker: checks
*** TURN **** [2c]
DeepStack: checks
Andrew_@ThinkingPoker: raises $1800 to $1800
DeepStack: calls $1800
*** RIVER **** [As]
DeepStack: checks
Andrew_@ThinkingPoker: raises $4600 to $4600
DeepStack: calls $4600
*** SHOW DOWN ***
Andrew_@ThinkingPoker: shows [8d Qd] (Ace high)
DeepStack: shows [Ts Ks] (a pair of Tens)
DeepStack collected $15800 from pot
*** SUMMARY ***
Total pot $15800 | Rake $0
Board [Jh Th 4h 2c As]
Seat 1: DeepStack (big blind) showed [Ts Ks] and won ($15800) with a pair of Tens
Seat 2: Andrew_@ThinkingPoker (button) (small blind) showed [8d Qd] and lost with Ace high

PokerStars Hand #1001700060: Tournament #18, Mar29_2017-at-17_4_17 Hold'em No Limit ($300/$600 USD) - 2017/03/29 19:05:16 ET
Table 'ACPC Match' 2-max Seat #1 is the button
Seat 1: DeepStack ($26300 in chips)
Seat 2: Andrew_@ThinkingPoker ($13700 in chips)
DeepStack: posts small blind $300
Andrew_@ThinkingPoker: posts big blind $600
*** HOLE CARDS ***
Dealt to DeepStack [Kh 9h]
Dealt to Andrew_@ThinkingPoker [Ks 6s]
DeepStack: calls $300
Andrew_@ThinkingPoker: raises $13100 to $13700 and is all-in
DeepStack: calls $13100
*** FLOP **** [Th Tc 7s]
*** TURN **** [8d]
*** RIVER **** [7h]
*** SHOW DOWN ***
Andrew_@ThinkingPoker: shows [Ks 6s] (two pair, Tens and Sevens)
DeepStack: shows [Kh 9h] (two pair, Tens and Sevens)
Andrew_@ThinkingPoker collected $13700 from pot
DeepStack collected $13700 from pot
*** SUMMARY ***
Total pot $27400 | Rake $0
Board [Th Tc 7s 8d 7h]
Seat 1: DeepStack (button) (small blind) showed [Kh 9h] and won ($13700) with two pair, Tens and Sevens
Seat 2: Andrew_@ThinkingPoker (big blind) showed [Ks 6s] and won ($13700) with two pair, Tens and Sevens

PokerStars Hand #1001700061: Tournament #18, Mar29_2017-at-17_4_17 Hold'em No Limit ($400/$800 USD) - 2017/03/29 19:05:17 ET
Table 'ACPC Match' 2-max Seat #2 is the button
Seat 1: DeepStack ($26300 in chips)
Seat 2: Andrew_@ThinkingPoker ($13700 in chips)
Andrew_@ThinkingPoker: posts small blind $400
DeepStack: posts big blind $800
*** HOLE CARDS ***
Dealt to DeepStack [7h Kh]
Dealt to Andrew_@ThinkingPoker [2d Ts]
Andrew_@ThinkingPoker: folds
Uncalled bet ($400) returned to DeepStack
DeepStack collected $800 from the pot
*** SUMMARY ***
Total pot $800 | Rake $0
Seat 1: DeepStack (big blind) collected ($800)
Seat 2: Andrew_@ThinkingPoker (button) (small blind) folded before the Flop

PokerStars Hand #1001700062: Tournament #18, Mar29_2017-at-17_4_17 Hold'em No Limit ($400/$800 USD) - 2017/03/29 19:05:18 ET
Table 'ACPC Match' 2-max Seat #1 is the button
Seat 1: DeepStack ($26700 in chips)
Seat 2: Andrew_@ThinkingPoker ($13300 in chips)
DeepStack: posts small blind $400
Andrew_@ThinkingPoker: posts big blind $800
*** HOLE CARDS ***
Dealt to DeepStack [2c Kd]
Dealt to Andrew_@ThinkingPoker [3h 5h]
DeepStack: calls $400
Andrew_@ThinkingPoker: checks
*** FLOP **** [Ks 8h 4c]
Andrew_@ThinkingPoker: bets $800
DeepStack: calls $800
*** TURN **** [2d]
Andrew_@ThinkingPoker: checks
DeepStack: raises $1600 to $1600
Andrew_@ThinkingPoker: raises $10100 to $11700 and is all-in
DeepStack: calls $10100
*** RIVER **** [4s]
*** SHOW DOWN ***
Andrew_@ThinkingPoker: shows [3h 5h] (a pair of Fours)
DeepStack: shows [2c Kd] (two pair, Kings and Fours)
DeepStack collected $26600 from pot
*** SUMMARY ***
Total pot $26600 | Rake $0
Board [Ks 8h 4c 2d 4s]
Seat 1: DeepStack (button) (small blind) showed [2c Kd] and won ($26600) with two pair, Kings and Fours
Seat 2: Andrew_@ThinkingPoker (big blind) showed [3h 5h] and lost with a pair of Fours
