PokerStars Hand #1001800001: Tournament #19, Mar29_2017-at-18_1_11 Hold'em No Limit ($50/$100 USD) - 2017/03/29 20:01:11 ET
Table 'ACPC Match' 2-max Seat #2 is the button
Seat 1: DeepStack ($20000 in chips)
Seat 2: Andrew_@ThinkingPoker ($20000 in chips)
Andrew_@ThinkingPoker: posts small blind $50
DeepStack: posts big blind $100
*** HOLE CARDS ***
Dealt to DeepStack [6s 2h]
Dealt to Andrew_@ThinkingPoker [Qd Qh]
Andrew_@ThinkingPoker: raises $300 to $400
DeepStack: folds
Uncalled bet ($300) returned to Andrew_@ThinkingPoker
Andrew_@ThinkingPoker collected $200 from the pot
*** SUMMARY ***
Total pot $200 | Rake $0
Seat 1: DeepStack (big blind) folded before the Flop
Seat 2: Andrew_@ThinkingPoker (button) (small blind) collected ($200)

PokerStars Hand #1001800002: Tournament #19, Mar29_2017-at-18_1_11 Hold'em No Limit ($50/$100 USD) - 2017/03/29 20:01:12 ET
Table 'ACPC Match' 2-max Seat #1 is the button
Seat 1: DeepStack ($19900 in chips)
Seat 2: Andrew_@ThinkingPoker ($20100 in chips)
DeepStack: posts small blind $50
Andrew_@ThinkingPoker: posts big blind $100
*** HOLE CARDS ***
Dealt to DeepStack [Jh Kc]
Dealt to Andrew_@ThinkingPoker [Ah 4d]
DeepStack: calls $50
Andrew_@ThinkingPoker: checks
*** FLOP **** [2h Kd 6h]
Andrew_@ThinkingPoker: checks
DeepStack: raises $100 to $100
Andrew_@ThinkingPoker: raises $300 to $400
DeepStack: calls $300
*** TURN **** [9s]
Andrew_@ThinkingPoker: checks
DeepStack: checks
*** RIVER **** [5h]
Andrew_@ThinkingPoker: bets $2000
DeepStack: calls $2000
*** SHOW DOWN ***
Andrew_@ThinkingPoker: shows [Ah 4d] (Ace high)
DeepStack: shows [Jh Kc] (a pair of Kings)
DeepStack collected $5000 from pot
*** SUMMARY ***
Total pot $5000 | Rake $0
Board [2h Kd 6h 9s 5h]
Seat 1: DeepStack (button) (small blind) showed [Jh Kc] and won ($5000) with a pair of Kings
Seat 2: Andrew_@ThinkingPoker (big blind) showed [Ah 4d] and lost with Ace high

PokerStars Hand #1001800003: Tournament #19, Mar29_2017-at-18_1_11 Hold'em No Limit ($50/$100 USD) - 2017/03/29 20:01:13 ET
Table 'ACPC Match' 2-max Seat #2 is the button
Seat 1: DeepStack ($22400 in chips)
Seat 2: Andrew_@ThinkingPoker ($17600 in chips)
Andrew_@ThinkingPoker: posts small blind $50
DeepStack: posts big blind $100
*** HOLE CARDS ***
Dealt to DeepStack [8s Th]
Dealt to Andrew_@ThinkingPoker [8d 4h]
Andrew_@ThinkingPoker: folds
Uncalled bet ($50) returned to DeepStack
DeepStack collected $100 from the pot
*** SUMMARY ***
Total pot $100 | Rake $0
Seat 1: DeepStack (big blind) collected ($100)
Seat 2: Andrew_@ThinkingPoker (button) (small blind) folded before the Flop

PokerStars Hand #1001800004: Tournament #19, Mar29_2017-at-18_1_11 Hold'em No Limit ($50/$100 USD) - 2017/03/29 20:01:14 ET
Table 'ACPC Match' 2-max Seat #1 is the button
Seat 1: DeepStack ($22450 in chips)
Seat 2: Andrew_@ThinkingPoker ($17550 in chips)
DeepStack: posts small blind $50
Andrew_@ThinkingPoker: posts big blind $100
*** HOLE CARDS ***
Dealt to DeepStack [Kc 6c]
Dealt to Andrew_@ThinkingPoker [As Kd]
DeepStack: calls $50
Andrew_@ThinkingPoker: raises $300 to $400
DeepStack: calls $300
*** FLOP **** [8h 5s 6h]
Andrew_@ThinkingPoker: checks
DeepStack: checks
*** TURN **** [2s]
Andrew_@ThinkingPoker: checks
DeepStack: checks
*** RIVER **** [Td]
Andrew_@ThinkingPoker: checks
DeepStack: raises $400 to $400
Andrew_@ThinkingPoker: folds
Uncalled bet ($400) returned to DeepStack
DeepStack collected $800 from the pot
*** SUMMARY ***
Total pot $800 | Rake $0
Board [8h 5s 6h 2s Td]
Seat 1: DeepStack (button) (small blind) collected ($800)
Seat 2: Andrew_@ThinkingPoker (big blind) folded on the River

PokerStars Hand #1001800005: Tournament #19, Mar29_2017-at-18_1_11 Hold'em No Limit ($50/$100 USD) - 2017/03/29 20:01:15 ET
Table 'ACPC Match' 2-max Seat #2 is the button
Seat 1: DeepStack ($22850 in chips)
Seat 2: Andrew_@ThinkingPoker ($17150 in chips)
Andrew_@ThinkingPoker: posts small blind $50
DeepStack: posts big blind $100
*** HOLE CARDS ***
Dealt to DeepStack [Ad 4s]
Dealt to Andrew_@ThinkingPoker [Js Qs]
Andrew_@ThinkingPoker: raises $300 to $400
DeepStack: folds
Uncalled bet ($300) returned to Andrew_@ThinkingPoker
Andrew_@ThinkingPoker collected $200 from the pot
*** SUMMARY ***
Total pot $200 | Rake $0
Seat 1: DeepStack (big blind) folded before the Flop
Seat 2: Andrew_@ThinkingPoker (button) (small blind) collected ($200)

PokerStars Hand #1001800006: Tournament #19, Mar29_2017-at-18_1_11 Hold'em No Limit ($50/$100 USD) - 2017/03/29 20:01:16 ET
Table 'ACPC Match' 2-max Seat #1 is the button
Seat 1: DeepStack ($22750 in chips)
Seat 2: Andrew_@ThinkingPoker ($17250 in chips)
DeepStack: posts small blind $50
Andrew_@ThinkingPoker: posts big blind $100
*** HOLE CARDS ***
Dealt to DeepStack [2s 6h]
Dealt to Andrew_@ThinkingPoker [As Ts]
DeepStack: folds
Uncalled bet ($50) returned to Andrew_@ThinkingPoker
Andrew_@ThinkingPoker collected $100 from the pot
*** SUMMARY ***
Total pot $100 | Rake $0
Seat 1: DeepStack (button) (small blind) folded before the Flop
Seat 2: Andrew_@ThinkingPoker (big blind) collected ($100)

PokerStars Hand #1001800007: Tournament #19, Mar29_2017-at-18_1_11 Hold'em No Limit ($50/$100 USD) - 2017/03/29 20:01:17 ET
Table 'ACPC Match' 2-max Seat #2 is the button
Seat 1: DeepStack ($22700 in chips)
Seat 2: Andrew_@ThinkingPoker ($17300 in chips)
Andrew_@ThinkingPoker: posts small blind $50
DeepStack: posts big blind $100
*** HOLE CARDS ***
Dealt to DeepStack [8c 8h]
Dealt to Andrew_@ThinkingPoker [9h Jc]
Andrew_@ThinkingPoker: raises $300 to $400
DeepStack: raises $800 to $1200
Andrew_@ThinkingPoker: calls $800
*** FLOP **** [8d 7c 4s]
DeepStack: checks
Andrew_@ThinkingPoker: raises $1200 to $1200
DeepStack: calls $1200
*** TURN **** [3h]
DeepStack: checks
Andrew_@ThinkingPoker: checks
*** RIVER **** [3s]
DeepStack: checks
Andrew_@ThinkingPoker: checks
*** SHOW DOWN ***
DeepStack: shows [8c 8h] (full house, Eights and Threes)
Andrew_@ThinkingPoker: shows [9h Jc] (a pair of Threes)
DeepStack collected $4800 from pot
*** SUMMARY ***
Total pot $4800 | Rake $0
Board [8d 7c 4s 3h 3s]
Seat 1: DeepStack (big blind) showed [8c 8h] and won ($4800) with full house, Eights and Threes
Seat 2: Andrew_@ThinkingPoker (button) (small blind) showed [9h Jc] and lost with a pair of Threes

PokerStars Hand #1001800008: Tournament #19, Mar29_2017-at-18_1_11 Hold'em No Limit ($50/$100 USD) - 2017/03/29 20:01:18 ET
Table 'ACPC Match' 2-max Seat #1 is the button
Seat 1: DeepStack ($25100 in chips)
Seat 2: Andrew_@ThinkingPoker ($14900 in chips)
DeepStack: posts small blind $50
Andrew_@ThinkingPoker: posts big blind $100
*** HOLE CARDS ***
Dealt to DeepStack [9s 2d]
Dealt to Andrew_@ThinkingPoker [4h 5s]
DeepStack: folds
Uncalled bet ($50) returned to Andrew_@ThinkingPoker
Andrew_@ThinkingPoker collected $100 from the pot
*** SUMMARY ***
Total pot $100 | Rake $0
Seat 1: DeepStack (button) (small blind) folded before the Flop
Seat 2: Andrew_@ThinkingPoker (big blind) collected ($100)

PokerStars Hand #1001800009: Tournament #19, Mar29_2017-at-18_1_11 Hold'em No Limit ($50/$100 USD) - 2017/03/29 20:01:19 ET
Table 'ACPC Match' 2-max Seat #2 is the button
Seat 1: DeepStack ($25050 in chips)
Seat 2: Andrew_@ThinkingPoker ($14950 in chips)
Andrew_@ThinkingPoker: posts small blind $50
DeepStack: posts big blind $100
*** HOLE CARDS ***
Dealt to DeepStack [3c 9s]
Dealt to Andrew_@ThinkingPoker [Qs 9c]
Andrew_@ThinkingPoker: raises $300 to $400
DeepStack: folds
Uncalled bet ($300) returned to Andrew_@ThinkingPoker
Andrew_@ThinkingPoker collected $200 from the pot
*** SUMMARY ***
Total pot $200 | Rake $0
Seat 1: DeepStack (big blind) folded before the Flop
Seat 2: Andrew_@ThinkingPoker (button) (small blind) collected ($200)

PokerStars Hand #1001800010: Tournament #19, Mar29_2017-at-18_1_11 Hold'em No Limit ($50/$100 USD) - 2017/03/29 20:01:20 ET
Table 'ACPC Match' 2-max Seat #1 is the button
Seat 1: DeepStack ($24950 in chips)
Seat 2: Andrew_@ThinkingPoker ($15050 in chips)
DeepStack: posts small blind $50
Andrew_@ThinkingPoker: posts big blind $100
*** HOLE CARDS ***
Dealt to DeepStack [3s 9h]
Dealt to Andrew_@ThinkingPoker [6h Ah]
DeepStack: calls $50
Andrew_@ThinkingPoker: raises $300 to $400
DeepStack: folds
Uncalled bet ($300) returned to Andrew_@ThinkingPoker
Andrew_@ThinkingPoker collected $200 from the pot
*** SUMMARY ***
Total pot $200 | Rake $0
Seat 1: DeepStack (button) (small blind) folded before the Flop
Seat 2: Andrew_@ThinkingPoker (big blind) collected ($200)

PokerStars Hand #1001800011: Tournament #19, Mar29_2017-at-18_1_11 Hold'em No Limit ($75/$150 USD) - 2017/03/29 20:01:21 ET
Table 'ACPC Match' 2-max Seat #2 is the button
Seat 1: DeepStack ($24850 in chips)
Seat 2: Andrew_@ThinkingPoker ($15150 in chips)
Andrew_@ThinkingPoker: posts small blind $75
DeepStack: posts big blind $150
*** HOLE CARDS ***
Dealt to DeepStack [2c 4c]
Dealt to Andrew_@ThinkingPoker [3d 3s]
Andrew_@ThinkingPoker: raises $300 to $450
DeepStack: calls $300
*** FLOP **** [Kh 7s 8s]
DeepStack: checks
Andrew_@ThinkingPoker: checks
*** TURN **** [2s]
DeepStack: checks
Andrew_@ThinkingPoker: checks
*** RIVER **** [5h]
DeepStack: checks
Andrew_@ThinkingPoker: checks
*** SHOW DOWN ***
DeepStack: shows [2c 4c] (a pair of Deuces)
Andrew_@ThinkingPoker: shows [3d 3s] (a pair of Threes)
Andrew_@ThinkingPoker collected $900 from pot
*** SUMMARY ***
Total pot $900 | Rake $0
Board [Kh 7s 8s 2s 5h]
Seat 1: DeepStack (big blind) showed [2c 4c] and lost with a pair of Deuces
Seat 2: Andrew_@ThinkingPoker (button) (small blind) showed [3d 3s] and won ($900) with a pair of Threes

PokerStars Hand #1001800012: Tournament #19, Mar29_2017-at-18_1_11 Hold'em No Limit ($75/$150 USD) - 2017/03/29 20:01:22 ET
Table 'ACPC Match' 2-max Seat #1 is the button
Seat 1: DeepStack ($24400 in chips)
Seat 2: Andrew_@ThinkingPoker ($15600 in chips)
DeepStack: posts small blind $75
Andrew_@ThinkingPoker: posts big blind $150
*** HOLE CARDS ***
Dealt to DeepStack [Kh Jc]
Dealt to Andrew_@ThinkingPoker [9h 2s]
DeepStack: calls $75
Andrew_@ThinkingPoker: checks
*** FLOP **** [Qh Js 7c]
Andrew_@ThinkingPoker: checks
DeepStack: checks
*** TURN **** [8c]
Andrew_@ThinkingPoker: bets $300
DeepStack: calls $300
*** RIVER **** [7s]
Andrew_@ThinkingPoker: bets $900
DeepStack: calls $900
*** SHOW DOWN ***
Andrew_@ThinkingPoker: shows [9h 2s] (a pair of Sevens)
DeepStack: shows [Kh Jc] (two pair, Jacks and Sevens)
DeepStack collected $2700 from pot
*** SUMMARY ***
Total pot $2700 | Rake $0
Board [Qh Js 7c 8c 7s]
Seat 1: DeepStack (button) (small blind) showed [Kh Jc] and won ($2700) with two pair, Jacks and Sevens
Seat 2: Andrew_@ThinkingPoker (big blind) showed [9h 2s] and lost with a pair of Sevens

PokerStars Hand #1001800013: Tournament #19, Mar29_2017-at-18_1_11 Hold'em No Limit ($75/$150 USD) - 2017/03/29 20:01:23 ET
Table 'ACPC Match' 2-max Seat #2 is the button
Seat 1: DeepStack ($25750 in chips)
Seat 2: Andrew_@ThinkingPoker ($14250 in chips)
Andrew_@ThinkingPoker: posts small blind $75
DeepStack: posts big blind $150
*** HOLE CARDS ***
Dealt to DeepStack [7d 5s]
Dealt to Andrew_@ThinkingPoker [Th Ah]
Andrew_@ThinkingPoker: raises $300 to $450
DeepStack: folds
Uncalled bet ($300) returned to Andrew_@ThinkingPoker
Andrew_@ThinkingPoker collected $300 from the pot
*** SUMMARY ***
Total pot $300 | Rake $0
Seat 1: DeepStack (big blind) folded before the Flop
Seat 2: Andrew_@ThinkingPoker (button) (small blind) collected ($300)

PokerStars Hand #1001800014: Tournament #19, Mar29_2017-at-18_1_11 Hold'em No Limit ($75/$150 USD) - 2017/03/29 20:01:24 ET
Table 'ACPC Match' 2-max Seat #1 is the button
Seat 1: DeepStack ($25600 in chips)
Seat 2: Andrew_@ThinkingPoker ($14400 in chips)
DeepStack: posts small blind $75
Andrew_@ThinkingPoker: posts big blind $150
*** HOLE CARDS ***
Dealt to DeepStack [Ts 6d]
Dealt to Andrew_@ThinkingPoker [Td Jh]
DeepStack: raises $150 to $300
Andrew_@ThinkingPoker: calls $150
*** FLOP **** [Kh 5h 8s]
Andrew_@ThinkingPoker: checks
DeepStack: raises $300 to $300
Andrew_@ThinkingPoker: raises $900 to $1200
DeepStack: folds
Uncalled bet ($900) returned to Andrew_@ThinkingPoker
Andrew_@ThinkingPoker collected $1200 from the pot
*** SUMMARY ***
Total pot $1200 | Rake $0
Board [Kh 5h 8s]
Seat 1: DeepStack (button) (small blind) folded on the Flop
Seat 2: Andrew_@ThinkingPoker (big blind) collected ($1200)

PokerStars Hand #1001800015: Tournament #19, Mar29_2017-at-18_1_11 Hold'em No Limit ($75/$150 USD) - 2017/03/29 20:01:25 ET
Table 'ACPC Match' 2-max Seat #2 is the button
Seat 1: DeepStack ($25000 in chips)
Seat 2: Andrew_@ThinkingPoker ($15000 in chips)
Andrew_@ThinkingPoker: posts small blind $75
DeepStack: posts big blind $150
*** HOLE CARDS ***
Dealt to DeepStack [5s Ks]
Dealt to Andrew_@ThinkingPoker [4s Kd]
Andrew_@ThinkingPoker: folds
Uncalled bet ($75) returned to DeepStack
DeepStack collected $150 from the pot
*** SUMMARY ***
Total pot $150 | Rake $0
Seat 1: DeepStack (big blind) collected ($150)
Seat 2: Andrew_@ThinkingPoker (button) (small blind) folded before the Flop

PokerStars Hand #1001800016: Tournament #19, Mar29_2017-at-18_1_11 Hold'em No Limit ($75/$150 USD) - 2017/03/29 20:01:26 ET
Table 'ACPC Match' 2-max Seat #1 is the button
Seat 1: DeepStack ($25075 in chips)
Seat 2: Andrew_@ThinkingPoker ($14925 in chips)
DeepStack: posts small blind $75
Andrew_@ThinkingPoker: posts big blind $150
*** HOLE CARDS ***
Dealt to DeepStack [8h 3d]
Dealt to Andrew_@ThinkingPoker [Td 6h]
DeepStack: folds
Uncalled bet ($75) returned to Andrew_@ThinkingPoker
Andrew_@ThinkingPoker collected $150 from the pot
*** SUMMARY ***
Total pot $150 | Rake $0
Seat 1: DeepStack (button) (small blind) folded before the Flop
Seat 2: Andrew_@ThinkingPoker (big blind) collected ($150)

PokerStars Hand #1001800017: Tournament #19, Mar29_2017-at-18_1_11 Hold'em No Limit ($75/$150 USD) - 2017/03/29 20:01:27 ET
Table 'ACPC Match' 2-max Seat #2 is the button
Seat 1: DeepStack ($25000 in chips)
Seat 2: Andrew_@ThinkingPoker ($15000 in chips)
Andrew_@ThinkingPoker: posts small blind $75
DeepStack: posts big blind $150
*** HOLE CARDS ***
Dealt to DeepStack [8s 9h]
Dealt to Andrew_@ThinkingPoker [2s Kc]
Andrew_@ThinkingPoker: folds
Uncalled bet ($75) returned to DeepStack
DeepStack collected $150 from the pot
*** SUMMARY ***
Total pot $150 | Rake $0
Seat 1: DeepStack (big blind) collected ($150)
Seat 2: Andrew_@ThinkingPoker (button) (small blind) folded before the Flop

PokerStars Hand #1001800018: Tournament #19, Mar29_2017-at-18_1_11 Hold'em No Limit ($75/$150 USD) - 2017/03/29 20:01:28 ET
Table 'ACPC Match' 2-max Seat #1 is the button
Seat 1: DeepStack ($25075 in chips)
Seat 2: Andrew_@ThinkingPoker ($14925 in chips)
DeepStack: posts small blind $75
Andrew_@ThinkingPoker: posts big blind $150
*** HOLE CARDS ***
Dealt to DeepStack [6h Ts]
Dealt to Andrew_@ThinkingPoker [Kc Ad]
DeepStack: raises $150 to $300
Andrew_@ThinkingPoker: raises $900 to $1200
DeepStack: folds
Uncalled bet ($900) returned to Andrew_@ThinkingPoker
Andrew_@ThinkingPoker collected $600 from the pot
*** SUMMARY ***
Total pot $600 | Rake $0
Seat 1: DeepStack (button) (small blind) folded before the Flop
Seat 2: Andrew_@ThinkingPoker (big blind) collected ($600)

PokerStars Hand #1001800019: Tournament #19, Mar29_2017-at-18_1_11 Hold'em No Limit ($75/$150 USD) - 2017/03/29 20:01:29 ET
Table 'ACPC Match' 2-max Seat #2 is the button
Seat 1: DeepStack ($24775 in chips)
Seat 2: Andrew_@ThinkingPoker ($15225 in chips)
Andrew_@ThinkingPoker: posts small blind $75
DeepStack: posts big blind $150
*** HOLE CARDS ***
Dealt to DeepStack [5h 5c]
Dealt to Andrew_@ThinkingPoker [3c 7h]
Andrew_@ThinkingPoker: folds
Uncalled bet ($75) returned to DeepStack
DeepStack collected $150 from the pot
*** SUMMARY ***
Total pot $150 | Rake $0
Seat 1: DeepStack (big blind) collected ($150)
Seat 2: Andrew_@ThinkingPoker (button) (small blind) folded before the Flop

PokerStars Hand #1001800020: Tournament #19, Mar29_2017-at-18_1_11 Hold'em No Limit ($75/$150 USD) - 2017/03/29 20:01:30 ET
Table 'ACPC Match' 2-max Seat #1 is the button
Seat 1: DeepStack ($24850 in chips)
Seat 2: Andrew_@ThinkingPoker ($15150 in chips)
DeepStack: posts small blind $75
Andrew_@ThinkingPoker: posts big blind $150
*** HOLE CARDS ***
Dealt to DeepStack [7h 6c]
Dealt to Andrew_@ThinkingPoker [Ad Qs]
DeepStack: raises $150 to $300
Andrew_@ThinkingPoker: raises $900 to $1200
DeepStack: calls $900
*** FLOP **** [2c 4s Qh]
Andrew_@ThinkingPoker: bets $1600
DeepStack: folds
Uncalled bet ($1600) returned to Andrew_@ThinkingPoker
Andrew_@ThinkingPoker collected $2400 from the pot
*** SUMMARY ***
Total pot $2400 | Rake $0
Board [2c 4s Qh]
Seat 1: DeepStack (button) (small blind) folded on the Flop
Seat 2: Andrew_@ThinkingPoker (big blind) collected ($2400)

PokerStars Hand #1001800021: Tournament #19, Mar29_2017-at-18_1_11 Hold'em No Limit ($100/$200 USD) - 2017/03/29 20:01:31 ET
Table 'ACPC Match' 2-max Seat #2 is the button
Seat 1: DeepStack ($23650 in chips)
Seat 2: Andrew_@ThinkingPoker ($16350 in chips)
Andrew_@ThinkingPoker: posts small blind $100
DeepStack: posts big blind $200
*** HOLE CARDS ***
Dealt to DeepStack [Td 3h]
Dealt to Andrew_@ThinkingPoker [2h 6c]
Andrew_@ThinkingPoker: folds
Uncalled bet ($100) returned to DeepStack
DeepStack collected $200 from the pot
*** SUMMARY ***
Total pot $200 | Rake $0
Seat 1: DeepStack (big blind) collected ($200)
Seat 2: Andrew_@ThinkingPoker (button) (small blind) folded before the Flop

PokerStars Hand #1001800022: Tournament #19, Mar29_2017-at-18_1_11 Hold'em No Limit ($100/$200 USD) - 2017/03/29 20:01:32 ET
Table 'ACPC Match' 2-max Seat #1 is the button
Seat 1: DeepStack ($23750 in chips)
Seat 2: Andrew_@ThinkingPoker ($16250 in chips)
DeepStack: posts small blind $100
Andrew_@ThinkingPoker: posts big blind $200
*** HOLE CARDS ***
Dealt to DeepStack [5s 3s]
Dealt to Andrew_@ThinkingPoker [8h 4c]
DeepStack: raises $400 to $600
Andrew_@ThinkingPoker: folds
Uncalled bet ($400) returned to DeepStack
DeepStack collected $400 from the pot
*** SUMMARY ***
Total pot $400 | Rake $0
Seat 1: DeepStack (button) (small blind) collected ($400)
Seat 2: Andrew_@ThinkingPoker (big blind) folded before the Flop

PokerStars Hand #1001800023: Tournament #19, Mar29_2017-at-18_1_11 Hold'em No Limit ($100/$200 USD) - 2017/03/29 20:01:33 ET
Table 'ACPC Match' 2-max Seat #2 is the button
Seat 1: DeepStack ($23950 in chips)
Seat 2: Andrew_@ThinkingPoker ($16050 in chips)
Andrew_@ThinkingPoker: posts small blind $100
DeepStack: posts big blind $200
*** HOLE CARDS ***
Dealt to DeepStack [Kc 7h]
Dealt to Andrew_@ThinkingPoker [As Ts]
Andrew_@ThinkingPoker: raises $400 to $600
DeepStack: calls $400
*** FLOP **** [7s 6s 2h]
DeepStack: checks
Andrew_@ThinkingPoker: raises $800 to $800
DeepStack: calls $800
*** TURN **** [Ac]
DeepStack: checks
Andrew_@ThinkingPoker: raises $2000 to $2000
DeepStack: calls $2000
*** RIVER **** [Td]
DeepStack: checks
Andrew_@ThinkingPoker: raises $3800 to $3800
DeepStack: calls $3800
*** SHOW DOWN ***
Andrew_@ThinkingPoker: shows [As Ts] (two pair, Aces and Tens)
DeepStack: shows [Kc 7h] (a pair of Sevens)
Andrew_@ThinkingPoker collected $14400 from pot
*** SUMMARY ***
Total pot $14400 | Rake $0
Board [7s 6s 2h Ac Td]
Seat 1: DeepStack (big blind) showed [Kc 7h] and lost with a pair of Sevens
Seat 2: Andrew_@ThinkingPoker (button) (small blind) showed [As Ts] and won ($14400) with two pair, Aces and Tens

PokerStars Hand #1001800024: Tournament #19, Mar29_2017-at-18_1_11 Hold'em No Limit ($100/$200 USD) - 2017/03/29 20:01:34 ET
Table 'ACPC Match' 2-max Seat #1 is the button
Seat 1: DeepStack ($16750 in chips)
Seat 2: Andrew_@ThinkingPoker ($23250 in chips)
DeepStack: posts small blind $100
Andrew_@ThinkingPoker: posts big blind $200
*** HOLE CARDS ***
Dealt to DeepStack [8h 2h]
Dealt to Andrew_@ThinkingPoker [2s 7h]
DeepStack: calls $100
Andrew_@ThinkingPoker: checks
*** FLOP **** [Ah Js 3d]
Andrew_@ThinkingPoker: checks
DeepStack: raises $200 to $200
Andrew_@ThinkingPoker: folds
Uncalled bet ($200) returned to DeepStack
DeepStack collected $400 from the pot
*** SUMMARY ***
Total pot $400 | Rake $0
Board [Ah Js 3d]
Seat 1: DeepStack (button) (small blind) collected ($400)
Seat 2: Andrew_@ThinkingPoker (big blind) folded on the Flop

PokerStars Hand #1001800025: Tournament #19, Mar29_2017-at-18_1_11 Hold'em No Limit ($100/$200 USD) - 2017/03/29 20:01:35 ET
Table 'ACPC Match' 2-max Seat #2 is the button
Seat 1: DeepStack ($16950 in chips)
Seat 2: Andrew_@ThinkingPoker ($23050 in chips)
Andrew_@ThinkingPoker: posts small blind $100
DeepStack: posts big blind $200
*** HOLE CARDS ***
Dealt to DeepStack [Qs Ks]
Dealt to Andrew_@ThinkingPoker [6h Qc]
Andrew_@ThinkingPoker: raises $400 to $600
DeepStack: raises $1200 to $1800
Andrew_@ThinkingPoker: folds
Uncalled bet ($1200) returned to DeepStack
DeepStack collected $1200 from the pot
*** SUMMARY ***
Total pot $1200 | Rake $0
Seat 1: DeepStack (big blind) collected ($1200)
Seat 2: Andrew_@ThinkingPoker (button) (small blind) folded before the Flop

PokerStars Hand #1001800026: Tournament #19, Mar29_2017-at-18_1_11 Hold'em No Limit ($100/$200 USD) - 2017/03/29 20:01:36 ET
Table 'ACPC Match' 2-max Seat #1 is the button
Seat 1: DeepStack ($17550 in chips)
Seat 2: Andrew_@ThinkingPoker ($22450 in chips)
DeepStack: posts small blind $100
Andrew_@ThinkingPoker: posts big blind $200
*** HOLE CARDS ***
Dealt to DeepStack [2d 3s]
Dealt to Andrew_@ThinkingPoker [Ac Ad]
DeepStack: folds
Uncalled bet ($100) returned to Andrew_@ThinkingPoker
Andrew_@ThinkingPoker collected $200 from the pot
*** SUMMARY ***
Total pot $200 | Rake $0
Seat 1: DeepStack (button) (small blind) folded before the Flop
Seat 2: Andrew_@ThinkingPoker (big blind) collected ($200)

PokerStars Hand #1001800027: Tournament #19, Mar29_2017-at-18_1_11 Hold'em No Limit ($100/$200 USD) - 2017/03/29 20:01:37 ET
Table 'ACPC Match' 2-max Seat #2 is the button
Seat 1: DeepStack ($17450 in chips)
Seat 2: Andrew_@ThinkingPoker ($22550 in chips)
Andrew_@ThinkingPoker: posts small blind $100
DeepStack: posts big blind $200
*** HOLE CARDS ***
Dealt to DeepStack [6s 7d]
Dealt to Andrew_@ThinkingPoker [7c 2s]
Andrew_@ThinkingPoker: folds
Uncalled bet ($100) returned to DeepStack
DeepStack collected $200 from the pot
*** SUMMARY ***
Total pot $200 | Rake $0
Seat 1: DeepStack (big blind) collected ($200)
Seat 2: Andrew_@ThinkingPoker (button) (small blind) folded before the Flop

PokerStars Hand #1001800028: Tournament #19, Mar29_2017-at-18_1_11 Hold'em No Limit ($100/$200 USD) - 2017/03/29 20:01:38 ET
Table 'ACPC Match' 2-max Seat #1 is the button
Seat 1: DeepStack ($17550 in chips)
Seat 2: Andrew_@ThinkingPoker ($22450 in chips)
DeepStack: posts small blind $100
Andrew_@ThinkingPoker: posts big blind $200
*** HOLE CARDS ***
Dealt to DeepStack [Kd 3c]
Dealt to Andrew_@ThinkingPoker [Qc Qs]
DeepStack: raises $200 to $400
Andrew_@ThinkingPoker: raises $1200 to $1600
DeepStack: folds
Uncalled bet ($1200) returned to Andrew_@ThinkingPoker
Andrew_@ThinkingPoker collected $800 from the pot
*** SUMMARY ***
Total pot $800 | Rake $0
Seat 1: DeepStack (button) (small blind) folded before the Flop
Seat 2: Andrew_@ThinkingPoker (big blind) collected ($800)

PokerStars Hand #1001800029: Tournament #19, Mar29_2017-at-18_1_11 Hold'em No Limit ($100/$200 USD) - 2017/03/29 20:01:39 ET
Table 'ACPC Match' 2-max Seat #2 is the button
Seat 1: DeepStack ($17150 in chips)
Seat 2: Andrew_@ThinkingPoker ($22850 in chips)
Andrew_@ThinkingPoker: posts small blind $100
DeepStack: posts big blind $200
*** HOLE CARDS ***
Dealt to DeepStack [Kc Kh]
Dealt to Andrew_@ThinkingPoker [Js 3d]
Andrew_@ThinkingPoker: folds
Uncalled bet ($100) returned to DeepStack
DeepStack collected $200 from the pot
*** SUMMARY ***
Total pot $200 | Rake $0
Seat 1: DeepStack (big blind) collected ($200)
Seat 2: Andrew_@ThinkingPoker (button) (small blind) folded before the Flop

PokerStars Hand #1001800030: Tournament #19, Mar29_2017-at-18_1_11 Hold'em No Limit ($100/$200 USD) - 2017/03/29 20:01:40 ET
Table 'ACPC Match' 2-max Seat #1 is the button
Seat 1: DeepStack ($17250 in chips)
Seat 2: Andrew_@ThinkingPoker ($22750 in chips)
DeepStack: posts small blind $100
Andrew_@ThinkingPoker: posts big blind $200
*** HOLE CARDS ***
Dealt to DeepStack [2h 7s]
Dealt to Andrew_@ThinkingPoker [9d 6h]
DeepStack: folds
Uncalled bet ($100) returned to Andrew_@ThinkingPoker
Andrew_@ThinkingPoker collected $200 from the pot
*** SUMMARY ***
Total pot $200 | Rake $0
Seat 1: DeepStack (button) (small blind) folded before the Flop
Seat 2: Andrew_@ThinkingPoker (big blind) collected ($200)

PokerStars Hand #1001800031: Tournament #19, Mar29_2017-at-18_1_11 Hold'em No Limit ($150/$300 USD) - 2017/03/29 20:01:41 ET
Table 'ACPC Match' 2-max Seat #2 is the button
Seat 1: DeepStack ($17150 in chips)
Seat 2: Andrew_@ThinkingPoker ($22850 in chips)
Andrew_@ThinkingPoker: posts small blind $150
DeepStack: posts big blind $300
*** HOLE CARDS ***
Dealt to DeepStack [7d Th]
Dealt to Andrew_@ThinkingPoker [4h 4s]
Andrew_@ThinkingPoker: raises $600 to $900
DeepStack: calls $600
*** FLOP **** [4c 7s Ah]
DeepStack: checks
Andrew_@ThinkingPoker: raises $1200 to $1200
DeepStack: calls $1200
*** TURN **** [4d]
DeepStack: checks
Andrew_@ThinkingPoker: raises $3600 to $3600
DeepStack: folds
Uncalled bet ($3600) returned to Andrew_@ThinkingPoker
Andrew_@ThinkingPoker collected $4200 from the pot
*** SUMMARY ***
Total pot $4200 | Rake $0
Board [4c 7s Ah 4d]
Seat 1: DeepStack (big blind) folded on the Turn
Seat 2: Andrew_@ThinkingPoker (button) (small blind) collected ($4200)

PokerStars Hand #1001800032: Tournament #19, Mar29_2017-at-18_1_11 Hold'em No Limit ($150/$300 USD) - 2017/03/29 20:01:42 ET
Table 'ACPC Match' 2-max Seat #1 is the button
Seat 1: DeepStack ($15050 in chips)
Seat 2: Andrew_@ThinkingPoker ($24950 in chips)
DeepStack: posts small blind $150
Andrew_@ThinkingPoker: posts big blind $300
*** HOLE CARDS ***
Dealt to DeepStack [Qh 2d]
Dealt to Andrew_@ThinkingPoker [Qc Ks]
DeepStack: calls $150
Andrew_@ThinkingPoker: raises $900 to $1200
DeepStack: folds
Uncalled bet ($900) returned to Andrew_@ThinkingPoker
Andrew_@ThinkingPoker collected $600 from the pot
*** SUMMARY ***
Total pot $600 | Rake $0
Seat 1: DeepStack (button) (small blind) folded before the Flop
Seat 2: Andrew_@ThinkingPoker (big blind) collected ($600)

PokerStars Hand #1001800033: Tournament #19, Mar29_2017-at-18_1_11 Hold'em No Limit ($150/$300 USD) - 2017/03/29 20:01:43 ET
Table 'ACPC Match' 2-max Seat #2 is the button
Seat 1: DeepStack ($14750 in chips)
Seat 2: Andrew_@ThinkingPoker ($25250 in chips)
Andrew_@ThinkingPoker: posts small blind $150
DeepStack: posts big blind $300
*** HOLE CARDS ***
Dealt to DeepStack [9c 2h]
Dealt to Andrew_@ThinkingPoker [5d Th]
Andrew_@ThinkingPoker: folds
Uncalled bet ($150) returned to DeepStack
DeepStack collected $300 from the pot
*** SUMMARY ***
Total pot $300 | Rake $0
Seat 1: DeepStack (big blind) collected ($300)
Seat 2: Andrew_@ThinkingPoker (button) (small blind) folded before the Flop

PokerStars Hand #1001800034: Tournament #19, Mar29_2017-at-18_1_11 Hold'em No Limit ($150/$300 USD) - 2017/03/29 20:01:44 ET
Table 'ACPC Match' 2-max Seat #1 is the button
Seat 1: DeepStack ($14900 in chips)
Seat 2: Andrew_@ThinkingPoker ($25100 in chips)
DeepStack: posts small blind $150
Andrew_@ThinkingPoker: posts big blind $300
*** HOLE CARDS ***
Dealt to DeepStack [9s Kd]
Dealt to Andrew_@ThinkingPoker [8h Ah]
DeepStack: calls $150
Andrew_@ThinkingPoker: raises $900 to $1200
DeepStack: calls $900
*** FLOP **** [6d 4d Th]
Andrew_@ThinkingPoker: checks
DeepStack: checks
*** TURN **** [5h]
Andrew_@ThinkingPoker: checks
DeepStack: raises $1200 to $1200
Andrew_@ThinkingPoker: calls $1200
*** RIVER **** [8d]
Andrew_@ThinkingPoker: checks
DeepStack: raises $12500 to $12500 and is all-in
Andrew_@ThinkingPoker: folds
Uncalled bet ($12500) returned to DeepStack
DeepStack collected $4800 from the pot
*** SUMMARY ***
Total pot $4800 | Rake $0
Board [6d 4d Th 5h 8d]
Seat 1: DeepStack (button) (small blind) collected ($4800)
Seat 2: Andrew_@ThinkingPoker (big blind) folded on the River

PokerStars Hand #1001800035: Tournament #19, Mar29_2017-at-18_1_11 Hold'em No Limit ($150/$300 USD) - 2017/03/29 20:01:45 ET
Table 'ACPC Match' 2-max Seat #2 is the button
Seat 1: DeepStack ($17300 in chips)
Seat 2: Andrew_@ThinkingPoker ($22700 in chips)
Andrew_@ThinkingPoker: posts small blind $150
DeepStack: posts big blind $300
*** HOLE CARDS ***
Dealt to DeepStack [5c 3s]
Dealt to Andrew_@ThinkingPoker [8c 2s]
Andrew_@ThinkingPoker: folds
Uncalled bet ($150) returned to DeepStack
DeepStack collected $300 from the pot
*** SUMMARY ***
Total pot $300 | Rake $0
Seat 1: DeepStack (big blind) collected ($300)
Seat 2: Andrew_@ThinkingPoker (button) (small blind) folded before the Flop

PokerStars Hand #1001800036: Tournament #19, Mar29_2017-at-18_1_11 Hold'em No Limit ($150/$300 USD) - 2017/03/29 20:01:46 ET
Table 'ACPC Match' 2-max Seat #1 is the button
Seat 1: DeepStack ($17450 in chips)
Seat 2: Andrew_@ThinkingPoker ($22550 in chips)
DeepStack: posts small blind $150
Andrew_@ThinkingPoker: posts big blind $300
*** HOLE CARDS ***
Dealt to DeepStack [Qd 7h]
Dealt to Andrew_@ThinkingPoker [Jc 3c]
DeepStack: raises $600 to $900
Andrew_@ThinkingPoker: folds
Uncalled bet ($600) returned to DeepStack
DeepStack collected $600 from the pot
*** SUMMARY ***
Total pot $600 | Rake $0
Seat 1: DeepStack (button) (small blind) collected ($600)
Seat 2: Andrew_@ThinkingPoker (big blind) folded before the Flop

PokerStars Hand #1001800037: Tournament #19, Mar29_2017-at-18_1_11 Hold'em No Limit ($150/$300 USD) - 2017/03/29 20:01:47 ET
Table 'ACPC Match' 2-max Seat #2 is the button
Seat 1: DeepStack ($17750 in chips)
Seat 2: Andrew_@ThinkingPoker ($22250 in chips)
Andrew_@ThinkingPoker: posts small blind $150
DeepStack: posts big blind $300
*** HOLE CARDS ***
Dealt to DeepStack [5c Kd]
Dealt to Andrew_@ThinkingPoker [4d 3d]
Andrew_@ThinkingPoker: raises $600 to $900
DeepStack: calls $600
*** FLOP **** [Qh 7h 5h]
DeepStack: checks
Andrew_@ThinkingPoker: checks
*** TURN **** [2h]
DeepStack: checks
Andrew_@ThinkingPoker: checks
*** RIVER **** [9d]
DeepStack: checks
Andrew_@ThinkingPoker: raises $300 to $300
DeepStack: calls $300
*** SHOW DOWN ***
Andrew_@ThinkingPoker: shows [4d 3d] (Queen high)
DeepStack: shows [5c Kd] (a pair of Fives)
DeepStack collected $2400 from pot
*** SUMMARY ***
Total pot $2400 | Rake $0
Board [Qh 7h 5h 2h 9d]
Seat 1: DeepStack (big blind) showed [5c Kd] and won ($2400) with a pair of Fives
Seat 2: Andrew_@ThinkingPoker (button) (small blind) showed [4d 3d] and lost with Queen high

PokerStars Hand #1001800038: Tournament #19, Mar29_2017-at-18_1_11 Hold'em No Limit ($150/$300 USD) - 2017/03/29 20:01:48 ET
Table 'ACPC Match' 2-max Seat #1 is the button
Seat 1: DeepStack ($18950 in chips)
Seat 2: Andrew_@ThinkingPoker ($21050 in chips)
DeepStack: posts small blind $150
Andrew_@ThinkingPoker: posts big blind $300
*** HOLE CARDS ***
Dealt to DeepStack [Qh Js]
Dealt to Andrew_@ThinkingPoker [7c 2s]
DeepStack: raises $600 to $900
Andrew_@ThinkingPoker: folds
Uncalled bet ($600) returned to DeepStack
DeepStack collected $600 from the pot
*** SUMMARY ***
Total pot $600 | Rake $0
Seat 1: DeepStack (button) (small blind) collected ($600)
Seat 2: Andrew_@ThinkingPoker (big blind) folded before the Flop

PokerStars Hand #1001800039: Tournament #19, Mar29_2017-at-18_1_11 Hold'em No Limit ($150/$300 USD) - 2017/03/29 20:01:49 ET
Table 'ACPC Match' 2-max Seat #2 is the button
Seat 1: DeepStack ($19250 in chips)
Seat 2: Andrew_@ThinkingPoker ($20750 in chips)
Andrew_@ThinkingPoker: posts small blind $150
DeepStack: posts big blind $300
*** HOLE CARDS ***
Dealt to DeepStack [7c 2h]
Dealt to Andrew_@ThinkingPoker [7h Ks]
Andrew_@ThinkingPoker: raises $600 to $900
DeepStack: folds
Uncalled bet ($600) returned to Andrew_@ThinkingPoker
Andrew_@ThinkingPoker collected $600 from the pot
*** SUMMARY ***
Total pot $600 | Rake $0
Seat 1: DeepStack (big blind) folded before the Flop
Seat 2: Andrew_@ThinkingPoker (button) (small blind) collected ($600)

PokerStars Hand #1001800040: Tournament #19, Mar29_2017-at-18_1_11 Hold'em No Limit ($150/$300 USD) - 2017/03/29 20:01:50 ET
Table 'ACPC Match' 2-max Seat #1 is the button
Seat 1: DeepStack ($18950 in chips)
Seat 2: Andrew_@ThinkingPoker ($21050 in chips)
DeepStack: posts small blind $150
Andrew_@ThinkingPoker: posts big blind $300
*** HOLE CARDS ***
Dealt to DeepStack [Kd Jh]
Dealt to Andrew_@ThinkingPoker [Qc 2c]
DeepStack: raises $300 to $600
Andrew_@ThinkingPoker: calls $300
*** FLOP **** [Qh Tc As]
Andrew_@ThinkingPoker: checks
DeepStack: raises $1200 to $1200
Andrew_@ThinkingPoker: calls $1200
*** TURN **** [8d]
Andrew_@ThinkingPoker: checks
DeepStack: raises $1799 to $1799
Andrew_@ThinkingPoker: folds
Uncalled bet ($1799) returned to DeepStack
DeepStack collected $3600 from the pot
*** SUMMARY ***
Total pot $3600 | Rake $0
Board [Qh Tc As 8d]
Seat 1: DeepStack (button) (small blind) collected ($3600)
Seat 2: Andrew_@ThinkingPoker (big blind) folded on the Turn

PokerStars Hand #1001800041: Tournament #19, Mar29_2017-at-18_1_11 Hold'em No Limit ($200/$400 USD) - 2017/03/29 20:01:51 ET
Table 'ACPC Match' 2-max Seat #2 is the button
Seat 1: DeepStack ($20750 in chips)
Seat 2: Andrew_@ThinkingPoker ($19250 in chips)
Andrew_@ThinkingPoker: posts small blind $200
DeepStack: posts big blind $400
*** HOLE CARDS ***
Dealt to DeepStack [3c Qs]
Dealt to Andrew_@ThinkingPoker [2s Td]
Andrew_@ThinkingPoker: folds
Uncalled bet ($200) returned to DeepStack
DeepStack collected $400 from the pot
*** SUMMARY ***
Total pot $400 | Rake $0
Seat 1: DeepStack (big blind) collected ($400)
Seat 2: Andrew_@ThinkingPoker (button) (small blind) folded before the Flop

PokerStars Hand #1001800042: Tournament #19, Mar29_2017-at-18_1_11 Hold'em No Limit ($200/$400 USD) - 2017/03/29 20:01:52 ET
Table 'ACPC Match' 2-max Seat #1 is the button
Seat 1: DeepStack ($20950 in chips)
Seat 2: Andrew_@ThinkingPoker ($19050 in chips)
DeepStack: posts small blind $200
Andrew_@ThinkingPoker: posts big blind $400
*** HOLE CARDS ***
Dealt to DeepStack [5d Kh]
Dealt to Andrew_@ThinkingPoker [Js 7c]
DeepStack: raises $400 to $800
Andrew_@ThinkingPoker: calls $400
*** FLOP **** [8c 2c 4d]
Andrew_@ThinkingPoker: checks
DeepStack: raises $800 to $800
Andrew_@ThinkingPoker: folds
Uncalled bet ($800) returned to DeepStack
DeepStack collected $1600 from the pot
*** SUMMARY ***
Total pot $1600 | Rake $0
Board [8c 2c 4d]
Seat 1: DeepStack (button) (small blind) collected ($1600)
Seat 2: Andrew_@ThinkingPoker (big blind) folded on the Flop

PokerStars Hand #1001800043: Tournament #19, Mar29_2017-at-18_1_11 Hold'em No Limit ($200/$400 USD) - 2017/03/29 20:01:53 ET
Table 'ACPC Match' 2-max Seat #2 is the button
Seat 1: DeepStack ($21750 in chips)
Seat 2: Andrew_@ThinkingPoker ($18250 in chips)
Andrew_@ThinkingPoker: posts small blind $200
DeepStack: posts big blind $400
*** HOLE CARDS ***
Dealt to DeepStack [5c 8h]
Dealt to Andrew_@ThinkingPoker [Qd Th]
Andrew_@ThinkingPoker: raises $800 to $1200
DeepStack: raises $17050 to $18250
Andrew_@ThinkingPoker: folds
Uncalled bet ($17050) returned to DeepStack
DeepStack collected $2400 from the pot
*** SUMMARY ***
Total pot $2400 | Rake $0
Seat 1: DeepStack (big blind) collected ($2400)
Seat 2: Andrew_@ThinkingPoker (button) (small blind) folded before the Flop

PokerStars Hand #1001800044: Tournament #19, Mar29_2017-at-18_1_11 Hold'em No Limit ($200/$400 USD) - 2017/03/29 20:01:54 ET
Table 'ACPC Match' 2-max Seat #1 is the button
Seat 1: DeepStack ($22950 in chips)
Seat 2: Andrew_@ThinkingPoker ($17050 in chips)
DeepStack: posts small blind $200
Andrew_@ThinkingPoker: posts big blind $400
*** HOLE CARDS ***
Dealt to DeepStack [2h 5c]
Dealt to Andrew_@ThinkingPoker [8c 8s]
DeepStack: folds
Uncalled bet ($200) returned to Andrew_@ThinkingPoker
Andrew_@ThinkingPoker collected $400 from the pot
*** SUMMARY ***
Total pot $400 | Rake $0
Seat 1: DeepStack (button) (small blind) folded before the Flop
Seat 2: Andrew_@ThinkingPoker (big blind) collected ($400)

PokerStars Hand #1001800045: Tournament #19, Mar29_2017-at-18_1_11 Hold'em No Limit ($200/$400 USD) - 2017/03/29 20:01:55 ET
Table 'ACPC Match' 2-max Seat #2 is the button
Seat 1: DeepStack ($22750 in chips)
Seat 2: Andrew_@ThinkingPoker ($17250 in chips)
Andrew_@ThinkingPoker: posts small blind $200
DeepStack: posts big blind $400
*** HOLE CARDS ***
Dealt to DeepStack [2c 3d]
Dealt to Andrew_@ThinkingPoker [Qh 5h]
Andrew_@ThinkingPoker: raises $800 to $1200
DeepStack: folds
Uncalled bet ($800) returned to Andrew_@ThinkingPoker
Andrew_@ThinkingPoker collected $800 from the pot
*** SUMMARY ***
Total pot $800 | Rake $0
Seat 1: DeepStack (big blind) folded before the Flop
Seat 2: Andrew_@ThinkingPoker (button) (small blind) collected ($800)

PokerStars Hand #1001800046: Tournament #19, Mar29_2017-at-18_1_11 Hold'em No Limit ($200/$400 USD) - 2017/03/29 20:01:56 ET
Table 'ACPC Match' 2-max Seat #1 is the button
Seat 1: DeepStack ($22350 in chips)
Seat 2: Andrew_@ThinkingPoker ($17650 in chips)
DeepStack: posts small blind $200
Andrew_@ThinkingPoker: posts big blind $400
*** HOLE CARDS ***
Dealt to DeepStack [Kh 8c]
Dealt to Andrew_@ThinkingPoker [9c Ts]
DeepStack: raises $400 to $800
Andrew_@ThinkingPoker: calls $400
*** FLOP **** [Ah Td 4d]
Andrew_@ThinkingPoker: checks
DeepStack: checks
*** TURN **** [Kd]
Andrew_@ThinkingPoker: checks
DeepStack: checks
*** RIVER **** [Tc]
Andrew_@ThinkingPoker: bets $3200
DeepStack: folds
Uncalled bet ($3200) returned to Andrew_@ThinkingPoker
Andrew_@ThinkingPoker collected $1600 from the pot
*** SUMMARY ***
Total pot $1600 | Rake $0
Board [Ah Td 4d Kd Tc]
Seat 1: DeepStack (button) (small blind) folded on the River
Seat 2: Andrew_@ThinkingPoker (big blind) collected ($1600)

PokerStars Hand #1001800047: Tournament #19, Mar29_2017-at-18_1_11 Hold'em No Limit ($200/$400 USD) - 2017/03/29 20:01:57 ET
Table 'ACPC Match' 2-max Seat #2 is the button
Seat 1: DeepStack ($21550 in chips)
Seat 2: Andrew_@ThinkingPoker ($18450 in chips)
Andrew_@ThinkingPoker: posts small blind $200
DeepStack: posts big blind $400
*** HOLE CARDS ***
Dealt to DeepStack [8d Jc]
Dealt to Andrew_@ThinkingPoker [Ad Qc]
Andrew_@ThinkingPoker: raises $800 to $1200
DeepStack: calls $800
*** FLOP **** [Ac Ts 5c]
DeepStack: checks
Andrew_@ThinkingPoker: raises $1600 to $1600
DeepStack: folds
Uncalled bet ($1600) returned to Andrew_@ThinkingPoker
Andrew_@ThinkingPoker collected $2400 from the pot
*** SUMMARY ***
Total pot $2400 | Rake $0
Board [Ac Ts 5c]
Seat 1: DeepStack (big blind) folded on the Flop
Seat 2: Andrew_@ThinkingPoker (button) (small blind) collected ($2400)

PokerStars Hand #1001800048: Tournament #19, Mar29_2017-at-18_1_11 Hold'em No Limit ($200/$400 USD) - 2017/03/29 20:01:58 ET
Table 'ACPC Match' 2-max Seat #1 is the button
Seat 1: DeepStack ($20350 in chips)
Seat 2: Andrew_@ThinkingPoker ($19650 in chips)
DeepStack: posts small blind $200
Andrew_@ThinkingPoker: posts big blind $400
*** HOLE CARDS ***
Dealt to DeepStack [2d 4s]
Dealt to Andrew_@ThinkingPoker [5s Kc]
DeepStack: folds
Uncalled bet ($200) returned to Andrew_@ThinkingPoker
Andrew_@ThinkingPoker collected $400 from the pot
*** SUMMARY ***
Total pot $400 | Rake $0
Seat 1: DeepStack (button) (small blind) folded before the Flop
Seat 2: Andrew_@ThinkingPoker (big blind) collected ($400)

PokerStars Hand #1001800049: Tournament #19, Mar29_2017-at-18_1_11 Hold'em No Limit ($200/$400 USD) - 2017/03/29 20:01:59 ET
Table 'ACPC Match' 2-max Seat #2 is the button
Seat 1: DeepStack ($20150 in chips)
Seat 2: Andrew_@ThinkingPoker ($19850 in chips)
Andrew_@ThinkingPoker: posts small blind $200
DeepStack: posts big blind $400
*** HOLE CARDS ***
Dealt to DeepStack [Qd 8s]
Dealt to Andrew_@ThinkingPoker [5s 9c]
Andrew_@ThinkingPoker: folds
Uncalled bet ($200) returned to DeepStack
DeepStack collected $400 from the pot
*** SUMMARY ***
Total pot $400 | Rake $0
Seat 1: DeepStack (big blind) collected ($400)
Seat 2: Andrew_@ThinkingPoker (button) (small blind) folded before the Flop

PokerStars Hand #1001800050: Tournament #19, Mar29_2017-at-18_1_11 Hold'em No Limit ($200/$400 USD) - 2017/03/29 20:02:00 ET
Table 'ACPC Match' 2-max Seat #1 is the button
Seat 1: DeepStack ($20350 in chips)
Seat 2: Andrew_@ThinkingPoker ($19650 in chips)
DeepStack: posts small blind $200
Andrew_@ThinkingPoker: posts big blind $400
*** HOLE CARDS ***
Dealt to DeepStack [4c 3s]
Dealt to Andrew_@ThinkingPoker [8c 4h]
DeepStack: folds
Uncalled bet ($200) returned to Andrew_@ThinkingPoker
Andrew_@ThinkingPoker collected $400 from the pot
*** SUMMARY ***
Total pot $400 | Rake $0
Seat 1: DeepStack (button) (small blind) folded before the Flop
Seat 2: Andrew_@ThinkingPoker (big blind) collected ($400)

PokerStars Hand #1001800051: Tournament #19, Mar29_2017-at-18_1_11 Hold'em No Limit ($300/$600 USD) - 2017/03/29 20:02:01 ET
Table 'ACPC Match' 2-max Seat #2 is the button
Seat 1: DeepStack ($20150 in chips)
Seat 2: Andrew_@ThinkingPoker ($19850 in chips)
Andrew_@ThinkingPoker: posts small blind $300
DeepStack: posts big blind $600
*** HOLE CARDS ***
Dealt to DeepStack [5s 8d]
Dealt to Andrew_@ThinkingPoker [8s 4s]
Andrew_@ThinkingPoker: calls $300
DeepStack: checks
*** FLOP **** [Ah 2c Jd]
DeepStack: checks
Andrew_@ThinkingPoker: checks
*** TURN **** [4c]
DeepStack: bets $600
Andrew_@ThinkingPoker: calls $600
*** RIVER **** [Qs]
DeepStack: checks
Andrew_@ThinkingPoker: raises $2400 to $2400
DeepStack: raises $7200 to $9600
Andrew_@ThinkingPoker: folds
Uncalled bet ($7200) returned to DeepStack
DeepStack collected $7200 from the pot
*** SUMMARY ***
Total pot $7200 | Rake $0
Board [Ah 2c Jd 4c Qs]
Seat 1: DeepStack (big blind) collected ($7200)
Seat 2: Andrew_@ThinkingPoker (button) (small blind) folded on the River

PokerStars Hand #1001800052: Tournament #19, Mar29_2017-at-18_1_11 Hold'em No Limit ($300/$600 USD) - 2017/03/29 20:02:02 ET
Table 'ACPC Match' 2-max Seat #1 is the button
Seat 1: DeepStack ($23750 in chips)
Seat 2: Andrew_@ThinkingPoker ($16250 in chips)
DeepStack: posts small blind $300
Andrew_@ThinkingPoker: posts big blind $600
*** HOLE CARDS ***
Dealt to DeepStack [5d Tc]
Dealt to Andrew_@ThinkingPoker [Ts 8s]
DeepStack: calls $300
Andrew_@ThinkingPoker: checks
*** FLOP **** [4c 9c Ac]
Andrew_@ThinkingPoker: checks
DeepStack: raises $600 to $600
Andrew_@ThinkingPoker: folds
Uncalled bet ($600) returned to DeepStack
DeepStack collected $1200 from the pot
*** SUMMARY ***
Total pot $1200 | Rake $0
Board [4c 9c Ac]
Seat 1: DeepStack (button) (small blind) collected ($1200)
Seat 2: Andrew_@ThinkingPoker (big blind) folded on the Flop

PokerStars Hand #1001800053: Tournament #19, Mar29_2017-at-18_1_11 Hold'em No Limit ($300/$600 USD) - 2017/03/29 20:02:03 ET
Table 'ACPC Match' 2-max Seat #2 is the button
Seat 1: DeepStack ($24350 in chips)
Seat 2: Andrew_@ThinkingPoker ($15650 in chips)
Andrew_@ThinkingPoker: posts small blind $300
DeepStack: posts big blind $600
*** HOLE CARDS ***
Dealt to DeepStack [2d 4h]
Dealt to Andrew_@ThinkingPoker [5d 7d]
Andrew_@ThinkingPoker: calls $300
DeepStack: checks
*** FLOP **** [Qc 6h As]
DeepStack: checks
Andrew_@ThinkingPoker: checks
*** TURN **** [7c]
DeepStack: checks
Andrew_@ThinkingPoker: checks
*** RIVER **** [6d]
DeepStack: bets $600
Andrew_@ThinkingPoker: calls $600
*** SHOW DOWN ***
DeepStack: shows [2d 4h] (a pair of Sixes)
Andrew_@ThinkingPoker: shows [5d 7d] (two pair, Sevens and Sixes)
Andrew_@ThinkingPoker collected $2400 from pot
*** SUMMARY ***
Total pot $2400 | Rake $0
Board [Qc 6h As 7c 6d]
Seat 1: DeepStack (big blind) showed [2d 4h] and lost with a pair of Sixes
Seat 2: Andrew_@ThinkingPoker (button) (small blind) showed [5d 7d] and won ($2400) with two pair, Sevens and Sixes

PokerStars Hand #1001800054: Tournament #19, Mar29_2017-at-18_1_11 Hold'em No Limit ($300/$600 USD) - 2017/03/29 20:02:04 ET
Table 'ACPC Match' 2-max Seat #1 is the button
Seat 1: DeepStack ($23150 in chips)
Seat 2: Andrew_@ThinkingPoker ($16850 in chips)
DeepStack: posts small blind $300
Andrew_@ThinkingPoker: posts big blind $600
*** HOLE CARDS ***
Dealt to DeepStack [Ac 5c]
Dealt to Andrew_@ThinkingPoker [6c 9c]
DeepStack: raises $600 to $1200
Andrew_@ThinkingPoker: calls $600
*** FLOP **** [Tc 6h Td]
Andrew_@ThinkingPoker: checks
DeepStack: checks
*** TURN **** [5d]
Andrew_@ThinkingPoker: bets $1600
DeepStack: calls $1600
*** RIVER **** [9d]
Andrew_@ThinkingPoker: checks
DeepStack: checks
*** SHOW DOWN ***
Andrew_@ThinkingPoker: shows [6c 9c] (two pair, Tens and Nines)
DeepStack: shows [Ac 5c] (two pair, Tens and Fives)
Andrew_@ThinkingPoker collected $5600 from pot
*** SUMMARY ***
Total pot $5600 | Rake $0
Board [Tc 6h Td 5d 9d]
Seat 1: DeepStack (button) (small blind) showed [Ac 5c] and lost with two pair, Tens and Fives
Seat 2: Andrew_@ThinkingPoker (big blind) showed [6c 9c] and won ($5600) with two pair, Tens and Nines

PokerStars Hand #1001800055: Tournament #19, Mar29_2017-at-18_1_11 Hold'em No Limit ($300/$600 USD) - 2017/03/29 20:02:05 ET
Table 'ACPC Match' 2-max Seat #2 is the button
Seat 1: DeepStack ($20350 in chips)
Seat 2: Andrew_@ThinkingPoker ($19650 in chips)
Andrew_@ThinkingPoker: posts small blind $300
DeepStack: posts big blind $600
*** HOLE CARDS ***
Dealt to DeepStack [8s 2d]
Dealt to Andrew_@ThinkingPoker [8h 7s]
Andrew_@ThinkingPoker: raises $900 to $1500
DeepStack: folds
Uncalled bet ($900) returned to Andrew_@ThinkingPoker
Andrew_@ThinkingPoker collected $1200 from the pot
*** SUMMARY ***
Total pot $1200 | Rake $0
Seat 1: DeepStack (big blind) folded before the Flop
Seat 2: Andrew_@ThinkingPoker (button) (small blind) collected ($1200)

PokerStars Hand #1001800056: Tournament #19, Mar29_2017-at-18_1_11 Hold'em No Limit ($300/$600 USD) - 2017/03/29 20:02:06 ET
Table 'ACPC Match' 2-max Seat #1 is the button
Seat 1: DeepStack ($19750 in chips)
Seat 2: Andrew_@ThinkingPoker ($20250 in chips)
DeepStack: posts small blind $300
Andrew_@ThinkingPoker: posts big blind $600
*** HOLE CARDS ***
Dealt to DeepStack [5s Td]
Dealt to Andrew_@ThinkingPoker [Jd 6h]
DeepStack: calls $300
Andrew_@ThinkingPoker: checks
*** FLOP **** [2d 4s 4h]
Andrew_@ThinkingPoker: checks
DeepStack: raises $600 to $600
Andrew_@ThinkingPoker: folds
Uncalled bet ($600) returned to DeepStack
DeepStack collected $1200 from the pot
*** SUMMARY ***
Total pot $1200 | Rake $0
Board [2d 4s 4h]
Seat 1: DeepStack (button) (small blind) collected ($1200)
Seat 2: Andrew_@ThinkingPoker (big blind) folded on the Flop

PokerStars Hand #1001800057: Tournament #19, Mar29_2017-at-18_1_11 Hold'em No Limit ($300/$600 USD) - 2017/03/29 20:02:07 ET
Table 'ACPC Match' 2-max Seat #2 is the button
Seat 1: DeepStack ($20350 in chips)
Seat 2: Andrew_@ThinkingPoker ($19650 in chips)
Andrew_@ThinkingPoker: posts small blind $300
DeepStack: posts big blind $600
*** HOLE CARDS ***
Dealt to DeepStack [9c Kc]
Dealt to Andrew_@ThinkingPoker [Td 9h]
Andrew_@ThinkingPoker: raises $900 to $1500
DeepStack: calls $900
*** FLOP **** [Kd 5h 7d]
DeepStack: checks
Andrew_@ThinkingPoker: raises $1600 to $1600
DeepStack: calls $1600
*** TURN **** [Tc]
DeepStack: checks
Andrew_@ThinkingPoker: checks
*** RIVER **** [8h]
DeepStack: bets $6200
Andrew_@ThinkingPoker: calls $6200
*** SHOW DOWN ***
DeepStack: shows [9c Kc] (a pair of Kings)
Andrew_@ThinkingPoker: shows [Td 9h] (a pair of Tens)
DeepStack collected $18600 from pot
*** SUMMARY ***
Total pot $18600 | Rake $0
Board [Kd 5h 7d Tc 8h]
Seat 1: DeepStack (big blind) showed [9c Kc] and won ($18600) with a pair of Kings
Seat 2: Andrew_@ThinkingPoker (button) (small blind) showed [Td 9h] and lost with a pair of Tens

PokerStars Hand #1001800058: Tournament #19, Mar29_2017-at-18_1_11 Hold'em No Limit ($300/$600 USD) - 2017/03/29 20:02:08 ET
Table 'ACPC Match' 2-max Seat #1 is the button
Seat 1: DeepStack ($29650 in chips)
Seat 2: Andrew_@ThinkingPoker ($10350 in chips)
DeepStack: posts small blind $300
Andrew_@ThinkingPoker: posts big blind $600
*** HOLE CARDS ***
Dealt to DeepStack [8d 2c]
Dealt to Andrew_@ThinkingPoker [3h 5s]
DeepStack: calls $300
Andrew_@ThinkingPoker: checks
*** FLOP **** [9h Jd 5h]
Andrew_@ThinkingPoker: checks
DeepStack: checks
*** TURN **** [As]
Andrew_@ThinkingPoker: checks
DeepStack: checks
*** RIVER **** [3d]
Andrew_@ThinkingPoker: bets $2200
DeepStack: folds
Uncalled bet ($2200) returned to Andrew_@ThinkingPoker
Andrew_@ThinkingPoker collected $1200 from the pot
*** SUMMARY ***
Total pot $1200 | Rake $0
Board [9h Jd 5h As 3d]
Seat 1: DeepStack (button) (small blind) folded on the River
Seat 2: Andrew_@ThinkingPoker (big blind) collected ($1200)

PokerStars Hand #1001800059: Tournament #19, Mar29_2017-at-18_1_11 Hold'em No Limit ($300/$600 USD) - 2017/03/29 20:02:09 ET
Table 'ACPC Match' 2-max Seat #2 is the button
Seat 1: DeepStack ($29050 in chips)
Seat 2: Andrew_@ThinkingPoker ($10950 in chips)
Andrew_@ThinkingPoker: posts small blind $300
DeepStack: posts big blind $600
*** HOLE CARDS ***
Dealt to DeepStack [3c Jh]
Dealt to Andrew_@ThinkingPoker [Jd Kd]
Andrew_@ThinkingPoker: raises $900 to $1500
DeepStack: folds
Uncalled bet ($900) returned to Andrew_@ThinkingPoker
Andrew_@ThinkingPoker collected $1200 from the pot
*** SUMMARY ***
Total pot $1200 | Rake $0
Seat 1: DeepStack (big blind) folded before the Flop
Seat 2: Andrew_@ThinkingPoker (button) (small blind) collected ($1200)

PokerStars Hand #1001800060: Tournament #19, Mar29_2017-at-18_1_11 Hold'em No Limit ($300/$600 USD) - 2017/03/29 20:02:10 ET
Table 'ACPC Match' 2-max Seat #1 is the button
Seat 1: DeepStack ($28450 in chips)
Seat 2: Andrew_@ThinkingPoker ($11550 in chips)
DeepStack: posts small blind $300
Andrew_@ThinkingPoker: posts big blind $600
*** HOLE CARDS ***
Dealt to DeepStack [Qc 7h]
Dealt to Andrew_@ThinkingPoker [2s 9s]
DeepStack: calls $300
Andrew_@ThinkingPoker: checks
*** FLOP **** [Kd 6c Jd]
Andrew_@ThinkingPoker: checks
DeepStack: checks
*** TURN **** [2c]
Andrew_@ThinkingPoker: checks
DeepStack: checks
*** RIVER **** [3d]
Andrew_@ThinkingPoker: checks
DeepStack: checks
*** SHOW DOWN ***
Andrew_@ThinkingPoker: shows [2s 9s] (a pair of Deuces)
DeepStack: shows [Qc 7h] (King high)
Andrew_@ThinkingPoker collected $1200 from pot
*** SUMMARY ***
Total pot $1200 | Rake $0
Board [Kd 6c Jd 2c 3d]
Seat 1: DeepStack (button) (small blind) showed [Qc 7h] and lost with King high
Seat 2: Andrew_@ThinkingPoker (big blind) showed [2s 9s] and won ($1200) with a pair of Deuces

PokerStars Hand #1001800061: Tournament #19, Mar29_2017-at-18_1_11 Hold'em No Limit ($400/$800 USD) - 2017/03/29 20:02:11 ET
Table 'ACPC Match' 2-max Seat #2 is the button
Seat 1: DeepStack ($27850 in chips)
Seat 2: Andrew_@ThinkingPoker ($12150 in chips)
Andrew_@ThinkingPoker: posts small blind $400
DeepStack: posts big blind $800
*** HOLE CARDS ***
Dealt to DeepStack [Tc 8d]
Dealt to Andrew_@ThinkingPoker [Jh Js]
Andrew_@ThinkingPoker: raises $800 to $1600
DeepStack: calls $800
*** FLOP **** [Th Kc 7c]
DeepStack: checks
Andrew_@ThinkingPoker: checks
*** TURN **** [2c]
DeepStack: bets $3200
Andrew_@ThinkingPoker: calls $3200
*** RIVER **** [Ks]
DeepStack: bets $4800
Andrew_@ThinkingPoker: calls $4800
*** SHOW DOWN ***
DeepStack: shows [Tc 8d] (two pair, Kings and Tens)
Andrew_@ThinkingPoker: shows [Jh Js] (two pair, Kings and Jacks)
Andrew_@ThinkingPoker collected $19200 from pot
*** SUMMARY ***
Total pot $19200 | Rake $0
Board [Th Kc 7c 2c Ks]
Seat 1: DeepStack (big blind) showed [Tc 8d] and lost with two pair, Kings and Tens
Seat 2: Andrew_@ThinkingPoker (button) (small blind) showed [Jh Js] and won ($19200) with two pair, Kings and Jacks

PokerStars Hand #1001800062: Tournament #19, Mar29_2017-at-18_1_11 Hold'em No Limit ($400/$800 USD) - 2017/03/29 20:02:12 ET
Table 'ACPC Match' 2-max Seat #1 is the button
Seat 1: DeepStack ($18250 in chips)
Seat 2: Andrew_@ThinkingPoker ($21750 in chips)
DeepStack: posts small blind $400
Andrew_@ThinkingPoker: posts big blind $800
*** HOLE CARDS ***
Dealt to DeepStack [5s 6d]
Dealt to Andrew_@ThinkingPoker [6h 9c]
DeepStack: raises $800 to $1600
Andrew_@ThinkingPoker: folds
Uncalled bet ($800) returned to DeepStack
DeepStack collected $1600 from the pot
*** SUMMARY ***
Total pot $1600 | Rake $0
Seat 1: DeepStack (button) (small blind) collected ($1600)
Seat 2: Andrew_@ThinkingPoker (big blind) folded before the Flop

PokerStars Hand #1001800063: Tournament #19, Mar29_2017-at-18_1_11 Hold'em No Limit ($400/$800 USD) - 2017/03/29 20:02:13 ET
Table 'ACPC Match' 2-max Seat #2 is the button
Seat 1: DeepStack ($19050 in chips)
Seat 2: Andrew_@ThinkingPoker ($20950 in chips)
Andrew_@ThinkingPoker: posts small blind $400
DeepStack: posts big blind $800
*** HOLE CARDS ***
Dealt to DeepStack [Qd Qc]
Dealt to Andrew_@ThinkingPoker [Kd 5h]
Andrew_@ThinkingPoker: raises $800 to $1600
DeepStack: raises $3200 to $4800
Andrew_@ThinkingPoker: folds
Uncalled bet ($3200) returned to DeepStack
DeepStack collected $3200 from the pot
*** SUMMARY ***
Total pot $3200 | Rake $0
Seat 1: DeepStack (big blind) collected ($3200)
Seat 2: Andrew_@ThinkingPoker (button) (small blind) folded before the Flop

PokerStars Hand #1001800064: Tournament #19, Mar29_2017-at-18_1_11 Hold'em No Limit ($400/$800 USD) - 2017/03/29 20:02:14 ET
Table 'ACPC Match' 2-max Seat #1 is the button
Seat 1: DeepStack ($20650 in chips)
Seat 2: Andrew_@ThinkingPoker ($19350 in chips)
DeepStack: posts small blind $400
Andrew_@ThinkingPoker: posts big blind $800
*** HOLE CARDS ***
Dealt to DeepStack [Tc 8d]
Dealt to Andrew_@ThinkingPoker [6d Jc]
DeepStack: calls $400
Andrew_@ThinkingPoker: checks
*** FLOP **** [3h 6h Ad]
Andrew_@ThinkingPoker: checks
DeepStack: raises $800 to $800
Andrew_@ThinkingPoker: calls $800
*** TURN **** [Kh]
Andrew_@ThinkingPoker: checks
DeepStack: checks
*** RIVER **** [Th]
Andrew_@ThinkingPoker: bets $3200
DeepStack: folds
Uncalled bet ($3200) returned to Andrew_@ThinkingPoker
Andrew_@ThinkingPoker collected $3200 from the pot
*** SUMMARY ***
Total pot $3200 | Rake $0
Board [3h 6h Ad Kh Th]
Seat 1: DeepStack (button) (small blind) folded on the River
Seat 2: Andrew_@ThinkingPoker (big blind) collected ($3200)

PokerStars Hand #1001800065: Tournament #19, Mar29_2017-at-18_1_11 Hold'em No Limit ($400/$800 USD) - 2017/03/29 20:02:15 ET
Table 'ACPC Match' 2-max Seat #2 is the button
Seat 1: DeepStack ($19050 in chips)
Seat 2: Andrew_@ThinkingPoker ($20950 in chips)
Andrew_@ThinkingPoker: posts small blind $400
DeepStack: posts big blind $800
*** HOLE CARDS ***
Dealt to DeepStack [2s Jc]
Dealt to Andrew_@ThinkingPoker [Th 2d]
Andrew_@ThinkingPoker: folds
Uncalled bet ($400) returned to DeepStack
DeepStack collected $800 from the pot
*** SUMMARY ***
Total pot $800 | Rake $0
Seat 1: DeepStack (big blind) collected ($800)
Seat 2: Andrew_@ThinkingPoker (button) (small blind) folded before the Flop

PokerStars Hand #1001800066: Tournament #19, Mar29_2017-at-18_1_11 Hold'em No Limit ($400/$800 USD) - 2017/03/29 20:02:16 ET
Table 'ACPC Match' 2-max Seat #1 is the button
Seat 1: DeepStack ($19450 in chips)
Seat 2: Andrew_@ThinkingPoker ($20550 in chips)
DeepStack: posts small blind $400
Andrew_@ThinkingPoker: posts big blind $800
*** HOLE CARDS ***
Dealt to DeepStack [5c Ks]
Dealt to Andrew_@ThinkingPoker [Ts Kc]
DeepStack: calls $400
Andrew_@ThinkingPoker: raises $19750 to $20550 and is all-in
DeepStack: folds
Uncalled bet ($19750) returned to Andrew_@ThinkingPoker
Andrew_@ThinkingPoker collected $1600 from the pot
*** SUMMARY ***
Total pot $1600 | Rake $0
Seat 1: DeepStack (button) (small blind) folded before the Flop
Seat 2: Andrew_@ThinkingPoker (big blind) collected ($1600)

PokerStars Hand #1001800067: Tournament #19, Mar29_2017-at-18_1_11 Hold'em No Limit ($400/$800 USD) - 2017/03/29 20:02:17 ET
Table 'ACPC Match' 2-max Seat #2 is the button
Seat 1: DeepStack ($18650 in chips)
Seat 2: Andrew_@ThinkingPoker ($21350 in chips)
Andrew_@ThinkingPoker: posts small blind $400
DeepStack: posts big blind $800
*** HOLE CARDS ***
Dealt to DeepStack [7c 7h]
Dealt to Andrew_@ThinkingPoker [Jd Ah]
Andrew_@ThinkingPoker: raises $1200 to $2000
DeepStack: raises $16650 to $18650 and is all-in
Andrew_@ThinkingPoker: calls $16650
*** FLOP **** [9d Ad 2h]
*** TURN **** [5h]
*** RIVER **** [3c]
*** SHOW DOWN ***
DeepStack: shows [7c 7h] (a pair of Sevens)
Andrew_@ThinkingPoker: shows [Jd Ah] (a pair of Aces)
Andrew_@ThinkingPoker collected $37300 from pot
*** SUMMARY ***
Total pot $37300 | Rake $0
Board [9d Ad 2h 5h 3c]
Seat 1: DeepStack (big blind) showed [7c 7h] and lost with a pair of Sevens
Seat 2: Andrew_@ThinkingPoker (button) (small blind) showed [Jd Ah] and won ($37300) with a pair of Aces
