PokerStars Hand #7000000001: Tournament #1, Apr13_2017-at-16_27_48 Hold'em No Limit ($50/$100 USD) - 2017/04/13 18:27:48 ET
Table 'ACPC Match' 2-max Seat #2 is the button
Seat 1: DeepStack ($20000 in chips)
Seat 2: Dutch_@DutchBoyd ($20000 in chips)
Dutch_@DutchBoyd: posts small blind $50
DeepStack: posts big blind $100
*** HOLE CARDS ***
Dealt to DeepStack [Js Ac]
Dealt to Dutch_@DutchBoyd [7h 9d]
Dutch_@DutchBoyd: raises $19900 to $20000 and is all-in
DeepStack: folds
Uncalled bet ($19900) returned to Dutch_@DutchBoyd
Dutch_@DutchBoyd collected $200 from the pot
*** SUMMARY ***
Total pot $200 | Rake $0
Seat 1: DeepStack (big blind) folded before the Flop
Seat 2: Dutch_@DutchBoyd (button) (small blind) collected ($200)

PokerStars Hand #7000000002: Tournament #1, Apr13_2017-at-16_27_48 Hold'em No Limit ($50/$100 USD) - 2017/04/13 18:27:49 ET
Table 'ACPC Match' 2-max Seat #1 is the button
Seat 1: DeepStack ($19900 in chips)
Seat 2: Dutch_@DutchBoyd ($20100 in chips)
DeepStack: posts small blind $50
Dutch_@DutchBoyd: posts big blind $100
*** HOLE CARDS ***
Dealt to DeepStack [Jd Ah]
Dealt to Dutch_@DutchBoyd [8c 2h]
DeepStack: raises $200 to $300
Dutch_@DutchBoyd: raises $19800 to $20100 and is all-in
DeepStack: folds
Uncalled bet ($19800) returned to Dutch_@DutchBoyd
Dutch_@DutchBoyd collected $600 from the pot
*** SUMMARY ***
Total pot $600 | Rake $0
Seat 1: DeepStack (button) (small blind) folded before the Flop
Seat 2: Dutch_@DutchBoyd (big blind) collected ($600)

PokerStars Hand #7000000003: Tournament #1, Apr13_2017-at-16_27_48 Hold'em No Limit ($50/$100 USD) - 2017/04/13 18:27:50 ET
Table 'ACPC Match' 2-max Seat #2 is the button
Seat 1: DeepStack ($19600 in chips)
Seat 2: Dutch_@DutchBoyd ($20400 in chips)
Dutch_@DutchBoyd: posts small blind $50
DeepStack: posts big blind $100
*** HOLE CARDS ***
Dealt to DeepStack [4s Kc]
Dealt to Dutch_@DutchBoyd [Jh Qs]
Dutch_@DutchBoyd: raises $100 to $200
DeepStack: calls $100
*** FLOP **** [Js Kh Td]
DeepStack: checks
Dutch_@DutchBoyd: raises $200 to $200
DeepStack: calls $200
*** TURN **** [9c]
DeepStack: checks
Dutch_@DutchBoyd: raises $200 to $200
DeepStack: calls $200
*** RIVER **** [Qd]
DeepStack: checks
Dutch_@DutchBoyd: raises $19800 to $19800 and is all-in
DeepStack: folds
Uncalled bet ($19800) returned to Dutch_@DutchBoyd
Dutch_@DutchBoyd collected $1200 from the pot
*** SUMMARY ***
Total pot $1200 | Rake $0
Board [Js Kh Td 9c Qd]
Seat 1: DeepStack (big blind) folded on the River
Seat 2: Dutch_@DutchBoyd (button) (small blind) collected ($1200)

PokerStars Hand #7000000004: Tournament #1, Apr13_2017-at-16_27_48 Hold'em No Limit ($50/$100 USD) - 2017/04/13 18:27:51 ET
Table 'ACPC Match' 2-max Seat #1 is the button
Seat 1: DeepStack ($19000 in chips)
Seat 2: Dutch_@DutchBoyd ($21000 in chips)
DeepStack: posts small blind $50
Dutch_@DutchBoyd: posts big blind $100
*** HOLE CARDS ***
Dealt to DeepStack [Ah 7h]
Dealt to Dutch_@DutchBoyd [7d 9s]
DeepStack: raises $200 to $300
Dutch_@DutchBoyd: raises $20700 to $21000 and is all-in
DeepStack: folds
Uncalled bet ($20700) returned to Dutch_@DutchBoyd
Dutch_@DutchBoyd collected $600 from the pot
*** SUMMARY ***
Total pot $600 | Rake $0
Seat 1: DeepStack (button) (small blind) folded before the Flop
Seat 2: Dutch_@DutchBoyd (big blind) collected ($600)

PokerStars Hand #7000000005: Tournament #1, Apr13_2017-at-16_27_48 Hold'em No Limit ($50/$100 USD) - 2017/04/13 18:27:52 ET
Table 'ACPC Match' 2-max Seat #2 is the button
Seat 1: DeepStack ($18700 in chips)
Seat 2: Dutch_@DutchBoyd ($21300 in chips)
Dutch_@DutchBoyd: posts small blind $50
DeepStack: posts big blind $100
*** HOLE CARDS ***
Dealt to DeepStack [9s 5d]
Dealt to Dutch_@DutchBoyd [4h 3c]
Dutch_@DutchBoyd: raises $21200 to $21300 and is all-in
DeepStack: folds
Uncalled bet ($21200) returned to Dutch_@DutchBoyd
Dutch_@DutchBoyd collected $200 from the pot
*** SUMMARY ***
Total pot $200 | Rake $0
Seat 1: DeepStack (big blind) folded before the Flop
Seat 2: Dutch_@DutchBoyd (button) (small blind) collected ($200)

PokerStars Hand #7000000006: Tournament #1, Apr13_2017-at-16_27_48 Hold'em No Limit ($50/$100 USD) - 2017/04/13 18:27:53 ET
Table 'ACPC Match' 2-max Seat #1 is the button
Seat 1: DeepStack ($18600 in chips)
Seat 2: Dutch_@DutchBoyd ($21400 in chips)
DeepStack: posts small blind $50
Dutch_@DutchBoyd: posts big blind $100
*** HOLE CARDS ***
Dealt to DeepStack [Kd Qd]
Dealt to Dutch_@DutchBoyd [6c 8d]
DeepStack: raises $200 to $300
Dutch_@DutchBoyd: raises $21100 to $21400 and is all-in
DeepStack: calls $18300 and is all-in
Uncalled bet ($2800) returned to Dutch_@DutchBoyd
*** FLOP **** [9d Kc 4d]
*** TURN **** [Th]
*** RIVER **** [Ks]
*** SHOW DOWN ***
Dutch_@DutchBoyd: shows [6c 8d] (a pair of Kings)
DeepStack: shows [Kd Qd] (three of a kind, Kings)
DeepStack collected $37200 from pot
*** SUMMARY ***
Total pot $37200 | Rake $0
Board [9d Kc 4d Th Ks]
Seat 1: DeepStack (button) (small blind) showed [Kd Qd] and won ($37200) with three of a kind, Kings
Seat 2: Dutch_@DutchBoyd (big blind) showed [6c 8d] and lost with a pair of Kings

PokerStars Hand #7000000007: Tournament #1, Apr13_2017-at-16_27_48 Hold'em No Limit ($50/$100 USD) - 2017/04/13 18:27:54 ET
Table 'ACPC Match' 2-max Seat #2 is the button
Seat 1: DeepStack ($37200 in chips)
Seat 2: Dutch_@DutchBoyd ($2800 in chips)
Dutch_@DutchBoyd: posts small blind $50
DeepStack: posts big blind $100
*** HOLE CARDS ***
Dealt to DeepStack [As 6d]
Dealt to Dutch_@DutchBoyd [Jd Tc]
Dutch_@DutchBoyd: raises $100 to $200
DeepStack: calls $100
*** FLOP **** [6h 5s Th]
DeepStack: checks
Dutch_@DutchBoyd: raises $100 to $100
DeepStack: calls $100
*** TURN **** [7h]
DeepStack: checks
Dutch_@DutchBoyd: raises $300 to $300
DeepStack: folds
Uncalled bet ($300) returned to Dutch_@DutchBoyd
Dutch_@DutchBoyd collected $600 from the pot
*** SUMMARY ***
Total pot $600 | Rake $0
Board [6h 5s Th 7h]
Seat 1: DeepStack (big blind) folded on the Turn
Seat 2: Dutch_@DutchBoyd (button) (small blind) collected ($600)

PokerStars Hand #7000000008: Tournament #1, Apr13_2017-at-16_27_48 Hold'em No Limit ($50/$100 USD) - 2017/04/13 18:27:55 ET
Table 'ACPC Match' 2-max Seat #1 is the button
Seat 1: DeepStack ($36900 in chips)
Seat 2: Dutch_@DutchBoyd ($3100 in chips)
DeepStack: posts small blind $50
Dutch_@DutchBoyd: posts big blind $100
*** HOLE CARDS ***
Dealt to DeepStack [Jd 2d]
Dealt to Dutch_@DutchBoyd [5h 6h]
DeepStack: calls $50
Dutch_@DutchBoyd: checks
*** FLOP **** [2s Jc 8s]
Dutch_@DutchBoyd: checks
DeepStack: raises $100 to $100
Dutch_@DutchBoyd: folds
Uncalled bet ($100) returned to DeepStack
DeepStack collected $200 from the pot
*** SUMMARY ***
Total pot $200 | Rake $0
Board [2s Jc 8s]
Seat 1: DeepStack (button) (small blind) collected ($200)
Seat 2: Dutch_@DutchBoyd (big blind) folded on the Flop

PokerStars Hand #7000000009: Tournament #1, Apr13_2017-at-16_27_48 Hold'em No Limit ($50/$100 USD) - 2017/04/13 18:27:56 ET
Table 'ACPC Match' 2-max Seat #2 is the button
Seat 1: DeepStack ($37000 in chips)
Seat 2: Dutch_@DutchBoyd ($3000 in chips)
Dutch_@DutchBoyd: posts small blind $50
DeepStack: posts big blind $100
*** HOLE CARDS ***
Dealt to DeepStack [Kd Qd]
Dealt to Dutch_@DutchBoyd [6d 8s]
Dutch_@DutchBoyd: raises $100 to $200
DeepStack: calls $100
*** FLOP **** [3s 7s Tc]
DeepStack: checks
Dutch_@DutchBoyd: checks
*** TURN **** [Kc]
DeepStack: bets $400
Dutch_@DutchBoyd: folds
Uncalled bet ($400) returned to DeepStack
DeepStack collected $400 from the pot
*** SUMMARY ***
Total pot $400 | Rake $0
Board [3s 7s Tc Kc]
Seat 1: DeepStack (big blind) collected ($400)
Seat 2: Dutch_@DutchBoyd (button) (small blind) folded on the Turn

PokerStars Hand #7000000010: Tournament #1, Apr13_2017-at-16_27_48 Hold'em No Limit ($50/$100 USD) - 2017/04/13 18:27:57 ET
Table 'ACPC Match' 2-max Seat #1 is the button
Seat 1: DeepStack ($37200 in chips)
Seat 2: Dutch_@DutchBoyd ($2800 in chips)
DeepStack: posts small blind $50
Dutch_@DutchBoyd: posts big blind $100
*** HOLE CARDS ***
Dealt to DeepStack [Kc 9d]
Dealt to Dutch_@DutchBoyd [5c 8d]
DeepStack: raises $100 to $200
Dutch_@DutchBoyd: calls $100
*** FLOP **** [6c 5d 9c]
Dutch_@DutchBoyd: checks
DeepStack: raises $400 to $400
Dutch_@DutchBoyd: raises $2200 to $2600 and is all-in
DeepStack: calls $2200
*** TURN **** [2s]
*** RIVER **** [As]
*** SHOW DOWN ***
Dutch_@DutchBoyd: shows [5c 8d] (a pair of Fives)
DeepStack: shows [Kc 9d] (a pair of Nines)
DeepStack collected $5600 from pot
*** SUMMARY ***
Total pot $5600 | Rake $0
Board [6c 5d 9c 2s As]
Seat 1: DeepStack (button) (small blind) showed [Kc 9d] and won ($5600) with a pair of Nines
Seat 2: Dutch_@DutchBoyd (big blind) showed [5c 8d] and lost with a pair of Fives
