PokerStars Hand #7000100001: Tournament #2, Apr13_2017-at-16_41_56 Hold'em No Limit ($50/$100 USD) - 2017/04/13 18:41:56 ET
Table 'ACPC Match' 2-max Seat #2 is the button
Seat 1: DeepStack ($20000 in chips)
Seat 2: Dutch_@DutchBoyd ($20000 in chips)
Dutch_@DutchBoyd: posts small blind $50
DeepStack: posts big blind $100
*** HOLE CARDS ***
Dealt to DeepStack [Js Qd]
Dealt to Dutch_@DutchBoyd [7h 3d]
Dutch_@DutchBoyd: raises $19900 to $20000 and is all-in
DeepStack: folds
Uncalled bet ($19900) returned to Dutch_@DutchBoyd
Dutch_@DutchBoyd collected $200 from the pot
*** SUMMARY ***
Total pot $200 | Rake $0
Seat 1: DeepStack (big blind) folded before the Flop
Seat 2: Dutch_@DutchBoyd (button) (small blind) collected ($200)

PokerStars Hand #7000100002: Tournament #2, Apr13_2017-at-16_41_56 Hold'em No Limit ($50/$100 USD) - 2017/04/13 18:41:57 ET
Table 'ACPC Match' 2-max Seat #1 is the button
Seat 1: DeepStack ($19900 in chips)
Seat 2: Dutch_@DutchBoyd ($20100 in chips)
DeepStack: posts small blind $50
Dutch_@DutchBoyd: posts big blind $100
*** HOLE CARDS ***
Dealt to DeepStack [Kh 6c]
Dealt to Dutch_@DutchBoyd [2h 5h]
DeepStack: raises $100 to $200
Dutch_@DutchBoyd: raises $19900 to $20100 and is all-in
DeepStack: folds
Uncalled bet ($19900) returned to Dutch_@DutchBoyd
Dutch_@DutchBoyd collected $400 from the pot
*** SUMMARY ***
Total pot $400 | Rake $0
Seat 1: DeepStack (button) (small blind) folded before the Flop
Seat 2: Dutch_@DutchBoyd (big blind) collected ($400)

PokerStars Hand #7000100003: Tournament #2, Apr13_2017-at-16_41_56 Hold'em No Limit ($50/$100 USD) - 2017/04/13 18:41:58 ET
Table 'ACPC Match' 2-max Seat #2 is the button
Seat 1: DeepStack ($19700 in chips)
Seat 2: Dutch_@DutchBoyd ($20300 in chips)
Dutch_@DutchBoyd: posts small blind $50
DeepStack: posts big blind $100
*** HOLE CARDS ***
Dealt to DeepStack [4h Td]
Dealt to Dutch_@DutchBoyd [Kh 4d]
Dutch_@DutchBoyd: raises $20200 to $20300 and is all-in
DeepStack: folds
Uncalled bet ($20200) returned to Dutch_@DutchBoyd
Dutch_@DutchBoyd collected $200 from the pot
*** SUMMARY ***
Total pot $200 | Rake $0
Seat 1: DeepStack (big blind) folded before the Flop
Seat 2: Dutch_@DutchBoyd (button) (small blind) collected ($200)

PokerStars Hand #7000100004: Tournament #2, Apr13_2017-at-16_41_56 Hold'em No Limit ($50/$100 USD) - 2017/04/13 18:41:59 ET
Table 'ACPC Match' 2-max Seat #1 is the button
Seat 1: DeepStack ($19600 in chips)
Seat 2: Dutch_@DutchBoyd ($20400 in chips)
DeepStack: posts small blind $50
Dutch_@DutchBoyd: posts big blind $100
*** HOLE CARDS ***
Dealt to DeepStack [6d 5h]
Dealt to Dutch_@DutchBoyd [6h Kh]
DeepStack: calls $50
Dutch_@DutchBoyd: raises $20300 to $20400 and is all-in
DeepStack: folds
Uncalled bet ($20300) returned to Dutch_@DutchBoyd
Dutch_@DutchBoyd collected $200 from the pot
*** SUMMARY ***
Total pot $200 | Rake $0
Seat 1: DeepStack (button) (small blind) folded before the Flop
Seat 2: Dutch_@DutchBoyd (big blind) collected ($200)

PokerStars Hand #7000100005: Tournament #2, Apr13_2017-at-16_41_56 Hold'em No Limit ($50/$100 USD) - 2017/04/13 18:42:00 ET
Table 'ACPC Match' 2-max Seat #2 is the button
Seat 1: DeepStack ($19500 in chips)
Seat 2: Dutch_@DutchBoyd ($20500 in chips)
Dutch_@DutchBoyd: posts small blind $50
DeepStack: posts big blind $100
*** HOLE CARDS ***
Dealt to DeepStack [Jh 5s]
Dealt to Dutch_@DutchBoyd [Ac Ks]
Dutch_@DutchBoyd: raises $100 to $200
DeepStack: calls $100
*** FLOP **** [6d Qc 3c]
DeepStack: checks
Dutch_@DutchBoyd: checks
*** TURN **** [2c]
DeepStack: checks
Dutch_@DutchBoyd: checks
*** RIVER **** [3s]
DeepStack: checks
Dutch_@DutchBoyd: raises $200 to $200
DeepStack: folds
Uncalled bet ($200) returned to Dutch_@DutchBoyd
Dutch_@DutchBoyd collected $400 from the pot
*** SUMMARY ***
Total pot $400 | Rake $0
Board [6d Qc 3c 2c 3s]
Seat 1: DeepStack (big blind) folded on the River
Seat 2: Dutch_@DutchBoyd (button) (small blind) collected ($400)

PokerStars Hand #7000100006: Tournament #2, Apr13_2017-at-16_41_56 Hold'em No Limit ($50/$100 USD) - 2017/04/13 18:42:01 ET
Table 'ACPC Match' 2-max Seat #1 is the button
Seat 1: DeepStack ($19300 in chips)
Seat 2: Dutch_@DutchBoyd ($20700 in chips)
DeepStack: posts small blind $50
Dutch_@DutchBoyd: posts big blind $100
*** HOLE CARDS ***
Dealt to DeepStack [3s 8s]
Dealt to Dutch_@DutchBoyd [9s Jh]
DeepStack: raises $200 to $300
Dutch_@DutchBoyd: raises $20400 to $20700 and is all-in
DeepStack: folds
Uncalled bet ($20400) returned to Dutch_@DutchBoyd
Dutch_@DutchBoyd collected $600 from the pot
*** SUMMARY ***
Total pot $600 | Rake $0
Seat 1: DeepStack (button) (small blind) folded before the Flop
Seat 2: Dutch_@DutchBoyd (big blind) collected ($600)

PokerStars Hand #7000100007: Tournament #2, Apr13_2017-at-16_41_56 Hold'em No Limit ($50/$100 USD) - 2017/04/13 18:42:02 ET
Table 'ACPC Match' 2-max Seat #2 is the button
Seat 1: DeepStack ($19000 in chips)
Seat 2: Dutch_@DutchBoyd ($21000 in chips)
Dutch_@DutchBoyd: posts small blind $50
DeepStack: posts big blind $100
*** HOLE CARDS ***
Dealt to DeepStack [Ts 4h]
Dealt to Dutch_@DutchBoyd [Js 9c]
Dutch_@DutchBoyd: raises $20900 to $21000 and is all-in
DeepStack: folds
Uncalled bet ($20900) returned to Dutch_@DutchBoyd
Dutch_@DutchBoyd collected $200 from the pot
*** SUMMARY ***
Total pot $200 | Rake $0
Seat 1: DeepStack (big blind) folded before the Flop
Seat 2: Dutch_@DutchBoyd (button) (small blind) collected ($200)

PokerStars Hand #7000100008: Tournament #2, Apr13_2017-at-16_41_56 Hold'em No Limit ($50/$100 USD) - 2017/04/13 18:42:03 ET
Table 'ACPC Match' 2-max Seat #1 is the button
Seat 1: DeepStack ($18900 in chips)
Seat 2: Dutch_@DutchBoyd ($21100 in chips)
DeepStack: posts small blind $50
Dutch_@DutchBoyd: posts big blind $100
*** HOLE CARDS ***
Dealt to DeepStack [3h Kd]
Dealt to Dutch_@DutchBoyd [4h Jh]
DeepStack: calls $50
Dutch_@DutchBoyd: raises $21000 to $21100 and is all-in
DeepStack: folds
Uncalled bet ($21000) returned to Dutch_@DutchBoyd
Dutch_@DutchBoyd collected $200 from the pot
*** SUMMARY ***
Total pot $200 | Rake $0
Seat 1: DeepStack (button) (small blind) folded before the Flop
Seat 2: Dutch_@DutchBoyd (big blind) collected ($200)

PokerStars Hand #7000100009: Tournament #2, Apr13_2017-at-16_41_56 Hold'em No Limit ($50/$100 USD) - 2017/04/13 18:42:04 ET
Table 'ACPC Match' 2-max Seat #2 is the button
Seat 1: DeepStack ($18800 in chips)
Seat 2: Dutch_@DutchBoyd ($21200 in chips)
Dutch_@DutchBoyd: posts small blind $50
DeepStack: posts big blind $100
*** HOLE CARDS ***
Dealt to DeepStack [Kc 9s]
Dealt to Dutch_@DutchBoyd [9h 9c]
Dutch_@DutchBoyd: raises $100 to $200
DeepStack: calls $100
*** FLOP **** [As 4h 7c]
DeepStack: checks
Dutch_@DutchBoyd: raises $200 to $200
DeepStack: calls $200
*** TURN **** [Qs]
DeepStack: checks
Dutch_@DutchBoyd: checks
*** RIVER **** [6c]
DeepStack: checks
Dutch_@DutchBoyd: raises $200 to $200
DeepStack: folds
Uncalled bet ($200) returned to Dutch_@DutchBoyd
Dutch_@DutchBoyd collected $800 from the pot
*** SUMMARY ***
Total pot $800 | Rake $0
Board [As 4h 7c Qs 6c]
Seat 1: DeepStack (big blind) folded on the River
Seat 2: Dutch_@DutchBoyd (button) (small blind) collected ($800)

PokerStars Hand #7000100010: Tournament #2, Apr13_2017-at-16_41_56 Hold'em No Limit ($50/$100 USD) - 2017/04/13 18:42:05 ET
Table 'ACPC Match' 2-max Seat #1 is the button
Seat 1: DeepStack ($18400 in chips)
Seat 2: Dutch_@DutchBoyd ($21600 in chips)
DeepStack: posts small blind $50
Dutch_@DutchBoyd: posts big blind $100
*** HOLE CARDS ***
Dealt to DeepStack [8s Js]
Dealt to Dutch_@DutchBoyd [3d 4c]
DeepStack: calls $50
Dutch_@DutchBoyd: raises $21500 to $21600 and is all-in
DeepStack: folds
Uncalled bet ($21500) returned to Dutch_@DutchBoyd
Dutch_@DutchBoyd collected $200 from the pot
*** SUMMARY ***
Total pot $200 | Rake $0
Seat 1: DeepStack (button) (small blind) folded before the Flop
Seat 2: Dutch_@DutchBoyd (big blind) collected ($200)

PokerStars Hand #7000100011: Tournament #2, Apr13_2017-at-16_41_56 Hold'em No Limit ($75/$150 USD) - 2017/04/13 18:42:06 ET
Table 'ACPC Match' 2-max Seat #2 is the button
Seat 1: DeepStack ($18300 in chips)
Seat 2: Dutch_@DutchBoyd ($21700 in chips)
Dutch_@DutchBoyd: posts small blind $75
DeepStack: posts big blind $150
*** HOLE CARDS ***
Dealt to DeepStack [Qd 8d]
Dealt to Dutch_@DutchBoyd [2d Tc]
Dutch_@DutchBoyd: raises $21550 to $21700 and is all-in
DeepStack: folds
Uncalled bet ($21550) returned to Dutch_@DutchBoyd
Dutch_@DutchBoyd collected $300 from the pot
*** SUMMARY ***
Total pot $300 | Rake $0
Seat 1: DeepStack (big blind) folded before the Flop
Seat 2: Dutch_@DutchBoyd (button) (small blind) collected ($300)

PokerStars Hand #7000100012: Tournament #2, Apr13_2017-at-16_41_56 Hold'em No Limit ($75/$150 USD) - 2017/04/13 18:42:07 ET
Table 'ACPC Match' 2-max Seat #1 is the button
Seat 1: DeepStack ($18150 in chips)
Seat 2: Dutch_@DutchBoyd ($21850 in chips)
DeepStack: posts small blind $75
Dutch_@DutchBoyd: posts big blind $150
*** HOLE CARDS ***
Dealt to DeepStack [2h 2d]
Dealt to Dutch_@DutchBoyd [4d 8d]
DeepStack: calls $75
Dutch_@DutchBoyd: raises $21700 to $21850 and is all-in
DeepStack: folds
Uncalled bet ($21700) returned to Dutch_@DutchBoyd
Dutch_@DutchBoyd collected $300 from the pot
*** SUMMARY ***
Total pot $300 | Rake $0
Seat 1: DeepStack (button) (small blind) folded before the Flop
Seat 2: Dutch_@DutchBoyd (big blind) collected ($300)

PokerStars Hand #7000100013: Tournament #2, Apr13_2017-at-16_41_56 Hold'em No Limit ($75/$150 USD) - 2017/04/13 18:42:08 ET
Table 'ACPC Match' 2-max Seat #2 is the button
Seat 1: DeepStack ($18000 in chips)
Seat 2: Dutch_@DutchBoyd ($22000 in chips)
Dutch_@DutchBoyd: posts small blind $75
DeepStack: posts big blind $150
*** HOLE CARDS ***
Dealt to DeepStack [5c Jc]
Dealt to Dutch_@DutchBoyd [2s Ac]
Dutch_@DutchBoyd: raises $21850 to $22000 and is all-in
DeepStack: folds
Uncalled bet ($21850) returned to Dutch_@DutchBoyd
Dutch_@DutchBoyd collected $300 from the pot
*** SUMMARY ***
Total pot $300 | Rake $0
Seat 1: DeepStack (big blind) folded before the Flop
Seat 2: Dutch_@DutchBoyd (button) (small blind) collected ($300)

PokerStars Hand #7000100014: Tournament #2, Apr13_2017-at-16_41_56 Hold'em No Limit ($75/$150 USD) - 2017/04/13 18:42:09 ET
Table 'ACPC Match' 2-max Seat #1 is the button
Seat 1: DeepStack ($17850 in chips)
Seat 2: Dutch_@DutchBoyd ($22150 in chips)
DeepStack: posts small blind $75
Dutch_@DutchBoyd: posts big blind $150
*** HOLE CARDS ***
Dealt to DeepStack [Kc Jd]
Dealt to Dutch_@DutchBoyd [6c 2d]
DeepStack: raises $300 to $450
Dutch_@DutchBoyd: raises $21700 to $22150 and is all-in
DeepStack: folds
Uncalled bet ($21700) returned to Dutch_@DutchBoyd
Dutch_@DutchBoyd collected $900 from the pot
*** SUMMARY ***
Total pot $900 | Rake $0
Seat 1: DeepStack (button) (small blind) folded before the Flop
Seat 2: Dutch_@DutchBoyd (big blind) collected ($900)

PokerStars Hand #7000100015: Tournament #2, Apr13_2017-at-16_41_56 Hold'em No Limit ($75/$150 USD) - 2017/04/13 18:42:10 ET
Table 'ACPC Match' 2-max Seat #2 is the button
Seat 1: DeepStack ($17400 in chips)
Seat 2: Dutch_@DutchBoyd ($22600 in chips)
Dutch_@DutchBoyd: posts small blind $75
DeepStack: posts big blind $150
*** HOLE CARDS ***
Dealt to DeepStack [6c Jc]
Dealt to Dutch_@DutchBoyd [Th 9s]
Dutch_@DutchBoyd: raises $22450 to $22600 and is all-in
DeepStack: folds
Uncalled bet ($22450) returned to Dutch_@DutchBoyd
Dutch_@DutchBoyd collected $300 from the pot
*** SUMMARY ***
Total pot $300 | Rake $0
Seat 1: DeepStack (big blind) folded before the Flop
Seat 2: Dutch_@DutchBoyd (button) (small blind) collected ($300)

PokerStars Hand #7000100016: Tournament #2, Apr13_2017-at-16_41_56 Hold'em No Limit ($75/$150 USD) - 2017/04/13 18:42:11 ET
Table 'ACPC Match' 2-max Seat #1 is the button
Seat 1: DeepStack ($17250 in chips)
Seat 2: Dutch_@DutchBoyd ($22750 in chips)
DeepStack: posts small blind $75
Dutch_@DutchBoyd: posts big blind $150
*** HOLE CARDS ***
Dealt to DeepStack [Qh 9s]
Dealt to Dutch_@DutchBoyd [3s 6h]
DeepStack: raises $300 to $450
Dutch_@DutchBoyd: raises $22300 to $22750 and is all-in
DeepStack: folds
Uncalled bet ($22300) returned to Dutch_@DutchBoyd
Dutch_@DutchBoyd collected $900 from the pot
*** SUMMARY ***
Total pot $900 | Rake $0
Seat 1: DeepStack (button) (small blind) folded before the Flop
Seat 2: Dutch_@DutchBoyd (big blind) collected ($900)

PokerStars Hand #7000100017: Tournament #2, Apr13_2017-at-16_41_56 Hold'em No Limit ($75/$150 USD) - 2017/04/13 18:42:12 ET
Table 'ACPC Match' 2-max Seat #2 is the button
Seat 1: DeepStack ($16800 in chips)
Seat 2: Dutch_@DutchBoyd ($23200 in chips)
Dutch_@DutchBoyd: posts small blind $75
DeepStack: posts big blind $150
*** HOLE CARDS ***
Dealt to DeepStack [3d Js]
Dealt to Dutch_@DutchBoyd [8d Ad]
Dutch_@DutchBoyd: raises $150 to $300
DeepStack: calls $150
*** FLOP **** [Ks 3h As]
DeepStack: checks
Dutch_@DutchBoyd: raises $150 to $150
DeepStack: calls $150
*** TURN **** [7s]
DeepStack: checks
Dutch_@DutchBoyd: raises $250 to $250
DeepStack: calls $250
*** RIVER **** [6d]
DeepStack: checks
Dutch_@DutchBoyd: raises $300 to $300
DeepStack: calls $300
*** SHOW DOWN ***
Dutch_@DutchBoyd: shows [8d Ad] (a pair of Aces)
DeepStack: shows [3d Js] (a pair of Threes)
Dutch_@DutchBoyd collected $2000 from pot
*** SUMMARY ***
Total pot $2000 | Rake $0
Board [Ks 3h As 7s 6d]
Seat 1: DeepStack (big blind) showed [3d Js] and lost with a pair of Threes
Seat 2: Dutch_@DutchBoyd (button) (small blind) showed [8d Ad] and won ($2000) with a pair of Aces

PokerStars Hand #7000100018: Tournament #2, Apr13_2017-at-16_41_56 Hold'em No Limit ($75/$150 USD) - 2017/04/13 18:42:13 ET
Table 'ACPC Match' 2-max Seat #1 is the button
Seat 1: DeepStack ($15800 in chips)
Seat 2: Dutch_@DutchBoyd ($24200 in chips)
DeepStack: posts small blind $75
Dutch_@DutchBoyd: posts big blind $150
*** HOLE CARDS ***
Dealt to DeepStack [Js 7d]
Dealt to Dutch_@DutchBoyd [5d 8c]
DeepStack: raises $300 to $450
Dutch_@DutchBoyd: raises $23750 to $24200 and is all-in
DeepStack: folds
Uncalled bet ($23750) returned to Dutch_@DutchBoyd
Dutch_@DutchBoyd collected $900 from the pot
*** SUMMARY ***
Total pot $900 | Rake $0
Seat 1: DeepStack (button) (small blind) folded before the Flop
Seat 2: Dutch_@DutchBoyd (big blind) collected ($900)

PokerStars Hand #7000100019: Tournament #2, Apr13_2017-at-16_41_56 Hold'em No Limit ($75/$150 USD) - 2017/04/13 18:42:14 ET
Table 'ACPC Match' 2-max Seat #2 is the button
Seat 1: DeepStack ($15350 in chips)
Seat 2: Dutch_@DutchBoyd ($24650 in chips)
Dutch_@DutchBoyd: posts small blind $75
DeepStack: posts big blind $150
*** HOLE CARDS ***
Dealt to DeepStack [Jc Qh]
Dealt to Dutch_@DutchBoyd [Ad 6s]
Dutch_@DutchBoyd: raises $24500 to $24650 and is all-in
DeepStack: folds
Uncalled bet ($24500) returned to Dutch_@DutchBoyd
Dutch_@DutchBoyd collected $300 from the pot
*** SUMMARY ***
Total pot $300 | Rake $0
Seat 1: DeepStack (big blind) folded before the Flop
Seat 2: Dutch_@DutchBoyd (button) (small blind) collected ($300)

PokerStars Hand #7000100020: Tournament #2, Apr13_2017-at-16_41_56 Hold'em No Limit ($75/$150 USD) - 2017/04/13 18:42:15 ET
Table 'ACPC Match' 2-max Seat #1 is the button
Seat 1: DeepStack ($15200 in chips)
Seat 2: Dutch_@DutchBoyd ($24800 in chips)
DeepStack: posts small blind $75
Dutch_@DutchBoyd: posts big blind $150
*** HOLE CARDS ***
Dealt to DeepStack [5s 4h]
Dealt to Dutch_@DutchBoyd [Qh 4d]
DeepStack: raises $150 to $300
Dutch_@DutchBoyd: raises $24500 to $24800 and is all-in
DeepStack: folds
Uncalled bet ($24500) returned to Dutch_@DutchBoyd
Dutch_@DutchBoyd collected $600 from the pot
*** SUMMARY ***
Total pot $600 | Rake $0
Seat 1: DeepStack (button) (small blind) folded before the Flop
Seat 2: Dutch_@DutchBoyd (big blind) collected ($600)

PokerStars Hand #7000100021: Tournament #2, Apr13_2017-at-16_41_56 Hold'em No Limit ($100/$200 USD) - 2017/04/13 18:42:16 ET
Table 'ACPC Match' 2-max Seat #2 is the button
Seat 1: DeepStack ($14900 in chips)
Seat 2: Dutch_@DutchBoyd ($25100 in chips)
Dutch_@DutchBoyd: posts small blind $100
DeepStack: posts big blind $200
*** HOLE CARDS ***
Dealt to DeepStack [3s Qs]
Dealt to Dutch_@DutchBoyd [2h 6s]
Dutch_@DutchBoyd: raises $24900 to $25100 and is all-in
DeepStack: folds
Uncalled bet ($24900) returned to Dutch_@DutchBoyd
Dutch_@DutchBoyd collected $400 from the pot
*** SUMMARY ***
Total pot $400 | Rake $0
Seat 1: DeepStack (big blind) folded before the Flop
Seat 2: Dutch_@DutchBoyd (button) (small blind) collected ($400)

PokerStars Hand #7000100022: Tournament #2, Apr13_2017-at-16_41_56 Hold'em No Limit ($100/$200 USD) - 2017/04/13 18:42:17 ET
Table 'ACPC Match' 2-max Seat #1 is the button
Seat 1: DeepStack ($14700 in chips)
Seat 2: Dutch_@DutchBoyd ($25300 in chips)
DeepStack: posts small blind $100
Dutch_@DutchBoyd: posts big blind $200
*** HOLE CARDS ***
Dealt to DeepStack [2c Tc]
Dealt to Dutch_@DutchBoyd [3c Td]
DeepStack: raises $400 to $600
Dutch_@DutchBoyd: folds
Uncalled bet ($400) returned to DeepStack
DeepStack collected $400 from the pot
*** SUMMARY ***
Total pot $400 | Rake $0
Seat 1: DeepStack (button) (small blind) collected ($400)
Seat 2: Dutch_@DutchBoyd (big blind) folded before the Flop

PokerStars Hand #7000100023: Tournament #2, Apr13_2017-at-16_41_56 Hold'em No Limit ($100/$200 USD) - 2017/04/13 18:42:18 ET
Table 'ACPC Match' 2-max Seat #2 is the button
Seat 1: DeepStack ($14900 in chips)
Seat 2: Dutch_@DutchBoyd ($25100 in chips)
Dutch_@DutchBoyd: posts small blind $100
DeepStack: posts big blind $200
*** HOLE CARDS ***
Dealt to DeepStack [9h 7h]
Dealt to Dutch_@DutchBoyd [Ac 5h]
Dutch_@DutchBoyd: raises $24900 to $25100 and is all-in
DeepStack: folds
Uncalled bet ($24900) returned to Dutch_@DutchBoyd
Dutch_@DutchBoyd collected $400 from the pot
*** SUMMARY ***
Total pot $400 | Rake $0
Seat 1: DeepStack (big blind) folded before the Flop
Seat 2: Dutch_@DutchBoyd (button) (small blind) collected ($400)

PokerStars Hand #7000100024: Tournament #2, Apr13_2017-at-16_41_56 Hold'em No Limit ($100/$200 USD) - 2017/04/13 18:42:19 ET
Table 'ACPC Match' 2-max Seat #1 is the button
Seat 1: DeepStack ($14700 in chips)
Seat 2: Dutch_@DutchBoyd ($25300 in chips)
DeepStack: posts small blind $100
Dutch_@DutchBoyd: posts big blind $200
*** HOLE CARDS ***
Dealt to DeepStack [6d 7s]
Dealt to Dutch_@DutchBoyd [7h 2c]
DeepStack: raises $200 to $400
Dutch_@DutchBoyd: raises $24900 to $25300 and is all-in
DeepStack: folds
Uncalled bet ($24900) returned to Dutch_@DutchBoyd
Dutch_@DutchBoyd collected $800 from the pot
*** SUMMARY ***
Total pot $800 | Rake $0
Seat 1: DeepStack (button) (small blind) folded before the Flop
Seat 2: Dutch_@DutchBoyd (big blind) collected ($800)

PokerStars Hand #7000100025: Tournament #2, Apr13_2017-at-16_41_56 Hold'em No Limit ($100/$200 USD) - 2017/04/13 18:42:20 ET
Table 'ACPC Match' 2-max Seat #2 is the button
Seat 1: DeepStack ($14300 in chips)
Seat 2: Dutch_@DutchBoyd ($25700 in chips)
Dutch_@DutchBoyd: posts small blind $100
DeepStack: posts big blind $200
*** HOLE CARDS ***
Dealt to DeepStack [Js 7h]
Dealt to Dutch_@DutchBoyd [Ad 3s]
Dutch_@DutchBoyd: raises $25500 to $25700 and is all-in
DeepStack: folds
Uncalled bet ($25500) returned to Dutch_@DutchBoyd
Dutch_@DutchBoyd collected $400 from the pot
*** SUMMARY ***
Total pot $400 | Rake $0
Seat 1: DeepStack (big blind) folded before the Flop
Seat 2: Dutch_@DutchBoyd (button) (small blind) collected ($400)

PokerStars Hand #7000100026: Tournament #2, Apr13_2017-at-16_41_56 Hold'em No Limit ($100/$200 USD) - 2017/04/13 18:42:21 ET
Table 'ACPC Match' 2-max Seat #1 is the button
Seat 1: DeepStack ($14100 in chips)
Seat 2: Dutch_@DutchBoyd ($25900 in chips)
DeepStack: posts small blind $100
Dutch_@DutchBoyd: posts big blind $200
*** HOLE CARDS ***
Dealt to DeepStack [Ts 4h]
Dealt to Dutch_@DutchBoyd [3s Jc]
DeepStack: calls $100
Dutch_@DutchBoyd: raises $25700 to $25900 and is all-in
DeepStack: folds
Uncalled bet ($25700) returned to Dutch_@DutchBoyd
Dutch_@DutchBoyd collected $400 from the pot
*** SUMMARY ***
Total pot $400 | Rake $0
Seat 1: DeepStack (button) (small blind) folded before the Flop
Seat 2: Dutch_@DutchBoyd (big blind) collected ($400)

PokerStars Hand #7000100027: Tournament #2, Apr13_2017-at-16_41_56 Hold'em No Limit ($100/$200 USD) - 2017/04/13 18:42:22 ET
Table 'ACPC Match' 2-max Seat #2 is the button
Seat 1: DeepStack ($13900 in chips)
Seat 2: Dutch_@DutchBoyd ($26100 in chips)
Dutch_@DutchBoyd: posts small blind $100
DeepStack: posts big blind $200
*** HOLE CARDS ***
Dealt to DeepStack [Kc 6c]
Dealt to Dutch_@DutchBoyd [3h Qc]
Dutch_@DutchBoyd: raises $25900 to $26100 and is all-in
DeepStack: folds
Uncalled bet ($25900) returned to Dutch_@DutchBoyd
Dutch_@DutchBoyd collected $400 from the pot
*** SUMMARY ***
Total pot $400 | Rake $0
Seat 1: DeepStack (big blind) folded before the Flop
Seat 2: Dutch_@DutchBoyd (button) (small blind) collected ($400)

PokerStars Hand #7000100028: Tournament #2, Apr13_2017-at-16_41_56 Hold'em No Limit ($100/$200 USD) - 2017/04/13 18:42:23 ET
Table 'ACPC Match' 2-max Seat #1 is the button
Seat 1: DeepStack ($13700 in chips)
Seat 2: Dutch_@DutchBoyd ($26300 in chips)
DeepStack: posts small blind $100
Dutch_@DutchBoyd: posts big blind $200
*** HOLE CARDS ***
Dealt to DeepStack [Tc 6h]
Dealt to Dutch_@DutchBoyd [6s Kh]
DeepStack: raises $400 to $600
Dutch_@DutchBoyd: raises $25700 to $26300 and is all-in
DeepStack: folds
Uncalled bet ($25700) returned to Dutch_@DutchBoyd
Dutch_@DutchBoyd collected $1200 from the pot
*** SUMMARY ***
Total pot $1200 | Rake $0
Seat 1: DeepStack (button) (small blind) folded before the Flop
Seat 2: Dutch_@DutchBoyd (big blind) collected ($1200)

PokerStars Hand #7000100029: Tournament #2, Apr13_2017-at-16_41_56 Hold'em No Limit ($100/$200 USD) - 2017/04/13 18:42:24 ET
Table 'ACPC Match' 2-max Seat #2 is the button
Seat 1: DeepStack ($13100 in chips)
Seat 2: Dutch_@DutchBoyd ($26900 in chips)
Dutch_@DutchBoyd: posts small blind $100
DeepStack: posts big blind $200
*** HOLE CARDS ***
Dealt to DeepStack [6h Kd]
Dealt to Dutch_@DutchBoyd [Ah 5c]
Dutch_@DutchBoyd: raises $26700 to $26900 and is all-in
DeepStack: folds
Uncalled bet ($26700) returned to Dutch_@DutchBoyd
Dutch_@DutchBoyd collected $400 from the pot
*** SUMMARY ***
Total pot $400 | Rake $0
Seat 1: DeepStack (big blind) folded before the Flop
Seat 2: Dutch_@DutchBoyd (button) (small blind) collected ($400)

PokerStars Hand #7000100030: Tournament #2, Apr13_2017-at-16_41_56 Hold'em No Limit ($100/$200 USD) - 2017/04/13 18:42:25 ET
Table 'ACPC Match' 2-max Seat #1 is the button
Seat 1: DeepStack ($12900 in chips)
Seat 2: Dutch_@DutchBoyd ($27100 in chips)
DeepStack: posts small blind $100
Dutch_@DutchBoyd: posts big blind $200
*** HOLE CARDS ***
Dealt to DeepStack [Kd 3h]
Dealt to Dutch_@DutchBoyd [9d 9c]
DeepStack: calls $100
Dutch_@DutchBoyd: raises $200 to $400
DeepStack: calls $200
*** FLOP **** [6c Jd Ac]
Dutch_@DutchBoyd: checks
DeepStack: checks
*** TURN **** [5h]
Dutch_@DutchBoyd: checks
DeepStack: checks
*** RIVER **** [4c]
Dutch_@DutchBoyd: bets $222
DeepStack: folds
Uncalled bet ($222) returned to Dutch_@DutchBoyd
Dutch_@DutchBoyd collected $800 from the pot
*** SUMMARY ***
Total pot $800 | Rake $0
Board [6c Jd Ac 5h 4c]
Seat 1: DeepStack (button) (small blind) folded on the River
Seat 2: Dutch_@DutchBoyd (big blind) collected ($800)

PokerStars Hand #7000100031: Tournament #2, Apr13_2017-at-16_41_56 Hold'em No Limit ($150/$300 USD) - 2017/04/13 18:42:26 ET
Table 'ACPC Match' 2-max Seat #2 is the button
Seat 1: DeepStack ($12500 in chips)
Seat 2: Dutch_@DutchBoyd ($27500 in chips)
Dutch_@DutchBoyd: posts small blind $150
DeepStack: posts big blind $300
*** HOLE CARDS ***
Dealt to DeepStack [4d 7c]
Dealt to Dutch_@DutchBoyd [8d Qs]
Dutch_@DutchBoyd: raises $300 to $600
DeepStack: calls $300
*** FLOP **** [4c 5h 6d]
DeepStack: checks
Dutch_@DutchBoyd: raises $600 to $600
DeepStack: calls $600
*** TURN **** [5c]
DeepStack: checks
Dutch_@DutchBoyd: checks
*** RIVER **** [As]
DeepStack: checks
Dutch_@DutchBoyd: checks
*** SHOW DOWN ***
DeepStack: shows [4d 7c] (two pair, Fives and Fours)
Dutch_@DutchBoyd: shows [8d Qs] (a pair of Fives)
DeepStack collected $2400 from pot
*** SUMMARY ***
Total pot $2400 | Rake $0
Board [4c 5h 6d 5c As]
Seat 1: DeepStack (big blind) showed [4d 7c] and won ($2400) with two pair, Fives and Fours
Seat 2: Dutch_@DutchBoyd (button) (small blind) showed [8d Qs] and lost with a pair of Fives

PokerStars Hand #7000100032: Tournament #2, Apr13_2017-at-16_41_56 Hold'em No Limit ($150/$300 USD) - 2017/04/13 18:42:27 ET
Table 'ACPC Match' 2-max Seat #1 is the button
Seat 1: DeepStack ($13700 in chips)
Seat 2: Dutch_@DutchBoyd ($26300 in chips)
DeepStack: posts small blind $150
Dutch_@DutchBoyd: posts big blind $300
*** HOLE CARDS ***
Dealt to DeepStack [Ad As]
Dealt to Dutch_@DutchBoyd [9c Jd]
DeepStack: raises $300 to $600
Dutch_@DutchBoyd: calls $300
*** FLOP **** [Th 3s Kd]
Dutch_@DutchBoyd: checks
DeepStack: raises $600 to $600
Dutch_@DutchBoyd: folds
Uncalled bet ($600) returned to DeepStack
DeepStack collected $1200 from the pot
*** SUMMARY ***
Total pot $1200 | Rake $0
Board [Th 3s Kd]
Seat 1: DeepStack (button) (small blind) collected ($1200)
Seat 2: Dutch_@DutchBoyd (big blind) folded on the Flop

PokerStars Hand #7000100033: Tournament #2, Apr13_2017-at-16_41_56 Hold'em No Limit ($150/$300 USD) - 2017/04/13 18:42:28 ET
Table 'ACPC Match' 2-max Seat #2 is the button
Seat 1: DeepStack ($14300 in chips)
Seat 2: Dutch_@DutchBoyd ($25700 in chips)
Dutch_@DutchBoyd: posts small blind $150
DeepStack: posts big blind $300
*** HOLE CARDS ***
Dealt to DeepStack [5s 8d]
Dealt to Dutch_@DutchBoyd [5c 7c]
Dutch_@DutchBoyd: raises $300 to $600
DeepStack: calls $300
*** FLOP **** [8c 3c 4h]
DeepStack: checks
Dutch_@DutchBoyd: raises $600 to $600
DeepStack: raises $2400 to $3000
Dutch_@DutchBoyd: raises $22100 to $25100 and is all-in
DeepStack: folds
Uncalled bet ($22100) returned to Dutch_@DutchBoyd
Dutch_@DutchBoyd collected $7200 from the pot
*** SUMMARY ***
Total pot $7200 | Rake $0
Board [8c 3c 4h]
Seat 1: DeepStack (big blind) folded on the Flop
Seat 2: Dutch_@DutchBoyd (button) (small blind) collected ($7200)

PokerStars Hand #7000100034: Tournament #2, Apr13_2017-at-16_41_56 Hold'em No Limit ($150/$300 USD) - 2017/04/13 18:42:29 ET
Table 'ACPC Match' 2-max Seat #1 is the button
Seat 1: DeepStack ($10700 in chips)
Seat 2: Dutch_@DutchBoyd ($29300 in chips)
DeepStack: posts small blind $150
Dutch_@DutchBoyd: posts big blind $300
*** HOLE CARDS ***
Dealt to DeepStack [6h 3d]
Dealt to Dutch_@DutchBoyd [7d Ah]
DeepStack: calls $150
Dutch_@DutchBoyd: raises $29000 to $29300 and is all-in
DeepStack: folds
Uncalled bet ($29000) returned to Dutch_@DutchBoyd
Dutch_@DutchBoyd collected $600 from the pot
*** SUMMARY ***
Total pot $600 | Rake $0
Seat 1: DeepStack (button) (small blind) folded before the Flop
Seat 2: Dutch_@DutchBoyd (big blind) collected ($600)

PokerStars Hand #7000100035: Tournament #2, Apr13_2017-at-16_41_56 Hold'em No Limit ($150/$300 USD) - 2017/04/13 18:42:30 ET
Table 'ACPC Match' 2-max Seat #2 is the button
Seat 1: DeepStack ($10400 in chips)
Seat 2: Dutch_@DutchBoyd ($29600 in chips)
Dutch_@DutchBoyd: posts small blind $150
DeepStack: posts big blind $300
*** HOLE CARDS ***
Dealt to DeepStack [4c Ts]
Dealt to Dutch_@DutchBoyd [6h Jc]
Dutch_@DutchBoyd: raises $300 to $600
DeepStack: folds
Uncalled bet ($300) returned to Dutch_@DutchBoyd
Dutch_@DutchBoyd collected $600 from the pot
*** SUMMARY ***
Total pot $600 | Rake $0
Seat 1: DeepStack (big blind) folded before the Flop
Seat 2: Dutch_@DutchBoyd (button) (small blind) collected ($600)

PokerStars Hand #7000100036: Tournament #2, Apr13_2017-at-16_41_56 Hold'em No Limit ($150/$300 USD) - 2017/04/13 18:42:31 ET
Table 'ACPC Match' 2-max Seat #1 is the button
Seat 1: DeepStack ($10100 in chips)
Seat 2: Dutch_@DutchBoyd ($29900 in chips)
DeepStack: posts small blind $150
Dutch_@DutchBoyd: posts big blind $300
*** HOLE CARDS ***
Dealt to DeepStack [6h 5h]
Dealt to Dutch_@DutchBoyd [5c 6c]
DeepStack: raises $300 to $600
Dutch_@DutchBoyd: calls $300
*** FLOP **** [Qc 3d Jh]
Dutch_@DutchBoyd: checks
DeepStack: raises $1200 to $1200
Dutch_@DutchBoyd: folds
Uncalled bet ($1200) returned to DeepStack
DeepStack collected $1200 from the pot
*** SUMMARY ***
Total pot $1200 | Rake $0
Board [Qc 3d Jh]
Seat 1: DeepStack (button) (small blind) collected ($1200)
Seat 2: Dutch_@DutchBoyd (big blind) folded on the Flop

PokerStars Hand #7000100037: Tournament #2, Apr13_2017-at-16_41_56 Hold'em No Limit ($150/$300 USD) - 2017/04/13 18:42:32 ET
Table 'ACPC Match' 2-max Seat #2 is the button
Seat 1: DeepStack ($10700 in chips)
Seat 2: Dutch_@DutchBoyd ($29300 in chips)
Dutch_@DutchBoyd: posts small blind $150
DeepStack: posts big blind $300
*** HOLE CARDS ***
Dealt to DeepStack [3h Qh]
Dealt to Dutch_@DutchBoyd [5h Js]
Dutch_@DutchBoyd: raises $300 to $600
DeepStack: calls $300
*** FLOP **** [9d As 9h]
DeepStack: checks
Dutch_@DutchBoyd: raises $600 to $600
DeepStack: calls $600
*** TURN **** [Jh]
DeepStack: checks
Dutch_@DutchBoyd: checks
*** RIVER **** [8h]
DeepStack: checks
Dutch_@DutchBoyd: checks
*** SHOW DOWN ***
DeepStack: shows [3h Qh] (flush, Queen high)
Dutch_@DutchBoyd: shows [5h Js] (two pair, Jacks and Nines)
DeepStack collected $2400 from pot
*** SUMMARY ***
Total pot $2400 | Rake $0
Board [9d As 9h Jh 8h]
Seat 1: DeepStack (big blind) showed [3h Qh] and won ($2400) with flush, Queen high
Seat 2: Dutch_@DutchBoyd (button) (small blind) showed [5h Js] and lost with two pair, Jacks and Nines

PokerStars Hand #7000100038: Tournament #2, Apr13_2017-at-16_41_56 Hold'em No Limit ($150/$300 USD) - 2017/04/13 18:42:33 ET
Table 'ACPC Match' 2-max Seat #1 is the button
Seat 1: DeepStack ($11900 in chips)
Seat 2: Dutch_@DutchBoyd ($28100 in chips)
DeepStack: posts small blind $150
Dutch_@DutchBoyd: posts big blind $300
*** HOLE CARDS ***
Dealt to DeepStack [Td Ad]
Dealt to Dutch_@DutchBoyd [Qd 3c]
DeepStack: raises $300 to $600
Dutch_@DutchBoyd: calls $300
*** FLOP **** [3d Qc 7s]
Dutch_@DutchBoyd: checks
DeepStack: checks
*** TURN **** [Ac]
Dutch_@DutchBoyd: checks
DeepStack: raises $1200 to $1200
Dutch_@DutchBoyd: raises $1200 to $2400
DeepStack: calls $1200
*** RIVER **** [Ah]
Dutch_@DutchBoyd: checks
DeepStack: raises $6000 to $6000
Dutch_@DutchBoyd: calls $6000
*** SHOW DOWN ***
DeepStack: shows [Td Ad] (three of a kind, Aces)
Dutch_@DutchBoyd: shows [Qd 3c] (two pair, Aces and Queens)
DeepStack collected $18000 from pot
*** SUMMARY ***
Total pot $18000 | Rake $0
Board [3d Qc 7s Ac Ah]
Seat 1: DeepStack (button) (small blind) showed [Td Ad] and won ($18000) with three of a kind, Aces
Seat 2: Dutch_@DutchBoyd (big blind) showed [Qd 3c] and lost with two pair, Aces and Queens

PokerStars Hand #7000100039: Tournament #2, Apr13_2017-at-16_41_56 Hold'em No Limit ($150/$300 USD) - 2017/04/13 18:42:34 ET
Table 'ACPC Match' 2-max Seat #2 is the button
Seat 1: DeepStack ($20900 in chips)
Seat 2: Dutch_@DutchBoyd ($19100 in chips)
Dutch_@DutchBoyd: posts small blind $150
DeepStack: posts big blind $300
*** HOLE CARDS ***
Dealt to DeepStack [4d 9s]
Dealt to Dutch_@DutchBoyd [Tc 2h]
Dutch_@DutchBoyd: raises $18800 to $19100 and is all-in
DeepStack: folds
Uncalled bet ($18800) returned to Dutch_@DutchBoyd
Dutch_@DutchBoyd collected $600 from the pot
*** SUMMARY ***
Total pot $600 | Rake $0
Seat 1: DeepStack (big blind) folded before the Flop
Seat 2: Dutch_@DutchBoyd (button) (small blind) collected ($600)

PokerStars Hand #7000100040: Tournament #2, Apr13_2017-at-16_41_56 Hold'em No Limit ($150/$300 USD) - 2017/04/13 18:42:35 ET
Table 'ACPC Match' 2-max Seat #1 is the button
Seat 1: DeepStack ($20600 in chips)
Seat 2: Dutch_@DutchBoyd ($19400 in chips)
DeepStack: posts small blind $150
Dutch_@DutchBoyd: posts big blind $300
*** HOLE CARDS ***
Dealt to DeepStack [Qc Ad]
Dealt to Dutch_@DutchBoyd [Js 2c]
DeepStack: raises $600 to $900
Dutch_@DutchBoyd: folds
Uncalled bet ($600) returned to DeepStack
DeepStack collected $600 from the pot
*** SUMMARY ***
Total pot $600 | Rake $0
Seat 1: DeepStack (button) (small blind) collected ($600)
Seat 2: Dutch_@DutchBoyd (big blind) folded before the Flop

PokerStars Hand #7000100041: Tournament #2, Apr13_2017-at-16_41_56 Hold'em No Limit ($200/$400 USD) - 2017/04/13 18:42:36 ET
Table 'ACPC Match' 2-max Seat #2 is the button
Seat 1: DeepStack ($20900 in chips)
Seat 2: Dutch_@DutchBoyd ($19100 in chips)
Dutch_@DutchBoyd: posts small blind $200
DeepStack: posts big blind $400
*** HOLE CARDS ***
Dealt to DeepStack [Td 3h]
Dealt to Dutch_@DutchBoyd [2c 5s]
Dutch_@DutchBoyd: raises $400 to $800
DeepStack: calls $400
*** FLOP **** [9s 3d 7c]
DeepStack: checks
Dutch_@DutchBoyd: checks
*** TURN **** [6d]
DeepStack: checks
Dutch_@DutchBoyd: checks
*** RIVER **** [Th]
DeepStack: checks
Dutch_@DutchBoyd: raises $1600 to $1600
DeepStack: calls $1600
*** SHOW DOWN ***
Dutch_@DutchBoyd: shows [2c 5s] (Ten high)
DeepStack: shows [Td 3h] (two pair, Tens and Threes)
DeepStack collected $4800 from pot
*** SUMMARY ***
Total pot $4800 | Rake $0
Board [9s 3d 7c 6d Th]
Seat 1: DeepStack (big blind) showed [Td 3h] and won ($4800) with two pair, Tens and Threes
Seat 2: Dutch_@DutchBoyd (button) (small blind) showed [2c 5s] and lost with Ten high

PokerStars Hand #7000100042: Tournament #2, Apr13_2017-at-16_41_56 Hold'em No Limit ($200/$400 USD) - 2017/04/13 18:42:37 ET
Table 'ACPC Match' 2-max Seat #1 is the button
Seat 1: DeepStack ($23300 in chips)
Seat 2: Dutch_@DutchBoyd ($16700 in chips)
DeepStack: posts small blind $200
Dutch_@DutchBoyd: posts big blind $400
*** HOLE CARDS ***
Dealt to DeepStack [2s Jc]
Dealt to Dutch_@DutchBoyd [3c 8s]
DeepStack: calls $200
Dutch_@DutchBoyd: raises $16300 to $16700 and is all-in
DeepStack: folds
Uncalled bet ($16300) returned to Dutch_@DutchBoyd
Dutch_@DutchBoyd collected $800 from the pot
*** SUMMARY ***
Total pot $800 | Rake $0
Seat 1: DeepStack (button) (small blind) folded before the Flop
Seat 2: Dutch_@DutchBoyd (big blind) collected ($800)

PokerStars Hand #7000100043: Tournament #2, Apr13_2017-at-16_41_56 Hold'em No Limit ($200/$400 USD) - 2017/04/13 18:42:38 ET
Table 'ACPC Match' 2-max Seat #2 is the button
Seat 1: DeepStack ($22900 in chips)
Seat 2: Dutch_@DutchBoyd ($17100 in chips)
Dutch_@DutchBoyd: posts small blind $200
DeepStack: posts big blind $400
*** HOLE CARDS ***
Dealt to DeepStack [Jc Jd]
Dealt to Dutch_@DutchBoyd [3c 8h]
Dutch_@DutchBoyd: raises $16700 to $17100 and is all-in
DeepStack: calls $16700
*** FLOP **** [Th Qs 5d]
*** TURN **** [3s]
*** RIVER **** [3h]
*** SHOW DOWN ***
Dutch_@DutchBoyd: shows [3c 8h] (three of a kind, Threes)
DeepStack: shows [Jc Jd] (two pair, Jacks and Threes)
Dutch_@DutchBoyd collected $34200 from pot
*** SUMMARY ***
Total pot $34200 | Rake $0
Board [Th Qs 5d 3s 3h]
Seat 1: DeepStack (big blind) showed [Jc Jd] and lost with two pair, Jacks and Threes
Seat 2: Dutch_@DutchBoyd (button) (small blind) showed [3c 8h] and won ($34200) with three of a kind, Threes

PokerStars Hand #7000100044: Tournament #2, Apr13_2017-at-16_41_56 Hold'em No Limit ($200/$400 USD) - 2017/04/13 18:42:39 ET
Table 'ACPC Match' 2-max Seat #1 is the button
Seat 1: DeepStack ($5800 in chips)
Seat 2: Dutch_@DutchBoyd ($34200 in chips)
DeepStack: posts small blind $200
Dutch_@DutchBoyd: posts big blind $400
*** HOLE CARDS ***
Dealt to DeepStack [Ks Ts]
Dealt to Dutch_@DutchBoyd [5h Ac]
DeepStack: raises $400 to $800
Dutch_@DutchBoyd: raises $33400 to $34200 and is all-in
DeepStack: calls $5000 and is all-in
Uncalled bet ($28400) returned to Dutch_@DutchBoyd
*** FLOP **** [6h Jh Tc]
*** TURN **** [Kc]
*** RIVER **** [5c]
*** SHOW DOWN ***
Dutch_@DutchBoyd: shows [5h Ac] (a pair of Fives)
DeepStack: shows [Ks Ts] (two pair, Kings and Tens)
DeepStack collected $11600 from pot
*** SUMMARY ***
Total pot $11600 | Rake $0
Board [6h Jh Tc Kc 5c]
Seat 1: DeepStack (button) (small blind) showed [Ks Ts] and won ($11600) with two pair, Kings and Tens
Seat 2: Dutch_@DutchBoyd (big blind) showed [5h Ac] and lost with a pair of Fives

PokerStars Hand #7000100045: Tournament #2, Apr13_2017-at-16_41_56 Hold'em No Limit ($200/$400 USD) - 2017/04/13 18:42:40 ET
Table 'ACPC Match' 2-max Seat #2 is the button
Seat 1: DeepStack ($11600 in chips)
Seat 2: Dutch_@DutchBoyd ($28400 in chips)
Dutch_@DutchBoyd: posts small blind $200
DeepStack: posts big blind $400
*** HOLE CARDS ***
Dealt to DeepStack [2c Ts]
Dealt to Dutch_@DutchBoyd [6s Ad]
Dutch_@DutchBoyd: raises $400 to $800
DeepStack: folds
Uncalled bet ($400) returned to Dutch_@DutchBoyd
Dutch_@DutchBoyd collected $800 from the pot
*** SUMMARY ***
Total pot $800 | Rake $0
Seat 1: DeepStack (big blind) folded before the Flop
Seat 2: Dutch_@DutchBoyd (button) (small blind) collected ($800)

PokerStars Hand #7000100046: Tournament #2, Apr13_2017-at-16_41_56 Hold'em No Limit ($200/$400 USD) - 2017/04/13 18:42:41 ET
Table 'ACPC Match' 2-max Seat #1 is the button
Seat 1: DeepStack ($11200 in chips)
Seat 2: Dutch_@DutchBoyd ($28800 in chips)
DeepStack: posts small blind $200
Dutch_@DutchBoyd: posts big blind $400
*** HOLE CARDS ***
Dealt to DeepStack [7s 4s]
Dealt to Dutch_@DutchBoyd [9d 8s]
DeepStack: calls $200
Dutch_@DutchBoyd: checks
*** FLOP **** [5s 6s Ks]
Dutch_@DutchBoyd: checks
DeepStack: raises $400 to $400
Dutch_@DutchBoyd: raises $1600 to $2000
DeepStack: calls $1600
*** TURN **** [As]
Dutch_@DutchBoyd: checks
DeepStack: checks
*** RIVER **** [7h]
Dutch_@DutchBoyd: bets $2400
DeepStack: calls $2400
*** SHOW DOWN ***
Dutch_@DutchBoyd: shows [9d 8s] (flush, Ace high)
DeepStack: shows [7s 4s] (flush, Ace high)
Dutch_@DutchBoyd collected $9600 from pot
*** SUMMARY ***
Total pot $9600 | Rake $0
Board [5s 6s Ks As 7h]
Seat 1: DeepStack (button) (small blind) showed [7s 4s] and lost with flush, Ace high
Seat 2: Dutch_@DutchBoyd (big blind) showed [9d 8s] and won ($9600) with flush, Ace high

PokerStars Hand #7000100047: Tournament #2, Apr13_2017-at-16_41_56 Hold'em No Limit ($200/$400 USD) - 2017/04/13 18:42:42 ET
Table 'ACPC Match' 2-max Seat #2 is the button
Seat 1: DeepStack ($6400 in chips)
Seat 2: Dutch_@DutchBoyd ($33600 in chips)
Dutch_@DutchBoyd: posts small blind $200
DeepStack: posts big blind $400
*** HOLE CARDS ***
Dealt to DeepStack [9c 8s]
Dealt to Dutch_@DutchBoyd [Qd Kh]
Dutch_@DutchBoyd: raises $400 to $800
DeepStack: calls $400
*** FLOP **** [7c 3d 4s]
DeepStack: checks
Dutch_@DutchBoyd: checks
*** TURN **** [Js]
DeepStack: checks
Dutch_@DutchBoyd: checks
*** RIVER **** [8d]
DeepStack: bets $800
Dutch_@DutchBoyd: folds
Uncalled bet ($800) returned to DeepStack
DeepStack collected $1600 from the pot
*** SUMMARY ***
Total pot $1600 | Rake $0
Board [7c 3d 4s Js 8d]
Seat 1: DeepStack (big blind) collected ($1600)
Seat 2: Dutch_@DutchBoyd (button) (small blind) folded on the River

PokerStars Hand #7000100048: Tournament #2, Apr13_2017-at-16_41_56 Hold'em No Limit ($200/$400 USD) - 2017/04/13 18:42:43 ET
Table 'ACPC Match' 2-max Seat #1 is the button
Seat 1: DeepStack ($7200 in chips)
Seat 2: Dutch_@DutchBoyd ($32800 in chips)
DeepStack: posts small blind $200
Dutch_@DutchBoyd: posts big blind $400
*** HOLE CARDS ***
Dealt to DeepStack [Jh 6c]
Dealt to Dutch_@DutchBoyd [Ks 3h]
DeepStack: calls $200
Dutch_@DutchBoyd: raises $32400 to $32800 and is all-in
DeepStack: folds
Uncalled bet ($32400) returned to Dutch_@DutchBoyd
Dutch_@DutchBoyd collected $800 from the pot
*** SUMMARY ***
Total pot $800 | Rake $0
Seat 1: DeepStack (button) (small blind) folded before the Flop
Seat 2: Dutch_@DutchBoyd (big blind) collected ($800)

PokerStars Hand #7000100049: Tournament #2, Apr13_2017-at-16_41_56 Hold'em No Limit ($200/$400 USD) - 2017/04/13 18:42:44 ET
Table 'ACPC Match' 2-max Seat #2 is the button
Seat 1: DeepStack ($6800 in chips)
Seat 2: Dutch_@DutchBoyd ($33200 in chips)
Dutch_@DutchBoyd: posts small blind $200
DeepStack: posts big blind $400
*** HOLE CARDS ***
Dealt to DeepStack [4d Qh]
Dealt to Dutch_@DutchBoyd [5c 3s]
Dutch_@DutchBoyd: raises $400 to $800
DeepStack: raises $1600 to $2400
Dutch_@DutchBoyd: folds
Uncalled bet ($1600) returned to DeepStack
DeepStack collected $1600 from the pot
*** SUMMARY ***
Total pot $1600 | Rake $0
Seat 1: DeepStack (big blind) collected ($1600)
Seat 2: Dutch_@DutchBoyd (button) (small blind) folded before the Flop

PokerStars Hand #7000100050: Tournament #2, Apr13_2017-at-16_41_56 Hold'em No Limit ($200/$400 USD) - 2017/04/13 18:42:45 ET
Table 'ACPC Match' 2-max Seat #1 is the button
Seat 1: DeepStack ($7600 in chips)
Seat 2: Dutch_@DutchBoyd ($32400 in chips)
DeepStack: posts small blind $200
Dutch_@DutchBoyd: posts big blind $400
*** HOLE CARDS ***
Dealt to DeepStack [Kh 5s]
Dealt to Dutch_@DutchBoyd [Qc Jh]
DeepStack: calls $200
Dutch_@DutchBoyd: raises $600 to $1000
DeepStack: raises $6600 to $7600 and is all-in
Dutch_@DutchBoyd: calls $6600
*** FLOP **** [Td 8h 2d]
*** TURN **** [8c]
*** RIVER **** [6c]
*** SHOW DOWN ***
DeepStack: shows [Kh 5s] (a pair of Eights)
Dutch_@DutchBoyd: shows [Qc Jh] (a pair of Eights)
DeepStack collected $15200 from pot
*** SUMMARY ***
Total pot $15200 | Rake $0
Board [Td 8h 2d 8c 6c]
Seat 1: DeepStack (button) (small blind) showed [Kh 5s] and won ($15200) with a pair of Eights
Seat 2: Dutch_@DutchBoyd (big blind) showed [Qc Jh] and lost with a pair of Eights

PokerStars Hand #7000100051: Tournament #2, Apr13_2017-at-16_41_56 Hold'em No Limit ($300/$600 USD) - 2017/04/13 18:42:46 ET
Table 'ACPC Match' 2-max Seat #2 is the button
Seat 1: DeepStack ($15200 in chips)
Seat 2: Dutch_@DutchBoyd ($24800 in chips)
Dutch_@DutchBoyd: posts small blind $300
DeepStack: posts big blind $600
*** HOLE CARDS ***
Dealt to DeepStack [9d 8h]
Dealt to Dutch_@DutchBoyd [5d Th]
Dutch_@DutchBoyd: raises $600 to $1200
DeepStack: calls $600
*** FLOP **** [8s 9c 8d]
DeepStack: checks
Dutch_@DutchBoyd: raises $1200 to $1200
DeepStack: calls $1200
*** TURN **** [3s]
DeepStack: checks
Dutch_@DutchBoyd: checks
*** RIVER **** [6h]
DeepStack: bets $2400
Dutch_@DutchBoyd: folds
Uncalled bet ($2400) returned to DeepStack
DeepStack collected $4800 from the pot
*** SUMMARY ***
Total pot $4800 | Rake $0
Board [8s 9c 8d 3s 6h]
Seat 1: DeepStack (big blind) collected ($4800)
Seat 2: Dutch_@DutchBoyd (button) (small blind) folded on the River

PokerStars Hand #7000100052: Tournament #2, Apr13_2017-at-16_41_56 Hold'em No Limit ($300/$600 USD) - 2017/04/13 18:42:47 ET
Table 'ACPC Match' 2-max Seat #1 is the button
Seat 1: DeepStack ($17600 in chips)
Seat 2: Dutch_@DutchBoyd ($22400 in chips)
DeepStack: posts small blind $300
Dutch_@DutchBoyd: posts big blind $600
*** HOLE CARDS ***
Dealt to DeepStack [8c Ts]
Dealt to Dutch_@DutchBoyd [Ah 7h]
DeepStack: raises $600 to $1200
Dutch_@DutchBoyd: raises $21200 to $22400 and is all-in
DeepStack: folds
Uncalled bet ($21200) returned to Dutch_@DutchBoyd
Dutch_@DutchBoyd collected $2400 from the pot
*** SUMMARY ***
Total pot $2400 | Rake $0
Seat 1: DeepStack (button) (small blind) folded before the Flop
Seat 2: Dutch_@DutchBoyd (big blind) collected ($2400)

PokerStars Hand #7000100053: Tournament #2, Apr13_2017-at-16_41_56 Hold'em No Limit ($300/$600 USD) - 2017/04/13 18:42:48 ET
Table 'ACPC Match' 2-max Seat #2 is the button
Seat 1: DeepStack ($16400 in chips)
Seat 2: Dutch_@DutchBoyd ($23600 in chips)
Dutch_@DutchBoyd: posts small blind $300
DeepStack: posts big blind $600
*** HOLE CARDS ***
Dealt to DeepStack [8c Qs]
Dealt to Dutch_@DutchBoyd [Qd 7h]
Dutch_@DutchBoyd: raises $600 to $1200
DeepStack: calls $600
*** FLOP **** [5c Ks Jh]
DeepStack: checks
Dutch_@DutchBoyd: raises $1200 to $1200
DeepStack: folds
Uncalled bet ($1200) returned to Dutch_@DutchBoyd
Dutch_@DutchBoyd collected $2400 from the pot
*** SUMMARY ***
Total pot $2400 | Rake $0
Board [5c Ks Jh]
Seat 1: DeepStack (big blind) folded on the Flop
Seat 2: Dutch_@DutchBoyd (button) (small blind) collected ($2400)

PokerStars Hand #7000100054: Tournament #2, Apr13_2017-at-16_41_56 Hold'em No Limit ($300/$600 USD) - 2017/04/13 18:42:49 ET
Table 'ACPC Match' 2-max Seat #1 is the button
Seat 1: DeepStack ($15200 in chips)
Seat 2: Dutch_@DutchBoyd ($24800 in chips)
DeepStack: posts small blind $300
Dutch_@DutchBoyd: posts big blind $600
*** HOLE CARDS ***
Dealt to DeepStack [Qd 2h]
Dealt to Dutch_@DutchBoyd [8d Kd]
DeepStack: calls $300
Dutch_@DutchBoyd: raises $24200 to $24800 and is all-in
DeepStack: folds
Uncalled bet ($24200) returned to Dutch_@DutchBoyd
Dutch_@DutchBoyd collected $1200 from the pot
*** SUMMARY ***
Total pot $1200 | Rake $0
Seat 1: DeepStack (button) (small blind) folded before the Flop
Seat 2: Dutch_@DutchBoyd (big blind) collected ($1200)

PokerStars Hand #7000100055: Tournament #2, Apr13_2017-at-16_41_56 Hold'em No Limit ($300/$600 USD) - 2017/04/13 18:42:50 ET
Table 'ACPC Match' 2-max Seat #2 is the button
Seat 1: DeepStack ($14600 in chips)
Seat 2: Dutch_@DutchBoyd ($25400 in chips)
Dutch_@DutchBoyd: posts small blind $300
DeepStack: posts big blind $600
*** HOLE CARDS ***
Dealt to DeepStack [9s 8c]
Dealt to Dutch_@DutchBoyd [Ks Tc]
Dutch_@DutchBoyd: raises $600 to $1200
DeepStack: calls $600
*** FLOP **** [Ac 3s Ts]
DeepStack: checks
Dutch_@DutchBoyd: raises $1200 to $1200
DeepStack: folds
Uncalled bet ($1200) returned to Dutch_@DutchBoyd
Dutch_@DutchBoyd collected $2400 from the pot
*** SUMMARY ***
Total pot $2400 | Rake $0
Board [Ac 3s Ts]
Seat 1: DeepStack (big blind) folded on the Flop
Seat 2: Dutch_@DutchBoyd (button) (small blind) collected ($2400)

PokerStars Hand #7000100056: Tournament #2, Apr13_2017-at-16_41_56 Hold'em No Limit ($300/$600 USD) - 2017/04/13 18:42:51 ET
Table 'ACPC Match' 2-max Seat #1 is the button
Seat 1: DeepStack ($13400 in chips)
Seat 2: Dutch_@DutchBoyd ($26600 in chips)
DeepStack: posts small blind $300
Dutch_@DutchBoyd: posts big blind $600
*** HOLE CARDS ***
Dealt to DeepStack [Th 5d]
Dealt to Dutch_@DutchBoyd [2s 9s]
DeepStack: calls $300
Dutch_@DutchBoyd: checks
*** FLOP **** [7h 5h 8s]
Dutch_@DutchBoyd: checks
DeepStack: checks
*** TURN **** [Ac]
Dutch_@DutchBoyd: checks
DeepStack: checks
*** RIVER **** [7c]
Dutch_@DutchBoyd: bets $600
DeepStack: calls $600
*** SHOW DOWN ***
Dutch_@DutchBoyd: shows [2s 9s] (a pair of Sevens)
DeepStack: shows [Th 5d] (two pair, Sevens and Fives)
DeepStack collected $2400 from pot
*** SUMMARY ***
Total pot $2400 | Rake $0
Board [7h 5h 8s Ac 7c]
Seat 1: DeepStack (button) (small blind) showed [Th 5d] and won ($2400) with two pair, Sevens and Fives
Seat 2: Dutch_@DutchBoyd (big blind) showed [2s 9s] and lost with a pair of Sevens

PokerStars Hand #7000100057: Tournament #2, Apr13_2017-at-16_41_56 Hold'em No Limit ($300/$600 USD) - 2017/04/13 18:42:52 ET
Table 'ACPC Match' 2-max Seat #2 is the button
Seat 1: DeepStack ($14600 in chips)
Seat 2: Dutch_@DutchBoyd ($25400 in chips)
Dutch_@DutchBoyd: posts small blind $300
DeepStack: posts big blind $600
*** HOLE CARDS ***
Dealt to DeepStack [7h 8h]
Dealt to Dutch_@DutchBoyd [4s 8d]
Dutch_@DutchBoyd: raises $600 to $1200
DeepStack: calls $600
*** FLOP **** [5s 4d 7d]
DeepStack: checks
Dutch_@DutchBoyd: raises $1200 to $1200
DeepStack: raises $2400 to $3600
Dutch_@DutchBoyd: calls $2400
*** TURN **** [9h]
DeepStack: bets $9800 and is all-in
Dutch_@DutchBoyd: folds
Uncalled bet ($9800) returned to DeepStack
DeepStack collected $9600 from the pot
*** SUMMARY ***
Total pot $9600 | Rake $0
Board [5s 4d 7d 9h]
Seat 1: DeepStack (big blind) collected ($9600)
Seat 2: Dutch_@DutchBoyd (button) (small blind) folded on the Turn

PokerStars Hand #7000100058: Tournament #2, Apr13_2017-at-16_41_56 Hold'em No Limit ($300/$600 USD) - 2017/04/13 18:42:53 ET
Table 'ACPC Match' 2-max Seat #1 is the button
Seat 1: DeepStack ($19400 in chips)
Seat 2: Dutch_@DutchBoyd ($20600 in chips)
DeepStack: posts small blind $300
Dutch_@DutchBoyd: posts big blind $600
*** HOLE CARDS ***
Dealt to DeepStack [Th Jh]
Dealt to Dutch_@DutchBoyd [2s 4s]
DeepStack: calls $300
Dutch_@DutchBoyd: checks
*** FLOP **** [Ts 7d 9h]
Dutch_@DutchBoyd: checks
DeepStack: raises $600 to $600
Dutch_@DutchBoyd: folds
Uncalled bet ($600) returned to DeepStack
DeepStack collected $1200 from the pot
*** SUMMARY ***
Total pot $1200 | Rake $0
Board [Ts 7d 9h]
Seat 1: DeepStack (button) (small blind) collected ($1200)
Seat 2: Dutch_@DutchBoyd (big blind) folded on the Flop

PokerStars Hand #7000100059: Tournament #2, Apr13_2017-at-16_41_56 Hold'em No Limit ($300/$600 USD) - 2017/04/13 18:42:54 ET
Table 'ACPC Match' 2-max Seat #2 is the button
Seat 1: DeepStack ($20000 in chips)
Seat 2: Dutch_@DutchBoyd ($20000 in chips)
Dutch_@DutchBoyd: posts small blind $300
DeepStack: posts big blind $600
*** HOLE CARDS ***
Dealt to DeepStack [Qh 6c]
Dealt to Dutch_@DutchBoyd [8d 9h]
Dutch_@DutchBoyd: raises $600 to $1200
DeepStack: calls $600
*** FLOP **** [5s 9s 6s]
DeepStack: checks
Dutch_@DutchBoyd: raises $1200 to $1200
DeepStack: calls $1200
*** TURN **** [4c]
DeepStack: checks
Dutch_@DutchBoyd: raises $3300 to $3300
DeepStack: folds
Uncalled bet ($3300) returned to Dutch_@DutchBoyd
Dutch_@DutchBoyd collected $4800 from the pot
*** SUMMARY ***
Total pot $4800 | Rake $0
Board [5s 9s 6s 4c]
Seat 1: DeepStack (big blind) folded on the Turn
Seat 2: Dutch_@DutchBoyd (button) (small blind) collected ($4800)

PokerStars Hand #7000100060: Tournament #2, Apr13_2017-at-16_41_56 Hold'em No Limit ($300/$600 USD) - 2017/04/13 18:42:55 ET
Table 'ACPC Match' 2-max Seat #1 is the button
Seat 1: DeepStack ($17600 in chips)
Seat 2: Dutch_@DutchBoyd ($22400 in chips)
DeepStack: posts small blind $300
Dutch_@DutchBoyd: posts big blind $600
*** HOLE CARDS ***
Dealt to DeepStack [Qs Kc]
Dealt to Dutch_@DutchBoyd [Js 5h]
DeepStack: raises $600 to $1200
Dutch_@DutchBoyd: calls $600
*** FLOP **** [8h 8c Ad]
Dutch_@DutchBoyd: checks
DeepStack: raises $1200 to $1200
Dutch_@DutchBoyd: folds
Uncalled bet ($1200) returned to DeepStack
DeepStack collected $2400 from the pot
*** SUMMARY ***
Total pot $2400 | Rake $0
Board [8h 8c Ad]
Seat 1: DeepStack (button) (small blind) collected ($2400)
Seat 2: Dutch_@DutchBoyd (big blind) folded on the Flop

PokerStars Hand #7000100061: Tournament #2, Apr13_2017-at-16_41_56 Hold'em No Limit ($400/$800 USD) - 2017/04/13 18:42:56 ET
Table 'ACPC Match' 2-max Seat #2 is the button
Seat 1: DeepStack ($18800 in chips)
Seat 2: Dutch_@DutchBoyd ($21200 in chips)
Dutch_@DutchBoyd: posts small blind $400
DeepStack: posts big blind $800
*** HOLE CARDS ***
Dealt to DeepStack [Ad 6d]
Dealt to Dutch_@DutchBoyd [Qs Qh]
Dutch_@DutchBoyd: raises $800 to $1600
DeepStack: calls $800
*** FLOP **** [Jd 7h 7s]
DeepStack: checks
Dutch_@DutchBoyd: raises $800 to $800
DeepStack: calls $800
*** TURN **** [Tc]
DeepStack: checks
Dutch_@DutchBoyd: raises $1600 to $1600
DeepStack: folds
Uncalled bet ($1600) returned to Dutch_@DutchBoyd
Dutch_@DutchBoyd collected $4800 from the pot
*** SUMMARY ***
Total pot $4800 | Rake $0
Board [Jd 7h 7s Tc]
Seat 1: DeepStack (big blind) folded on the Turn
Seat 2: Dutch_@DutchBoyd (button) (small blind) collected ($4800)

PokerStars Hand #7000100062: Tournament #2, Apr13_2017-at-16_41_56 Hold'em No Limit ($400/$800 USD) - 2017/04/13 18:42:57 ET
Table 'ACPC Match' 2-max Seat #1 is the button
Seat 1: DeepStack ($16400 in chips)
Seat 2: Dutch_@DutchBoyd ($23600 in chips)
DeepStack: posts small blind $400
Dutch_@DutchBoyd: posts big blind $800
*** HOLE CARDS ***
Dealt to DeepStack [4d 6s]
Dealt to Dutch_@DutchBoyd [9s Td]
DeepStack: calls $400
Dutch_@DutchBoyd: checks
*** FLOP **** [7h 5d 6d]
Dutch_@DutchBoyd: checks
DeepStack: raises $800 to $800
Dutch_@DutchBoyd: folds
Uncalled bet ($800) returned to DeepStack
DeepStack collected $1600 from the pot
*** SUMMARY ***
Total pot $1600 | Rake $0
Board [7h 5d 6d]
Seat 1: DeepStack (button) (small blind) collected ($1600)
Seat 2: Dutch_@DutchBoyd (big blind) folded on the Flop

PokerStars Hand #7000100063: Tournament #2, Apr13_2017-at-16_41_56 Hold'em No Limit ($400/$800 USD) - 2017/04/13 18:42:58 ET
Table 'ACPC Match' 2-max Seat #2 is the button
Seat 1: DeepStack ($17200 in chips)
Seat 2: Dutch_@DutchBoyd ($22800 in chips)
Dutch_@DutchBoyd: posts small blind $400
DeepStack: posts big blind $800
*** HOLE CARDS ***
Dealt to DeepStack [6c Jd]
Dealt to Dutch_@DutchBoyd [5h Qs]
Dutch_@DutchBoyd: raises $800 to $1600
DeepStack: calls $800
*** FLOP **** [9h 2h Qc]
DeepStack: checks
Dutch_@DutchBoyd: raises $800 to $800
DeepStack: folds
Uncalled bet ($800) returned to Dutch_@DutchBoyd
Dutch_@DutchBoyd collected $3200 from the pot
*** SUMMARY ***
Total pot $3200 | Rake $0
Board [9h 2h Qc]
Seat 1: DeepStack (big blind) folded on the Flop
Seat 2: Dutch_@DutchBoyd (button) (small blind) collected ($3200)

PokerStars Hand #7000100064: Tournament #2, Apr13_2017-at-16_41_56 Hold'em No Limit ($400/$800 USD) - 2017/04/13 18:42:59 ET
Table 'ACPC Match' 2-max Seat #1 is the button
Seat 1: DeepStack ($15600 in chips)
Seat 2: Dutch_@DutchBoyd ($24400 in chips)
DeepStack: posts small blind $400
Dutch_@DutchBoyd: posts big blind $800
*** HOLE CARDS ***
Dealt to DeepStack [Th Ac]
Dealt to Dutch_@DutchBoyd [3s 4h]
DeepStack: calls $400
Dutch_@DutchBoyd: checks
*** FLOP **** [9c 8s As]
Dutch_@DutchBoyd: checks
DeepStack: raises $1600 to $1600
Dutch_@DutchBoyd: folds
Uncalled bet ($1600) returned to DeepStack
DeepStack collected $1600 from the pot
*** SUMMARY ***
Total pot $1600 | Rake $0
Board [9c 8s As]
Seat 1: DeepStack (button) (small blind) collected ($1600)
Seat 2: Dutch_@DutchBoyd (big blind) folded on the Flop

PokerStars Hand #7000100065: Tournament #2, Apr13_2017-at-16_41_56 Hold'em No Limit ($400/$800 USD) - 2017/04/13 18:43:00 ET
Table 'ACPC Match' 2-max Seat #2 is the button
Seat 1: DeepStack ($16400 in chips)
Seat 2: Dutch_@DutchBoyd ($23600 in chips)
Dutch_@DutchBoyd: posts small blind $400
DeepStack: posts big blind $800
*** HOLE CARDS ***
Dealt to DeepStack [Js Qd]
Dealt to Dutch_@DutchBoyd [7d Qc]
Dutch_@DutchBoyd: raises $800 to $1600
DeepStack: calls $800
*** FLOP **** [9c Td 2d]
DeepStack: checks
Dutch_@DutchBoyd: checks
*** TURN **** [Ts]
DeepStack: checks
Dutch_@DutchBoyd: checks
*** RIVER **** [Ad]
DeepStack: checks
Dutch_@DutchBoyd: checks
*** SHOW DOWN ***
DeepStack: shows [Js Qd] (a pair of Tens)
Dutch_@DutchBoyd: shows [7d Qc] (a pair of Tens)
DeepStack collected $3200 from pot
*** SUMMARY ***
Total pot $3200 | Rake $0
Board [9c Td 2d Ts Ad]
Seat 1: DeepStack (big blind) showed [Js Qd] and won ($3200) with a pair of Tens
Seat 2: Dutch_@DutchBoyd (button) (small blind) showed [7d Qc] and lost with a pair of Tens

PokerStars Hand #7000100066: Tournament #2, Apr13_2017-at-16_41_56 Hold'em No Limit ($400/$800 USD) - 2017/04/13 18:43:01 ET
Table 'ACPC Match' 2-max Seat #1 is the button
Seat 1: DeepStack ($18000 in chips)
Seat 2: Dutch_@DutchBoyd ($22000 in chips)
DeepStack: posts small blind $400
Dutch_@DutchBoyd: posts big blind $800
*** HOLE CARDS ***
Dealt to DeepStack [Ks 3c]
Dealt to Dutch_@DutchBoyd [Ac 6h]
DeepStack: calls $400
Dutch_@DutchBoyd: raises $21200 to $22000 and is all-in
DeepStack: folds
Uncalled bet ($21200) returned to Dutch_@DutchBoyd
Dutch_@DutchBoyd collected $1600 from the pot
*** SUMMARY ***
Total pot $1600 | Rake $0
Seat 1: DeepStack (button) (small blind) folded before the Flop
Seat 2: Dutch_@DutchBoyd (big blind) collected ($1600)

PokerStars Hand #7000100067: Tournament #2, Apr13_2017-at-16_41_56 Hold'em No Limit ($400/$800 USD) - 2017/04/13 18:43:02 ET
Table 'ACPC Match' 2-max Seat #2 is the button
Seat 1: DeepStack ($17200 in chips)
Seat 2: Dutch_@DutchBoyd ($22800 in chips)
Dutch_@DutchBoyd: posts small blind $400
DeepStack: posts big blind $800
*** HOLE CARDS ***
Dealt to DeepStack [8s Tc]
Dealt to Dutch_@DutchBoyd [Qc Kd]
Dutch_@DutchBoyd: raises $800 to $1600
DeepStack: calls $800
*** FLOP **** [4s 7d 9h]
DeepStack: checks
Dutch_@DutchBoyd: raises $1600 to $1600
DeepStack: calls $1600
*** TURN **** [9d]
DeepStack: checks
Dutch_@DutchBoyd: checks
*** RIVER **** [3h]
DeepStack: checks
Dutch_@DutchBoyd: checks
*** SHOW DOWN ***
DeepStack: shows [8s Tc] (a pair of Nines)
Dutch_@DutchBoyd: shows [Qc Kd] (a pair of Nines)
Dutch_@DutchBoyd collected $6400 from pot
*** SUMMARY ***
Total pot $6400 | Rake $0
Board [4s 7d 9h 9d 3h]
Seat 1: DeepStack (big blind) showed [8s Tc] and lost with a pair of Nines
Seat 2: Dutch_@DutchBoyd (button) (small blind) showed [Qc Kd] and won ($6400) with a pair of Nines

PokerStars Hand #7000100068: Tournament #2, Apr13_2017-at-16_41_56 Hold'em No Limit ($400/$800 USD) - 2017/04/13 18:43:03 ET
Table 'ACPC Match' 2-max Seat #1 is the button
Seat 1: DeepStack ($14000 in chips)
Seat 2: Dutch_@DutchBoyd ($26000 in chips)
DeepStack: posts small blind $400
Dutch_@DutchBoyd: posts big blind $800
*** HOLE CARDS ***
Dealt to DeepStack [Ah Kh]
Dealt to Dutch_@DutchBoyd [Kc 3d]
DeepStack: calls $400
Dutch_@DutchBoyd: raises $25200 to $26000 and is all-in
DeepStack: calls $13200 and is all-in
Uncalled bet ($12000) returned to Dutch_@DutchBoyd
*** FLOP **** [7s Ts Jd]
*** TURN **** [Qc]
*** RIVER **** [5h]
*** SHOW DOWN ***
Dutch_@DutchBoyd: shows [Kc 3d] (King high)
DeepStack: shows [Ah Kh] (straight, Ace high)
DeepStack collected $28000 from pot
*** SUMMARY ***
Total pot $28000 | Rake $0
Board [7s Ts Jd Qc 5h]
Seat 1: DeepStack (button) (small blind) showed [Ah Kh] and won ($28000) with straight, Ace high
Seat 2: Dutch_@DutchBoyd (big blind) showed [Kc 3d] and lost with King high

PokerStars Hand #7000100069: Tournament #2, Apr13_2017-at-16_41_56 Hold'em No Limit ($400/$800 USD) - 2017/04/13 18:43:04 ET
Table 'ACPC Match' 2-max Seat #2 is the button
Seat 1: DeepStack ($28000 in chips)
Seat 2: Dutch_@DutchBoyd ($12000 in chips)
Dutch_@DutchBoyd: posts small blind $400
DeepStack: posts big blind $800
*** HOLE CARDS ***
Dealt to DeepStack [Ac Qh]
Dealt to Dutch_@DutchBoyd [6d Kd]
Dutch_@DutchBoyd: raises $800 to $1600
DeepStack: raises $10400 to $12000
Dutch_@DutchBoyd: folds
Uncalled bet ($10400) returned to DeepStack
DeepStack collected $3200 from the pot
*** SUMMARY ***
Total pot $3200 | Rake $0
Seat 1: DeepStack (big blind) collected ($3200)
Seat 2: Dutch_@DutchBoyd (button) (small blind) folded before the Flop

PokerStars Hand #7000100070: Tournament #2, Apr13_2017-at-16_41_56 Hold'em No Limit ($400/$800 USD) - 2017/04/13 18:43:05 ET
Table 'ACPC Match' 2-max Seat #1 is the button
Seat 1: DeepStack ($29600 in chips)
Seat 2: Dutch_@DutchBoyd ($10400 in chips)
DeepStack: posts small blind $400
Dutch_@DutchBoyd: posts big blind $800
*** HOLE CARDS ***
Dealt to DeepStack [Kd Kc]
Dealt to Dutch_@DutchBoyd [Qc 7s]
DeepStack: calls $400
Dutch_@DutchBoyd: raises $9600 to $10400 and is all-in
DeepStack: calls $9600
*** FLOP **** [Ks Jc 2d]
*** TURN **** [2c]
*** RIVER **** [9d]
*** SHOW DOWN ***
Dutch_@DutchBoyd: shows [Qc 7s] (a pair of Deuces)
DeepStack: shows [Kd Kc] (full house, Kings and Deuces)
DeepStack collected $20800 from pot
*** SUMMARY ***
Total pot $20800 | Rake $0
Board [Ks Jc 2d 2c 9d]
Seat 1: DeepStack (button) (small blind) showed [Kd Kc] and won ($20800) with full house, Kings and Deuces
Seat 2: Dutch_@DutchBoyd (big blind) showed [Qc 7s] and lost with a pair of Deuces
