PokerStars Hand #7000400001: Tournament #5, Apr13_2017-at-18_13_0 Hold'em No Limit ($50/$100 USD) - 2017/04/13 20:13:00 ET
Table 'ACPC Match' 2-max Seat #2 is the button
Seat 1: DeepStack ($20000 in chips)
Seat 2: Dutch_@DutchBoyd ($20000 in chips)
Dutch_@DutchBoyd: posts small blind $50
DeepStack: posts big blind $100
*** HOLE CARDS ***
Dealt to DeepStack [Qd 9d]
Dealt to Dutch_@DutchBoyd [8s 9c]
Dutch_@DutchBoyd: raises $100 to $200
DeepStack: raises $400 to $600
Dutch_@DutchBoyd: calls $400
*** FLOP **** [Ad Jd 2d]
DeepStack: bets $600
Dutch_@DutchBoyd: folds
Uncalled bet ($600) returned to DeepStack
DeepStack collected $1200 from the pot
*** SUMMARY ***
Total pot $1200 | Rake $0
Board [Ad Jd 2d]
Seat 1: DeepStack (big blind) collected ($1200)
Seat 2: Dutch_@DutchBoyd (button) (small blind) folded on the Flop

PokerStars Hand #7000400002: Tournament #5, Apr13_2017-at-18_13_0 Hold'em No Limit ($50/$100 USD) - 2017/04/13 20:13:01 ET
Table 'ACPC Match' 2-max Seat #1 is the button
Seat 1: DeepStack ($20600 in chips)
Seat 2: Dutch_@DutchBoyd ($19400 in chips)
DeepStack: posts small blind $50
Dutch_@DutchBoyd: posts big blind $100
*** HOLE CARDS ***
Dealt to DeepStack [4h 7s]
Dealt to Dutch_@DutchBoyd [5s 3s]
DeepStack: raises $200 to $300
Dutch_@DutchBoyd: calls $200
*** FLOP **** [Th 6h 7d]
Dutch_@DutchBoyd: checks
DeepStack: checks
*** TURN **** [Jc]
Dutch_@DutchBoyd: checks
DeepStack: checks
*** RIVER **** [Jd]
Dutch_@DutchBoyd: checks
DeepStack: raises $300 to $300
Dutch_@DutchBoyd: folds
Uncalled bet ($300) returned to DeepStack
DeepStack collected $600 from the pot
*** SUMMARY ***
Total pot $600 | Rake $0
Board [Th 6h 7d Jc Jd]
Seat 1: DeepStack (button) (small blind) collected ($600)
Seat 2: Dutch_@DutchBoyd (big blind) folded on the River

PokerStars Hand #7000400003: Tournament #5, Apr13_2017-at-18_13_0 Hold'em No Limit ($50/$100 USD) - 2017/04/13 20:13:02 ET
Table 'ACPC Match' 2-max Seat #2 is the button
Seat 1: DeepStack ($20900 in chips)
Seat 2: Dutch_@DutchBoyd ($19100 in chips)
Dutch_@DutchBoyd: posts small blind $50
DeepStack: posts big blind $100
*** HOLE CARDS ***
Dealt to DeepStack [Kd 7d]
Dealt to Dutch_@DutchBoyd [3c 9c]
Dutch_@DutchBoyd: raises $100 to $200
DeepStack: raises $400 to $600
Dutch_@DutchBoyd: calls $400
*** FLOP **** [Ah Qh 4d]
DeepStack: checks
Dutch_@DutchBoyd: checks
*** TURN **** [Td]
DeepStack: bets $1200
Dutch_@DutchBoyd: folds
Uncalled bet ($1200) returned to DeepStack
DeepStack collected $1200 from the pot
*** SUMMARY ***
Total pot $1200 | Rake $0
Board [Ah Qh 4d Td]
Seat 1: DeepStack (big blind) collected ($1200)
Seat 2: Dutch_@DutchBoyd (button) (small blind) folded on the Turn

PokerStars Hand #7000400004: Tournament #5, Apr13_2017-at-18_13_0 Hold'em No Limit ($50/$100 USD) - 2017/04/13 20:13:03 ET
Table 'ACPC Match' 2-max Seat #1 is the button
Seat 1: DeepStack ($21500 in chips)
Seat 2: Dutch_@DutchBoyd ($18500 in chips)
DeepStack: posts small blind $50
Dutch_@DutchBoyd: posts big blind $100
*** HOLE CARDS ***
Dealt to DeepStack [Td Kc]
Dealt to Dutch_@DutchBoyd [4c Qd]
DeepStack: calls $50
Dutch_@DutchBoyd: checks
*** FLOP **** [2d Tc Th]
Dutch_@DutchBoyd: checks
DeepStack: raises $100 to $100
Dutch_@DutchBoyd: calls $100
*** TURN **** [5h]
Dutch_@DutchBoyd: checks
DeepStack: raises $400 to $400
Dutch_@DutchBoyd: folds
Uncalled bet ($400) returned to DeepStack
DeepStack collected $400 from the pot
*** SUMMARY ***
Total pot $400 | Rake $0
Board [2d Tc Th 5h]
Seat 1: DeepStack (button) (small blind) collected ($400)
Seat 2: Dutch_@DutchBoyd (big blind) folded on the Turn

PokerStars Hand #7000400005: Tournament #5, Apr13_2017-at-18_13_0 Hold'em No Limit ($50/$100 USD) - 2017/04/13 20:13:04 ET
Table 'ACPC Match' 2-max Seat #2 is the button
Seat 1: DeepStack ($21700 in chips)
Seat 2: Dutch_@DutchBoyd ($18300 in chips)
Dutch_@DutchBoyd: posts small blind $50
DeepStack: posts big blind $100
*** HOLE CARDS ***
Dealt to DeepStack [9d Ac]
Dealt to Dutch_@DutchBoyd [2h Qs]
Dutch_@DutchBoyd: raises $100 to $200
DeepStack: calls $100
*** FLOP **** [4c 6h 3c]
DeepStack: checks
Dutch_@DutchBoyd: checks
*** TURN **** [3d]
DeepStack: checks
Dutch_@DutchBoyd: raises $200 to $200
DeepStack: calls $200
*** RIVER **** [Ts]
DeepStack: checks
Dutch_@DutchBoyd: checks
*** SHOW DOWN ***
DeepStack: shows [9d Ac] (a pair of Threes)
Dutch_@DutchBoyd: shows [2h Qs] (a pair of Threes)
DeepStack collected $800 from pot
*** SUMMARY ***
Total pot $800 | Rake $0
Board [4c 6h 3c 3d Ts]
Seat 1: DeepStack (big blind) showed [9d Ac] and won ($800) with a pair of Threes
Seat 2: Dutch_@DutchBoyd (button) (small blind) showed [2h Qs] and lost with a pair of Threes

PokerStars Hand #7000400006: Tournament #5, Apr13_2017-at-18_13_0 Hold'em No Limit ($50/$100 USD) - 2017/04/13 20:13:05 ET
Table 'ACPC Match' 2-max Seat #1 is the button
Seat 1: DeepStack ($22100 in chips)
Seat 2: Dutch_@DutchBoyd ($17900 in chips)
DeepStack: posts small blind $50
Dutch_@DutchBoyd: posts big blind $100
*** HOLE CARDS ***
Dealt to DeepStack [6d 7s]
Dealt to Dutch_@DutchBoyd [4d Qc]
DeepStack: raises $200 to $300
Dutch_@DutchBoyd: folds
Uncalled bet ($200) returned to DeepStack
DeepStack collected $200 from the pot
*** SUMMARY ***
Total pot $200 | Rake $0
Seat 1: DeepStack (button) (small blind) collected ($200)
Seat 2: Dutch_@DutchBoyd (big blind) folded before the Flop

PokerStars Hand #7000400007: Tournament #5, Apr13_2017-at-18_13_0 Hold'em No Limit ($50/$100 USD) - 2017/04/13 20:13:06 ET
Table 'ACPC Match' 2-max Seat #2 is the button
Seat 1: DeepStack ($22200 in chips)
Seat 2: Dutch_@DutchBoyd ($17800 in chips)
Dutch_@DutchBoyd: posts small blind $50
DeepStack: posts big blind $100
*** HOLE CARDS ***
Dealt to DeepStack [3c Ad]
Dealt to Dutch_@DutchBoyd [Td 5h]
Dutch_@DutchBoyd: raises $100 to $200
DeepStack: calls $100
*** FLOP **** [7h Ah Kc]
DeepStack: checks
Dutch_@DutchBoyd: raises $200 to $200
DeepStack: calls $200
*** TURN **** [8s]
DeepStack: checks
Dutch_@DutchBoyd: checks
*** RIVER **** [Kh]
DeepStack: bets $400
Dutch_@DutchBoyd: folds
Uncalled bet ($400) returned to DeepStack
DeepStack collected $800 from the pot
*** SUMMARY ***
Total pot $800 | Rake $0
Board [7h Ah Kc 8s Kh]
Seat 1: DeepStack (big blind) collected ($800)
Seat 2: Dutch_@DutchBoyd (button) (small blind) folded on the River

PokerStars Hand #7000400008: Tournament #5, Apr13_2017-at-18_13_0 Hold'em No Limit ($50/$100 USD) - 2017/04/13 20:13:07 ET
Table 'ACPC Match' 2-max Seat #1 is the button
Seat 1: DeepStack ($22600 in chips)
Seat 2: Dutch_@DutchBoyd ($17400 in chips)
DeepStack: posts small blind $50
Dutch_@DutchBoyd: posts big blind $100
*** HOLE CARDS ***
Dealt to DeepStack [Qc Js]
Dealt to Dutch_@DutchBoyd [8c 6c]
DeepStack: calls $50
Dutch_@DutchBoyd: checks
*** FLOP **** [Kh 2c Kc]
Dutch_@DutchBoyd: bets $150
DeepStack: calls $150
*** TURN **** [Jc]
Dutch_@DutchBoyd: bets $250
DeepStack: raises $500 to $750
Dutch_@DutchBoyd: calls $500
*** RIVER **** [5c]
Dutch_@DutchBoyd: checks
DeepStack: checks
*** SHOW DOWN ***
Dutch_@DutchBoyd: shows [8c 6c] (flush, King high)
DeepStack: shows [Qc Js] (flush, King high)
DeepStack collected $2000 from pot
*** SUMMARY ***
Total pot $2000 | Rake $0
Board [Kh 2c Kc Jc 5c]
Seat 1: DeepStack (button) (small blind) showed [Qc Js] and won ($2000) with flush, King high
Seat 2: Dutch_@DutchBoyd (big blind) showed [8c 6c] and lost with flush, King high

PokerStars Hand #7000400009: Tournament #5, Apr13_2017-at-18_13_0 Hold'em No Limit ($50/$100 USD) - 2017/04/13 20:13:08 ET
Table 'ACPC Match' 2-max Seat #2 is the button
Seat 1: DeepStack ($23600 in chips)
Seat 2: Dutch_@DutchBoyd ($16400 in chips)
Dutch_@DutchBoyd: posts small blind $50
DeepStack: posts big blind $100
*** HOLE CARDS ***
Dealt to DeepStack [8s 8c]
Dealt to Dutch_@DutchBoyd [7s 6d]
Dutch_@DutchBoyd: raises $100 to $200
DeepStack: raises $400 to $600
Dutch_@DutchBoyd: calls $400
*** FLOP **** [7h 8d Kh]
DeepStack: bets $600
Dutch_@DutchBoyd: folds
Uncalled bet ($600) returned to DeepStack
DeepStack collected $1200 from the pot
*** SUMMARY ***
Total pot $1200 | Rake $0
Board [7h 8d Kh]
Seat 1: DeepStack (big blind) collected ($1200)
Seat 2: Dutch_@DutchBoyd (button) (small blind) folded on the Flop

PokerStars Hand #7000400010: Tournament #5, Apr13_2017-at-18_13_0 Hold'em No Limit ($50/$100 USD) - 2017/04/13 20:13:09 ET
Table 'ACPC Match' 2-max Seat #1 is the button
Seat 1: DeepStack ($24200 in chips)
Seat 2: Dutch_@DutchBoyd ($15800 in chips)
DeepStack: posts small blind $50
Dutch_@DutchBoyd: posts big blind $100
*** HOLE CARDS ***
Dealt to DeepStack [Kd Qd]
Dealt to Dutch_@DutchBoyd [As Ah]
DeepStack: raises $200 to $300
Dutch_@DutchBoyd: raises $300 to $600
DeepStack: calls $300
*** FLOP **** [6h 2h 6s]
Dutch_@DutchBoyd: bets $100
DeepStack: calls $100
*** TURN **** [4d]
Dutch_@DutchBoyd: bets $700
DeepStack: calls $700
*** RIVER **** [Ks]
Dutch_@DutchBoyd: bets $1400
DeepStack: raises $2800 to $4200
Dutch_@DutchBoyd: raises $5600 to $9800
DeepStack: folds
Uncalled bet ($5600) returned to Dutch_@DutchBoyd
Dutch_@DutchBoyd collected $11200 from the pot
*** SUMMARY ***
Total pot $11200 | Rake $0
Board [6h 2h 6s 4d Ks]
Seat 1: DeepStack (button) (small blind) folded on the River
Seat 2: Dutch_@DutchBoyd (big blind) collected ($11200)

PokerStars Hand #7000400011: Tournament #5, Apr13_2017-at-18_13_0 Hold'em No Limit ($75/$150 USD) - 2017/04/13 20:13:10 ET
Table 'ACPC Match' 2-max Seat #2 is the button
Seat 1: DeepStack ($18600 in chips)
Seat 2: Dutch_@DutchBoyd ($21400 in chips)
Dutch_@DutchBoyd: posts small blind $75
DeepStack: posts big blind $150
*** HOLE CARDS ***
Dealt to DeepStack [6h 8d]
Dealt to Dutch_@DutchBoyd [7c 4s]
Dutch_@DutchBoyd: raises $150 to $300
DeepStack: calls $150
*** FLOP **** [Jd 8c Tc]
DeepStack: checks
Dutch_@DutchBoyd: checks
*** TURN **** [9h]
DeepStack: checks
Dutch_@DutchBoyd: raises $300 to $300
DeepStack: folds
Uncalled bet ($300) returned to Dutch_@DutchBoyd
Dutch_@DutchBoyd collected $600 from the pot
*** SUMMARY ***
Total pot $600 | Rake $0
Board [Jd 8c Tc 9h]
Seat 1: DeepStack (big blind) folded on the Turn
Seat 2: Dutch_@DutchBoyd (button) (small blind) collected ($600)

PokerStars Hand #7000400012: Tournament #5, Apr13_2017-at-18_13_0 Hold'em No Limit ($75/$150 USD) - 2017/04/13 20:13:11 ET
Table 'ACPC Match' 2-max Seat #1 is the button
Seat 1: DeepStack ($18300 in chips)
Seat 2: Dutch_@DutchBoyd ($21700 in chips)
DeepStack: posts small blind $75
Dutch_@DutchBoyd: posts big blind $150
*** HOLE CARDS ***
Dealt to DeepStack [7c 8c]
Dealt to Dutch_@DutchBoyd [Kd 2c]
DeepStack: raises $300 to $450
Dutch_@DutchBoyd: folds
Uncalled bet ($300) returned to DeepStack
DeepStack collected $300 from the pot
*** SUMMARY ***
Total pot $300 | Rake $0
Seat 1: DeepStack (button) (small blind) collected ($300)
Seat 2: Dutch_@DutchBoyd (big blind) folded before the Flop

PokerStars Hand #7000400013: Tournament #5, Apr13_2017-at-18_13_0 Hold'em No Limit ($75/$150 USD) - 2017/04/13 20:13:12 ET
Table 'ACPC Match' 2-max Seat #2 is the button
Seat 1: DeepStack ($18450 in chips)
Seat 2: Dutch_@DutchBoyd ($21550 in chips)
Dutch_@DutchBoyd: posts small blind $75
DeepStack: posts big blind $150
*** HOLE CARDS ***
Dealt to DeepStack [4d 2s]
Dealt to Dutch_@DutchBoyd [Qh 8s]
Dutch_@DutchBoyd: raises $150 to $300
DeepStack: folds
Uncalled bet ($150) returned to Dutch_@DutchBoyd
Dutch_@DutchBoyd collected $300 from the pot
*** SUMMARY ***
Total pot $300 | Rake $0
Seat 1: DeepStack (big blind) folded before the Flop
Seat 2: Dutch_@DutchBoyd (button) (small blind) collected ($300)

PokerStars Hand #7000400014: Tournament #5, Apr13_2017-at-18_13_0 Hold'em No Limit ($75/$150 USD) - 2017/04/13 20:13:13 ET
Table 'ACPC Match' 2-max Seat #1 is the button
Seat 1: DeepStack ($18300 in chips)
Seat 2: Dutch_@DutchBoyd ($21700 in chips)
DeepStack: posts small blind $75
Dutch_@DutchBoyd: posts big blind $150
*** HOLE CARDS ***
Dealt to DeepStack [6d Tc]
Dealt to Dutch_@DutchBoyd [Qd 5d]
DeepStack: raises $300 to $450
Dutch_@DutchBoyd: calls $300
*** FLOP **** [Jc Ad 4s]
Dutch_@DutchBoyd: bets $450
DeepStack: folds
Uncalled bet ($450) returned to Dutch_@DutchBoyd
Dutch_@DutchBoyd collected $900 from the pot
*** SUMMARY ***
Total pot $900 | Rake $0
Board [Jc Ad 4s]
Seat 1: DeepStack (button) (small blind) folded on the Flop
Seat 2: Dutch_@DutchBoyd (big blind) collected ($900)

PokerStars Hand #7000400015: Tournament #5, Apr13_2017-at-18_13_0 Hold'em No Limit ($75/$150 USD) - 2017/04/13 20:13:14 ET
Table 'ACPC Match' 2-max Seat #2 is the button
Seat 1: DeepStack ($17850 in chips)
Seat 2: Dutch_@DutchBoyd ($22150 in chips)
Dutch_@DutchBoyd: posts small blind $75
DeepStack: posts big blind $150
*** HOLE CARDS ***
Dealt to DeepStack [3c Jh]
Dealt to Dutch_@DutchBoyd [2h 9h]
Dutch_@DutchBoyd: raises $150 to $300
DeepStack: calls $150
*** FLOP **** [Td 9s 5c]
DeepStack: checks
Dutch_@DutchBoyd: raises $300 to $300
DeepStack: folds
Uncalled bet ($300) returned to Dutch_@DutchBoyd
Dutch_@DutchBoyd collected $600 from the pot
*** SUMMARY ***
Total pot $600 | Rake $0
Board [Td 9s 5c]
Seat 1: DeepStack (big blind) folded on the Flop
Seat 2: Dutch_@DutchBoyd (button) (small blind) collected ($600)

PokerStars Hand #7000400016: Tournament #5, Apr13_2017-at-18_13_0 Hold'em No Limit ($75/$150 USD) - 2017/04/13 20:13:15 ET
Table 'ACPC Match' 2-max Seat #1 is the button
Seat 1: DeepStack ($17550 in chips)
Seat 2: Dutch_@DutchBoyd ($22450 in chips)
DeepStack: posts small blind $75
Dutch_@DutchBoyd: posts big blind $150
*** HOLE CARDS ***
Dealt to DeepStack [Ad 9h]
Dealt to Dutch_@DutchBoyd [Td Th]
DeepStack: calls $75
Dutch_@DutchBoyd: raises $225 to $375
DeepStack: calls $225
*** FLOP **** [2c 7c Js]
Dutch_@DutchBoyd: bets $375
DeepStack: calls $375
*** TURN **** [4h]
Dutch_@DutchBoyd: bets $750
DeepStack: folds
Uncalled bet ($750) returned to Dutch_@DutchBoyd
Dutch_@DutchBoyd collected $1500 from the pot
*** SUMMARY ***
Total pot $1500 | Rake $0
Board [2c 7c Js 4h]
Seat 1: DeepStack (button) (small blind) folded on the Turn
Seat 2: Dutch_@DutchBoyd (big blind) collected ($1500)

PokerStars Hand #7000400017: Tournament #5, Apr13_2017-at-18_13_0 Hold'em No Limit ($75/$150 USD) - 2017/04/13 20:13:16 ET
Table 'ACPC Match' 2-max Seat #2 is the button
Seat 1: DeepStack ($16800 in chips)
Seat 2: Dutch_@DutchBoyd ($23200 in chips)
Dutch_@DutchBoyd: posts small blind $75
DeepStack: posts big blind $150
*** HOLE CARDS ***
Dealt to DeepStack [5s 2d]
Dealt to Dutch_@DutchBoyd [8c 6d]
Dutch_@DutchBoyd: raises $150 to $300
DeepStack: folds
Uncalled bet ($150) returned to Dutch_@DutchBoyd
Dutch_@DutchBoyd collected $300 from the pot
*** SUMMARY ***
Total pot $300 | Rake $0
Seat 1: DeepStack (big blind) folded before the Flop
Seat 2: Dutch_@DutchBoyd (button) (small blind) collected ($300)

PokerStars Hand #7000400018: Tournament #5, Apr13_2017-at-18_13_0 Hold'em No Limit ($75/$150 USD) - 2017/04/13 20:13:17 ET
Table 'ACPC Match' 2-max Seat #1 is the button
Seat 1: DeepStack ($16650 in chips)
Seat 2: Dutch_@DutchBoyd ($23350 in chips)
DeepStack: posts small blind $75
Dutch_@DutchBoyd: posts big blind $150
*** HOLE CARDS ***
Dealt to DeepStack [8c 9h]
Dealt to Dutch_@DutchBoyd [Js 6h]
DeepStack: raises $150 to $300
Dutch_@DutchBoyd: calls $150
*** FLOP **** [Qc 3h 4c]
Dutch_@DutchBoyd: checks
DeepStack: raises $300 to $300
Dutch_@DutchBoyd: folds
Uncalled bet ($300) returned to DeepStack
DeepStack collected $600 from the pot
*** SUMMARY ***
Total pot $600 | Rake $0
Board [Qc 3h 4c]
Seat 1: DeepStack (button) (small blind) collected ($600)
Seat 2: Dutch_@DutchBoyd (big blind) folded on the Flop

PokerStars Hand #7000400019: Tournament #5, Apr13_2017-at-18_13_0 Hold'em No Limit ($75/$150 USD) - 2017/04/13 20:13:18 ET
Table 'ACPC Match' 2-max Seat #2 is the button
Seat 1: DeepStack ($16950 in chips)
Seat 2: Dutch_@DutchBoyd ($23050 in chips)
Dutch_@DutchBoyd: posts small blind $75
DeepStack: posts big blind $150
*** HOLE CARDS ***
Dealt to DeepStack [Jh 9s]
Dealt to Dutch_@DutchBoyd [9h 5d]
Dutch_@DutchBoyd: raises $150 to $300
DeepStack: calls $150
*** FLOP **** [Qs Qd 4c]
DeepStack: checks
Dutch_@DutchBoyd: checks
*** TURN **** [Ah]
DeepStack: checks
Dutch_@DutchBoyd: checks
*** RIVER **** [Kh]
DeepStack: checks
Dutch_@DutchBoyd: checks
*** SHOW DOWN ***
DeepStack: shows [Jh 9s] (a pair of Queens)
Dutch_@DutchBoyd: shows [9h 5d] (a pair of Queens)
DeepStack collected $600 from pot
*** SUMMARY ***
Total pot $600 | Rake $0
Board [Qs Qd 4c Ah Kh]
Seat 1: DeepStack (big blind) showed [Jh 9s] and won ($600) with a pair of Queens
Seat 2: Dutch_@DutchBoyd (button) (small blind) showed [9h 5d] and lost with a pair of Queens

PokerStars Hand #7000400020: Tournament #5, Apr13_2017-at-18_13_0 Hold'em No Limit ($75/$150 USD) - 2017/04/13 20:13:19 ET
Table 'ACPC Match' 2-max Seat #1 is the button
Seat 1: DeepStack ($17250 in chips)
Seat 2: Dutch_@DutchBoyd ($22750 in chips)
DeepStack: posts small blind $75
Dutch_@DutchBoyd: posts big blind $150
*** HOLE CARDS ***
Dealt to DeepStack [3h 4c]
Dealt to Dutch_@DutchBoyd [7d 8c]
DeepStack: calls $75
Dutch_@DutchBoyd: checks
*** FLOP **** [Jh Js Jd]
Dutch_@DutchBoyd: checks
DeepStack: raises $150 to $150
Dutch_@DutchBoyd: folds
Uncalled bet ($150) returned to DeepStack
DeepStack collected $300 from the pot
*** SUMMARY ***
Total pot $300 | Rake $0
Board [Jh Js Jd]
Seat 1: DeepStack (button) (small blind) collected ($300)
Seat 2: Dutch_@DutchBoyd (big blind) folded on the Flop

PokerStars Hand #7000400021: Tournament #5, Apr13_2017-at-18_13_0 Hold'em No Limit ($100/$200 USD) - 2017/04/13 20:13:20 ET
Table 'ACPC Match' 2-max Seat #2 is the button
Seat 1: DeepStack ($17400 in chips)
Seat 2: Dutch_@DutchBoyd ($22600 in chips)
Dutch_@DutchBoyd: posts small blind $100
DeepStack: posts big blind $200
*** HOLE CARDS ***
Dealt to DeepStack [3h 2s]
Dealt to Dutch_@DutchBoyd [Qh Kh]
Dutch_@DutchBoyd: raises $200 to $400
DeepStack: folds
Uncalled bet ($200) returned to Dutch_@DutchBoyd
Dutch_@DutchBoyd collected $400 from the pot
*** SUMMARY ***
Total pot $400 | Rake $0
Seat 1: DeepStack (big blind) folded before the Flop
Seat 2: Dutch_@DutchBoyd (button) (small blind) collected ($400)

PokerStars Hand #7000400022: Tournament #5, Apr13_2017-at-18_13_0 Hold'em No Limit ($100/$200 USD) - 2017/04/13 20:13:21 ET
Table 'ACPC Match' 2-max Seat #1 is the button
Seat 1: DeepStack ($17200 in chips)
Seat 2: Dutch_@DutchBoyd ($22800 in chips)
DeepStack: posts small blind $100
Dutch_@DutchBoyd: posts big blind $200
*** HOLE CARDS ***
Dealt to DeepStack [4s 7s]
Dealt to Dutch_@DutchBoyd [3c 8d]
DeepStack: calls $100
Dutch_@DutchBoyd: checks
*** FLOP **** [7c 5s 9s]
Dutch_@DutchBoyd: checks
DeepStack: raises $400 to $400
Dutch_@DutchBoyd: folds
Uncalled bet ($400) returned to DeepStack
DeepStack collected $400 from the pot
*** SUMMARY ***
Total pot $400 | Rake $0
Board [7c 5s 9s]
Seat 1: DeepStack (button) (small blind) collected ($400)
Seat 2: Dutch_@DutchBoyd (big blind) folded on the Flop

PokerStars Hand #7000400023: Tournament #5, Apr13_2017-at-18_13_0 Hold'em No Limit ($100/$200 USD) - 2017/04/13 20:13:22 ET
Table 'ACPC Match' 2-max Seat #2 is the button
Seat 1: DeepStack ($17400 in chips)
Seat 2: Dutch_@DutchBoyd ($22600 in chips)
Dutch_@DutchBoyd: posts small blind $100
DeepStack: posts big blind $200
*** HOLE CARDS ***
Dealt to DeepStack [5h 9d]
Dealt to Dutch_@DutchBoyd [6s 7d]
Dutch_@DutchBoyd: raises $200 to $400
DeepStack: calls $200
*** FLOP **** [Tc Ts 3s]
DeepStack: checks
Dutch_@DutchBoyd: raises $400 to $400
DeepStack: folds
Uncalled bet ($400) returned to Dutch_@DutchBoyd
Dutch_@DutchBoyd collected $800 from the pot
*** SUMMARY ***
Total pot $800 | Rake $0
Board [Tc Ts 3s]
Seat 1: DeepStack (big blind) folded on the Flop
Seat 2: Dutch_@DutchBoyd (button) (small blind) collected ($800)

PokerStars Hand #7000400024: Tournament #5, Apr13_2017-at-18_13_0 Hold'em No Limit ($100/$200 USD) - 2017/04/13 20:13:23 ET
Table 'ACPC Match' 2-max Seat #1 is the button
Seat 1: DeepStack ($17000 in chips)
Seat 2: Dutch_@DutchBoyd ($23000 in chips)
DeepStack: posts small blind $100
Dutch_@DutchBoyd: posts big blind $200
*** HOLE CARDS ***
Dealt to DeepStack [Qs 2s]
Dealt to Dutch_@DutchBoyd [5h 2d]
DeepStack: raises $400 to $600
Dutch_@DutchBoyd: folds
Uncalled bet ($400) returned to DeepStack
DeepStack collected $400 from the pot
*** SUMMARY ***
Total pot $400 | Rake $0
Seat 1: DeepStack (button) (small blind) collected ($400)
Seat 2: Dutch_@DutchBoyd (big blind) folded before the Flop

PokerStars Hand #7000400025: Tournament #5, Apr13_2017-at-18_13_0 Hold'em No Limit ($100/$200 USD) - 2017/04/13 20:13:24 ET
Table 'ACPC Match' 2-max Seat #2 is the button
Seat 1: DeepStack ($17200 in chips)
Seat 2: Dutch_@DutchBoyd ($22800 in chips)
Dutch_@DutchBoyd: posts small blind $100
DeepStack: posts big blind $200
*** HOLE CARDS ***
Dealt to DeepStack [5d 5s]
Dealt to Dutch_@DutchBoyd [4c Jh]
Dutch_@DutchBoyd: raises $200 to $400
DeepStack: raises $800 to $1200
Dutch_@DutchBoyd: folds
Uncalled bet ($800) returned to DeepStack
DeepStack collected $800 from the pot
*** SUMMARY ***
Total pot $800 | Rake $0
Seat 1: DeepStack (big blind) collected ($800)
Seat 2: Dutch_@DutchBoyd (button) (small blind) folded before the Flop

PokerStars Hand #7000400026: Tournament #5, Apr13_2017-at-18_13_0 Hold'em No Limit ($100/$200 USD) - 2017/04/13 20:13:25 ET
Table 'ACPC Match' 2-max Seat #1 is the button
Seat 1: DeepStack ($17600 in chips)
Seat 2: Dutch_@DutchBoyd ($22400 in chips)
DeepStack: posts small blind $100
Dutch_@DutchBoyd: posts big blind $200
*** HOLE CARDS ***
Dealt to DeepStack [Th 9s]
Dealt to Dutch_@DutchBoyd [3c 3s]
DeepStack: raises $400 to $600
Dutch_@DutchBoyd: raises $900 to $1500
DeepStack: calls $900
*** FLOP **** [Ts 3h Qh]
Dutch_@DutchBoyd: bets $1500
DeepStack: calls $1500
*** TURN **** [Jc]
Dutch_@DutchBoyd: bets $3000
DeepStack: calls $3000
*** RIVER **** [6c]
Dutch_@DutchBoyd: bets $6000
DeepStack: folds
Uncalled bet ($6000) returned to Dutch_@DutchBoyd
Dutch_@DutchBoyd collected $12000 from the pot
*** SUMMARY ***
Total pot $12000 | Rake $0
Board [Ts 3h Qh Jc 6c]
Seat 1: DeepStack (button) (small blind) folded on the River
Seat 2: Dutch_@DutchBoyd (big blind) collected ($12000)

PokerStars Hand #7000400027: Tournament #5, Apr13_2017-at-18_13_0 Hold'em No Limit ($100/$200 USD) - 2017/04/13 20:13:26 ET
Table 'ACPC Match' 2-max Seat #2 is the button
Seat 1: DeepStack ($11600 in chips)
Seat 2: Dutch_@DutchBoyd ($28400 in chips)
Dutch_@DutchBoyd: posts small blind $100
DeepStack: posts big blind $200
*** HOLE CARDS ***
Dealt to DeepStack [5h Jh]
Dealt to Dutch_@DutchBoyd [7c 8d]
Dutch_@DutchBoyd: raises $200 to $400
DeepStack: calls $200
*** FLOP **** [Td 7d 2d]
DeepStack: checks
Dutch_@DutchBoyd: raises $400 to $400
DeepStack: folds
Uncalled bet ($400) returned to Dutch_@DutchBoyd
Dutch_@DutchBoyd collected $800 from the pot
*** SUMMARY ***
Total pot $800 | Rake $0
Board [Td 7d 2d]
Seat 1: DeepStack (big blind) folded on the Flop
Seat 2: Dutch_@DutchBoyd (button) (small blind) collected ($800)

PokerStars Hand #7000400028: Tournament #5, Apr13_2017-at-18_13_0 Hold'em No Limit ($100/$200 USD) - 2017/04/13 20:13:27 ET
Table 'ACPC Match' 2-max Seat #1 is the button
Seat 1: DeepStack ($11200 in chips)
Seat 2: Dutch_@DutchBoyd ($28800 in chips)
DeepStack: posts small blind $100
Dutch_@DutchBoyd: posts big blind $200
*** HOLE CARDS ***
Dealt to DeepStack [6h 3h]
Dealt to Dutch_@DutchBoyd [Qh Kc]
DeepStack: raises $200 to $400
Dutch_@DutchBoyd: raises $600 to $1000
DeepStack: calls $600
*** FLOP **** [Jh Qd 4s]
Dutch_@DutchBoyd: bets $1000
DeepStack: folds
Uncalled bet ($1000) returned to Dutch_@DutchBoyd
Dutch_@DutchBoyd collected $2000 from the pot
*** SUMMARY ***
Total pot $2000 | Rake $0
Board [Jh Qd 4s]
Seat 1: DeepStack (button) (small blind) folded on the Flop
Seat 2: Dutch_@DutchBoyd (big blind) collected ($2000)

PokerStars Hand #7000400029: Tournament #5, Apr13_2017-at-18_13_0 Hold'em No Limit ($100/$200 USD) - 2017/04/13 20:13:28 ET
Table 'ACPC Match' 2-max Seat #2 is the button
Seat 1: DeepStack ($10200 in chips)
Seat 2: Dutch_@DutchBoyd ($29800 in chips)
Dutch_@DutchBoyd: posts small blind $100
DeepStack: posts big blind $200
*** HOLE CARDS ***
Dealt to DeepStack [Qh 6h]
Dealt to Dutch_@DutchBoyd [4h 2c]
Dutch_@DutchBoyd: raises $200 to $400
DeepStack: raises $800 to $1200
Dutch_@DutchBoyd: folds
Uncalled bet ($800) returned to DeepStack
DeepStack collected $800 from the pot
*** SUMMARY ***
Total pot $800 | Rake $0
Seat 1: DeepStack (big blind) collected ($800)
Seat 2: Dutch_@DutchBoyd (button) (small blind) folded before the Flop

PokerStars Hand #7000400030: Tournament #5, Apr13_2017-at-18_13_0 Hold'em No Limit ($100/$200 USD) - 2017/04/13 20:13:29 ET
Table 'ACPC Match' 2-max Seat #1 is the button
Seat 1: DeepStack ($10600 in chips)
Seat 2: Dutch_@DutchBoyd ($29400 in chips)
DeepStack: posts small blind $100
Dutch_@DutchBoyd: posts big blind $200
*** HOLE CARDS ***
Dealt to DeepStack [3h 8d]
Dealt to Dutch_@DutchBoyd [7d 9h]
DeepStack: folds
Uncalled bet ($100) returned to Dutch_@DutchBoyd
Dutch_@DutchBoyd collected $200 from the pot
*** SUMMARY ***
Total pot $200 | Rake $0
Seat 1: DeepStack (button) (small blind) folded before the Flop
Seat 2: Dutch_@DutchBoyd (big blind) collected ($200)

PokerStars Hand #7000400031: Tournament #5, Apr13_2017-at-18_13_0 Hold'em No Limit ($150/$300 USD) - 2017/04/13 20:13:30 ET
Table 'ACPC Match' 2-max Seat #2 is the button
Seat 1: DeepStack ($10500 in chips)
Seat 2: Dutch_@DutchBoyd ($29500 in chips)
Dutch_@DutchBoyd: posts small blind $150
DeepStack: posts big blind $300
*** HOLE CARDS ***
Dealt to DeepStack [7h 7d]
Dealt to Dutch_@DutchBoyd [5h 5d]
Dutch_@DutchBoyd: raises $450 to $750
DeepStack: raises $1500 to $2250
Dutch_@DutchBoyd: raises $9000 to $11250
DeepStack: calls $8250 and is all-in
Uncalled bet ($750) returned to Dutch_@DutchBoyd
*** FLOP **** [Jc Qh 7s]
*** TURN **** [Js]
*** RIVER **** [Ad]
*** SHOW DOWN ***
Dutch_@DutchBoyd: shows [5h 5d] (two pair, Jacks and Fives)
DeepStack: shows [7h 7d] (full house, Sevens and Jacks)
DeepStack collected $21000 from pot
*** SUMMARY ***
Total pot $21000 | Rake $0
Board [Jc Qh 7s Js Ad]
Seat 1: DeepStack (big blind) showed [7h 7d] and won ($21000) with full house, Sevens and Jacks
Seat 2: Dutch_@DutchBoyd (button) (small blind) showed [5h 5d] and lost with two pair, Jacks and Fives

PokerStars Hand #7000400032: Tournament #5, Apr13_2017-at-18_13_0 Hold'em No Limit ($150/$300 USD) - 2017/04/13 20:13:31 ET
Table 'ACPC Match' 2-max Seat #1 is the button
Seat 1: DeepStack ($21000 in chips)
Seat 2: Dutch_@DutchBoyd ($19000 in chips)
DeepStack: posts small blind $150
Dutch_@DutchBoyd: posts big blind $300
*** HOLE CARDS ***
Dealt to DeepStack [6s 2h]
Dealt to Dutch_@DutchBoyd [Kc 6h]
DeepStack: folds
Uncalled bet ($150) returned to Dutch_@DutchBoyd
Dutch_@DutchBoyd collected $300 from the pot
*** SUMMARY ***
Total pot $300 | Rake $0
Seat 1: DeepStack (button) (small blind) folded before the Flop
Seat 2: Dutch_@DutchBoyd (big blind) collected ($300)

PokerStars Hand #7000400033: Tournament #5, Apr13_2017-at-18_13_0 Hold'em No Limit ($150/$300 USD) - 2017/04/13 20:13:32 ET
Table 'ACPC Match' 2-max Seat #2 is the button
Seat 1: DeepStack ($20850 in chips)
Seat 2: Dutch_@DutchBoyd ($19150 in chips)
Dutch_@DutchBoyd: posts small blind $150
DeepStack: posts big blind $300
*** HOLE CARDS ***
Dealt to DeepStack [8h Qh]
Dealt to Dutch_@DutchBoyd [5h 3s]
Dutch_@DutchBoyd: raises $300 to $600
DeepStack: raises $1200 to $1800
Dutch_@DutchBoyd: folds
Uncalled bet ($1200) returned to DeepStack
DeepStack collected $1200 from the pot
*** SUMMARY ***
Total pot $1200 | Rake $0
Seat 1: DeepStack (big blind) collected ($1200)
Seat 2: Dutch_@DutchBoyd (button) (small blind) folded before the Flop

PokerStars Hand #7000400034: Tournament #5, Apr13_2017-at-18_13_0 Hold'em No Limit ($150/$300 USD) - 2017/04/13 20:13:33 ET
Table 'ACPC Match' 2-max Seat #1 is the button
Seat 1: DeepStack ($21450 in chips)
Seat 2: Dutch_@DutchBoyd ($18550 in chips)
DeepStack: posts small blind $150
Dutch_@DutchBoyd: posts big blind $300
*** HOLE CARDS ***
Dealt to DeepStack [6h 4d]
Dealt to Dutch_@DutchBoyd [9h 2s]
DeepStack: raises $300 to $600
Dutch_@DutchBoyd: calls $300
*** FLOP **** [Tc Th 3h]
Dutch_@DutchBoyd: checks
DeepStack: raises $600 to $600
Dutch_@DutchBoyd: folds
Uncalled bet ($600) returned to DeepStack
DeepStack collected $1200 from the pot
*** SUMMARY ***
Total pot $1200 | Rake $0
Board [Tc Th 3h]
Seat 1: DeepStack (button) (small blind) collected ($1200)
Seat 2: Dutch_@DutchBoyd (big blind) folded on the Flop

PokerStars Hand #7000400035: Tournament #5, Apr13_2017-at-18_13_0 Hold'em No Limit ($150/$300 USD) - 2017/04/13 20:13:34 ET
Table 'ACPC Match' 2-max Seat #2 is the button
Seat 1: DeepStack ($22050 in chips)
Seat 2: Dutch_@DutchBoyd ($17950 in chips)
Dutch_@DutchBoyd: posts small blind $150
DeepStack: posts big blind $300
*** HOLE CARDS ***
Dealt to DeepStack [8s Jc]
Dealt to Dutch_@DutchBoyd [3s 2c]
Dutch_@DutchBoyd: folds
Uncalled bet ($150) returned to DeepStack
DeepStack collected $300 from the pot
*** SUMMARY ***
Total pot $300 | Rake $0
Seat 1: DeepStack (big blind) collected ($300)
Seat 2: Dutch_@DutchBoyd (button) (small blind) folded before the Flop

PokerStars Hand #7000400036: Tournament #5, Apr13_2017-at-18_13_0 Hold'em No Limit ($150/$300 USD) - 2017/04/13 20:13:35 ET
Table 'ACPC Match' 2-max Seat #1 is the button
Seat 1: DeepStack ($22200 in chips)
Seat 2: Dutch_@DutchBoyd ($17800 in chips)
DeepStack: posts small blind $150
Dutch_@DutchBoyd: posts big blind $300
*** HOLE CARDS ***
Dealt to DeepStack [Td 5c]
Dealt to Dutch_@DutchBoyd [4s As]
DeepStack: raises $300 to $600
Dutch_@DutchBoyd: calls $300
*** FLOP **** [5d 3d 7h]
Dutch_@DutchBoyd: bets $600
DeepStack: calls $600
*** TURN **** [2s]
Dutch_@DutchBoyd: bets $1800
DeepStack: calls $1800
*** RIVER **** [Jd]
Dutch_@DutchBoyd: bets $6000
DeepStack: calls $6000
*** SHOW DOWN ***
Dutch_@DutchBoyd: shows [4s As] (straight, Five high)
DeepStack: shows [Td 5c] (a pair of Fives)
Dutch_@DutchBoyd collected $18000 from pot
*** SUMMARY ***
Total pot $18000 | Rake $0
Board [5d 3d 7h 2s Jd]
Seat 1: DeepStack (button) (small blind) showed [Td 5c] and lost with a pair of Fives
Seat 2: Dutch_@DutchBoyd (big blind) showed [4s As] and won ($18000) with straight, Five high

PokerStars Hand #7000400037: Tournament #5, Apr13_2017-at-18_13_0 Hold'em No Limit ($150/$300 USD) - 2017/04/13 20:13:36 ET
Table 'ACPC Match' 2-max Seat #2 is the button
Seat 1: DeepStack ($13200 in chips)
Seat 2: Dutch_@DutchBoyd ($26800 in chips)
Dutch_@DutchBoyd: posts small blind $150
DeepStack: posts big blind $300
*** HOLE CARDS ***
Dealt to DeepStack [6d 4h]
Dealt to Dutch_@DutchBoyd [4c Jh]
Dutch_@DutchBoyd: raises $300 to $600
DeepStack: calls $300
*** FLOP **** [2c 3d 9c]
DeepStack: checks
Dutch_@DutchBoyd: checks
*** TURN **** [9s]
DeepStack: bets $1200
Dutch_@DutchBoyd: folds
Uncalled bet ($1200) returned to DeepStack
DeepStack collected $1200 from the pot
*** SUMMARY ***
Total pot $1200 | Rake $0
Board [2c 3d 9c 9s]
Seat 1: DeepStack (big blind) collected ($1200)
Seat 2: Dutch_@DutchBoyd (button) (small blind) folded on the Turn

PokerStars Hand #7000400038: Tournament #5, Apr13_2017-at-18_13_0 Hold'em No Limit ($150/$300 USD) - 2017/04/13 20:13:37 ET
Table 'ACPC Match' 2-max Seat #1 is the button
Seat 1: DeepStack ($13800 in chips)
Seat 2: Dutch_@DutchBoyd ($26200 in chips)
DeepStack: posts small blind $150
Dutch_@DutchBoyd: posts big blind $300
*** HOLE CARDS ***
Dealt to DeepStack [Ts 6h]
Dealt to Dutch_@DutchBoyd [8d Qd]
DeepStack: raises $300 to $600
Dutch_@DutchBoyd: calls $300
*** FLOP **** [Qh 9h 8h]
Dutch_@DutchBoyd: bets $600
DeepStack: calls $600
*** TURN **** [As]
Dutch_@DutchBoyd: bets $2400
DeepStack: calls $2400
*** RIVER **** [5h]
Dutch_@DutchBoyd: checks
DeepStack: checks
*** SHOW DOWN ***
Dutch_@DutchBoyd: shows [8d Qd] (two pair, Queens and Eights)
DeepStack: shows [Ts 6h] (flush, Queen high)
DeepStack collected $7200 from pot
*** SUMMARY ***
Total pot $7200 | Rake $0
Board [Qh 9h 8h As 5h]
Seat 1: DeepStack (button) (small blind) showed [Ts 6h] and won ($7200) with flush, Queen high
Seat 2: Dutch_@DutchBoyd (big blind) showed [8d Qd] and lost with two pair, Queens and Eights

PokerStars Hand #7000400039: Tournament #5, Apr13_2017-at-18_13_0 Hold'em No Limit ($150/$300 USD) - 2017/04/13 20:13:38 ET
Table 'ACPC Match' 2-max Seat #2 is the button
Seat 1: DeepStack ($17400 in chips)
Seat 2: Dutch_@DutchBoyd ($22600 in chips)
Dutch_@DutchBoyd: posts small blind $150
DeepStack: posts big blind $300
*** HOLE CARDS ***
Dealt to DeepStack [5h Ac]
Dealt to Dutch_@DutchBoyd [As Ah]
Dutch_@DutchBoyd: raises $300 to $600
DeepStack: calls $300
*** FLOP **** [3c 9h 7c]
DeepStack: checks
Dutch_@DutchBoyd: raises $900 to $900
DeepStack: calls $900
*** TURN **** [Jh]
DeepStack: checks
Dutch_@DutchBoyd: raises $1500 to $1500
DeepStack: folds
Uncalled bet ($1500) returned to Dutch_@DutchBoyd
Dutch_@DutchBoyd collected $3000 from the pot
*** SUMMARY ***
Total pot $3000 | Rake $0
Board [3c 9h 7c Jh]
Seat 1: DeepStack (big blind) folded on the Turn
Seat 2: Dutch_@DutchBoyd (button) (small blind) collected ($3000)

PokerStars Hand #7000400040: Tournament #5, Apr13_2017-at-18_13_0 Hold'em No Limit ($150/$300 USD) - 2017/04/13 20:13:39 ET
Table 'ACPC Match' 2-max Seat #1 is the button
Seat 1: DeepStack ($15900 in chips)
Seat 2: Dutch_@DutchBoyd ($24100 in chips)
DeepStack: posts small blind $150
Dutch_@DutchBoyd: posts big blind $300
*** HOLE CARDS ***
Dealt to DeepStack [Qh 3h]
Dealt to Dutch_@DutchBoyd [Qd Ad]
DeepStack: raises $600 to $900
Dutch_@DutchBoyd: raises $1350 to $2250
DeepStack: calls $1350
*** FLOP **** [Ts Jd 7c]
Dutch_@DutchBoyd: bets $2250
DeepStack: folds
Uncalled bet ($2250) returned to Dutch_@DutchBoyd
Dutch_@DutchBoyd collected $4500 from the pot
*** SUMMARY ***
Total pot $4500 | Rake $0
Board [Ts Jd 7c]
Seat 1: DeepStack (button) (small blind) folded on the Flop
Seat 2: Dutch_@DutchBoyd (big blind) collected ($4500)

PokerStars Hand #7000400041: Tournament #5, Apr13_2017-at-18_13_0 Hold'em No Limit ($200/$400 USD) - 2017/04/13 20:13:40 ET
Table 'ACPC Match' 2-max Seat #2 is the button
Seat 1: DeepStack ($13650 in chips)
Seat 2: Dutch_@DutchBoyd ($26350 in chips)
Dutch_@DutchBoyd: posts small blind $200
DeepStack: posts big blind $400
*** HOLE CARDS ***
Dealt to DeepStack [4d 3c]
Dealt to Dutch_@DutchBoyd [As 8c]
Dutch_@DutchBoyd: raises $400 to $800
DeepStack: calls $400
*** FLOP **** [Kc Ks 9d]
DeepStack: checks
Dutch_@DutchBoyd: raises $800 to $800
DeepStack: folds
Uncalled bet ($800) returned to Dutch_@DutchBoyd
Dutch_@DutchBoyd collected $1600 from the pot
*** SUMMARY ***
Total pot $1600 | Rake $0
Board [Kc Ks 9d]
Seat 1: DeepStack (big blind) folded on the Flop
Seat 2: Dutch_@DutchBoyd (button) (small blind) collected ($1600)

PokerStars Hand #7000400042: Tournament #5, Apr13_2017-at-18_13_0 Hold'em No Limit ($200/$400 USD) - 2017/04/13 20:13:41 ET
Table 'ACPC Match' 2-max Seat #1 is the button
Seat 1: DeepStack ($12850 in chips)
Seat 2: Dutch_@DutchBoyd ($27150 in chips)
DeepStack: posts small blind $200
Dutch_@DutchBoyd: posts big blind $400
*** HOLE CARDS ***
Dealt to DeepStack [Ks 5d]
Dealt to Dutch_@DutchBoyd [4d 7c]
DeepStack: raises $400 to $800
Dutch_@DutchBoyd: calls $400
*** FLOP **** [Ac 4h 9h]
Dutch_@DutchBoyd: checks
DeepStack: checks
*** TURN **** [Qd]
Dutch_@DutchBoyd: checks
DeepStack: checks
*** RIVER **** [7s]
Dutch_@DutchBoyd: bets $800
DeepStack: folds
Uncalled bet ($800) returned to Dutch_@DutchBoyd
Dutch_@DutchBoyd collected $1600 from the pot
*** SUMMARY ***
Total pot $1600 | Rake $0
Board [Ac 4h 9h Qd 7s]
Seat 1: DeepStack (button) (small blind) folded on the River
Seat 2: Dutch_@DutchBoyd (big blind) collected ($1600)

PokerStars Hand #7000400043: Tournament #5, Apr13_2017-at-18_13_0 Hold'em No Limit ($200/$400 USD) - 2017/04/13 20:13:42 ET
Table 'ACPC Match' 2-max Seat #2 is the button
Seat 1: DeepStack ($12050 in chips)
Seat 2: Dutch_@DutchBoyd ($27950 in chips)
Dutch_@DutchBoyd: posts small blind $200
DeepStack: posts big blind $400
*** HOLE CARDS ***
Dealt to DeepStack [Tc Jc]
Dealt to Dutch_@DutchBoyd [4h 5s]
Dutch_@DutchBoyd: raises $400 to $800
DeepStack: calls $400
*** FLOP **** [Kd Kc 7s]
DeepStack: checks
Dutch_@DutchBoyd: raises $800 to $800
DeepStack: calls $800
*** TURN **** [Qc]
DeepStack: checks
Dutch_@DutchBoyd: checks
*** RIVER **** [8h]
DeepStack: bets $1600
Dutch_@DutchBoyd: folds
Uncalled bet ($1600) returned to DeepStack
DeepStack collected $3200 from the pot
*** SUMMARY ***
Total pot $3200 | Rake $0
Board [Kd Kc 7s Qc 8h]
Seat 1: DeepStack (big blind) collected ($3200)
Seat 2: Dutch_@DutchBoyd (button) (small blind) folded on the River

PokerStars Hand #7000400044: Tournament #5, Apr13_2017-at-18_13_0 Hold'em No Limit ($200/$400 USD) - 2017/04/13 20:13:43 ET
Table 'ACPC Match' 2-max Seat #1 is the button
Seat 1: DeepStack ($13650 in chips)
Seat 2: Dutch_@DutchBoyd ($26350 in chips)
DeepStack: posts small blind $200
Dutch_@DutchBoyd: posts big blind $400
*** HOLE CARDS ***
Dealt to DeepStack [Kc Qd]
Dealt to Dutch_@DutchBoyd [4h 8d]
DeepStack: raises $400 to $800
Dutch_@DutchBoyd: calls $400
*** FLOP **** [Jh Qh Js]
Dutch_@DutchBoyd: checks
DeepStack: checks
*** TURN **** [9s]
Dutch_@DutchBoyd: checks
DeepStack: checks
*** RIVER **** [4c]
Dutch_@DutchBoyd: checks
DeepStack: raises $1600 to $1600
Dutch_@DutchBoyd: calls $1600
*** SHOW DOWN ***
DeepStack: shows [Kc Qd] (two pair, Queens and Jacks)
Dutch_@DutchBoyd: shows [4h 8d] (two pair, Jacks and Fours)
DeepStack collected $4800 from pot
*** SUMMARY ***
Total pot $4800 | Rake $0
Board [Jh Qh Js 9s 4c]
Seat 1: DeepStack (button) (small blind) showed [Kc Qd] and won ($4800) with two pair, Queens and Jacks
Seat 2: Dutch_@DutchBoyd (big blind) showed [4h 8d] and lost with two pair, Jacks and Fours

PokerStars Hand #7000400045: Tournament #5, Apr13_2017-at-18_13_0 Hold'em No Limit ($200/$400 USD) - 2017/04/13 20:13:44 ET
Table 'ACPC Match' 2-max Seat #2 is the button
Seat 1: DeepStack ($16050 in chips)
Seat 2: Dutch_@DutchBoyd ($23950 in chips)
Dutch_@DutchBoyd: posts small blind $200
DeepStack: posts big blind $400
*** HOLE CARDS ***
Dealt to DeepStack [Qc Jh]
Dealt to Dutch_@DutchBoyd [9c 3s]
Dutch_@DutchBoyd: raises $400 to $800
DeepStack: raises $1600 to $2400
Dutch_@DutchBoyd: folds
Uncalled bet ($1600) returned to DeepStack
DeepStack collected $1600 from the pot
*** SUMMARY ***
Total pot $1600 | Rake $0
Seat 1: DeepStack (big blind) collected ($1600)
Seat 2: Dutch_@DutchBoyd (button) (small blind) folded before the Flop

PokerStars Hand #7000400046: Tournament #5, Apr13_2017-at-18_13_0 Hold'em No Limit ($200/$400 USD) - 2017/04/13 20:13:45 ET
Table 'ACPC Match' 2-max Seat #1 is the button
Seat 1: DeepStack ($16850 in chips)
Seat 2: Dutch_@DutchBoyd ($23150 in chips)
DeepStack: posts small blind $200
Dutch_@DutchBoyd: posts big blind $400
*** HOLE CARDS ***
Dealt to DeepStack [Qh 4s]
Dealt to Dutch_@DutchBoyd [9h 2d]
DeepStack: calls $200
Dutch_@DutchBoyd: checks
*** FLOP **** [5c 5s 9d]
Dutch_@DutchBoyd: bets $400
DeepStack: folds
Uncalled bet ($400) returned to Dutch_@DutchBoyd
Dutch_@DutchBoyd collected $800 from the pot
*** SUMMARY ***
Total pot $800 | Rake $0
Board [5c 5s 9d]
Seat 1: DeepStack (button) (small blind) folded on the Flop
Seat 2: Dutch_@DutchBoyd (big blind) collected ($800)

PokerStars Hand #7000400047: Tournament #5, Apr13_2017-at-18_13_0 Hold'em No Limit ($200/$400 USD) - 2017/04/13 20:13:46 ET
Table 'ACPC Match' 2-max Seat #2 is the button
Seat 1: DeepStack ($16450 in chips)
Seat 2: Dutch_@DutchBoyd ($23550 in chips)
Dutch_@DutchBoyd: posts small blind $200
DeepStack: posts big blind $400
*** HOLE CARDS ***
Dealt to DeepStack [5s Kh]
Dealt to Dutch_@DutchBoyd [4d Jh]
Dutch_@DutchBoyd: raises $400 to $800
DeepStack: calls $400
*** FLOP **** [4h 7h 8d]
DeepStack: checks
Dutch_@DutchBoyd: checks
*** TURN **** [9c]
DeepStack: checks
Dutch_@DutchBoyd: checks
*** RIVER **** [2s]
DeepStack: bets $1600
Dutch_@DutchBoyd: folds
Uncalled bet ($1600) returned to DeepStack
DeepStack collected $1600 from the pot
*** SUMMARY ***
Total pot $1600 | Rake $0
Board [4h 7h 8d 9c 2s]
Seat 1: DeepStack (big blind) collected ($1600)
Seat 2: Dutch_@DutchBoyd (button) (small blind) folded on the River

PokerStars Hand #7000400048: Tournament #5, Apr13_2017-at-18_13_0 Hold'em No Limit ($200/$400 USD) - 2017/04/13 20:13:47 ET
Table 'ACPC Match' 2-max Seat #1 is the button
Seat 1: DeepStack ($17250 in chips)
Seat 2: Dutch_@DutchBoyd ($22750 in chips)
DeepStack: posts small blind $200
Dutch_@DutchBoyd: posts big blind $400
*** HOLE CARDS ***
Dealt to DeepStack [Js 3s]
Dealt to Dutch_@DutchBoyd [9h 6d]
DeepStack: raises $400 to $800
Dutch_@DutchBoyd: calls $400
*** FLOP **** [4h Jh Ks]
Dutch_@DutchBoyd: checks
DeepStack: checks
*** TURN **** [6c]
Dutch_@DutchBoyd: checks
DeepStack: raises $800 to $800
Dutch_@DutchBoyd: calls $800
*** RIVER **** [5h]
Dutch_@DutchBoyd: checks
DeepStack: checks
*** SHOW DOWN ***
Dutch_@DutchBoyd: shows [9h 6d] (a pair of Sixes)
DeepStack: shows [Js 3s] (a pair of Jacks)
DeepStack collected $3200 from pot
*** SUMMARY ***
Total pot $3200 | Rake $0
Board [4h Jh Ks 6c 5h]
Seat 1: DeepStack (button) (small blind) showed [Js 3s] and won ($3200) with a pair of Jacks
Seat 2: Dutch_@DutchBoyd (big blind) showed [9h 6d] and lost with a pair of Sixes

PokerStars Hand #7000400049: Tournament #5, Apr13_2017-at-18_13_0 Hold'em No Limit ($200/$400 USD) - 2017/04/13 20:13:48 ET
Table 'ACPC Match' 2-max Seat #2 is the button
Seat 1: DeepStack ($18850 in chips)
Seat 2: Dutch_@DutchBoyd ($21150 in chips)
Dutch_@DutchBoyd: posts small blind $200
DeepStack: posts big blind $400
*** HOLE CARDS ***
Dealt to DeepStack [Ac 9d]
Dealt to Dutch_@DutchBoyd [Qh Ks]
Dutch_@DutchBoyd: raises $400 to $800
DeepStack: raises $1600 to $2400
Dutch_@DutchBoyd: calls $1600
*** FLOP **** [9h Ts Tc]
DeepStack: bets $2400
Dutch_@DutchBoyd: raises $16350 to $18750 and is all-in
DeepStack: calls $14050 and is all-in
Uncalled bet ($2300) returned to Dutch_@DutchBoyd
*** TURN **** [Kd]
*** RIVER **** [7s]
*** SHOW DOWN ***
Dutch_@DutchBoyd: shows [Qh Ks] (two pair, Kings and Tens)
DeepStack: shows [Ac 9d] (two pair, Tens and Nines)
Dutch_@DutchBoyd collected $37700 from pot
*** SUMMARY ***
Total pot $37700 | Rake $0
Board [9h Ts Tc Kd 7s]
Seat 1: DeepStack (big blind) showed [Ac 9d] and lost with two pair, Tens and Nines
Seat 2: Dutch_@DutchBoyd (button) (small blind) showed [Qh Ks] and won ($37700) with two pair, Kings and Tens
