PokerStars Hand #13000300001: Tournament #4, May4_2017-at-15_13_17 Hold'em No Limit ($50/$100 USD) - 2017/05/04 17:13:17 ET
Table 'ACPC Match' 2-max Seat #2 is the button
Seat 1: DeepStack ($20000 in chips)
Seat 2: Bryan_Paris_@bparispoker ($20000 in chips)
Bryan_Paris_@bparispoker: posts small blind $50
DeepStack: posts big blind $100
*** HOLE CARDS ***
Dealt to DeepStack [9h Jc]
Dealt to Bryan_Paris_@bparispoker [3h 7d]
Bryan_Paris_@bparispoker: folds
Uncalled bet ($50) returned to DeepStack
DeepStack collected $100 from the pot
*** SUMMARY ***
Total pot $100 | Rake $0
Seat 1: DeepStack (big blind) collected ($100)
Seat 2: Bryan_Paris_@bparispoker (button) (small blind) folded before the Flop

PokerStars Hand #13000300002: Tournament #4, May4_2017-at-15_13_17 Hold'em No Limit ($50/$100 USD) - 2017/05/04 17:13:18 ET
Table 'ACPC Match' 2-max Seat #1 is the button
Seat 1: DeepStack ($20050 in chips)
Seat 2: Bryan_Paris_@bparispoker ($19950 in chips)
DeepStack: posts small blind $50
Bryan_Paris_@bparispoker: posts big blind $100
*** HOLE CARDS ***
Dealt to DeepStack [2s 5d]
Dealt to Bryan_Paris_@bparispoker [Kh 2d]
DeepStack: folds
Uncalled bet ($50) returned to Bryan_Paris_@bparispoker
Bryan_Paris_@bparispoker collected $100 from the pot
*** SUMMARY ***
Total pot $100 | Rake $0
Seat 1: DeepStack (button) (small blind) folded before the Flop
Seat 2: Bryan_Paris_@bparispoker (big blind) collected ($100)

PokerStars Hand #13000300003: Tournament #4, May4_2017-at-15_13_17 Hold'em No Limit ($50/$100 USD) - 2017/05/04 17:13:19 ET
Table 'ACPC Match' 2-max Seat #2 is the button
Seat 1: DeepStack ($20000 in chips)
Seat 2: Bryan_Paris_@bparispoker ($20000 in chips)
Bryan_Paris_@bparispoker: posts small blind $50
DeepStack: posts big blind $100
*** HOLE CARDS ***
Dealt to DeepStack [Qs 4c]
Dealt to Bryan_Paris_@bparispoker [9h 9s]
Bryan_Paris_@bparispoker: raises $200 to $300
DeepStack: folds
Uncalled bet ($200) returned to Bryan_Paris_@bparispoker
Bryan_Paris_@bparispoker collected $200 from the pot
*** SUMMARY ***
Total pot $200 | Rake $0
Seat 1: DeepStack (big blind) folded before the Flop
Seat 2: Bryan_Paris_@bparispoker (button) (small blind) collected ($200)

PokerStars Hand #13000300004: Tournament #4, May4_2017-at-15_13_17 Hold'em No Limit ($50/$100 USD) - 2017/05/04 17:13:20 ET
Table 'ACPC Match' 2-max Seat #1 is the button
Seat 1: DeepStack ($19900 in chips)
Seat 2: Bryan_Paris_@bparispoker ($20100 in chips)
DeepStack: posts small blind $50
Bryan_Paris_@bparispoker: posts big blind $100
*** HOLE CARDS ***
Dealt to DeepStack [3c Kh]
Dealt to Bryan_Paris_@bparispoker [5d Jc]
DeepStack: raises $100 to $200
Bryan_Paris_@bparispoker: calls $100
*** FLOP **** [8h Tc 6s]
Bryan_Paris_@bparispoker: checks
DeepStack: raises $200 to $200
Bryan_Paris_@bparispoker: folds
Uncalled bet ($200) returned to DeepStack
DeepStack collected $400 from the pot
*** SUMMARY ***
Total pot $400 | Rake $0
Board [8h Tc 6s]
Seat 1: DeepStack (button) (small blind) collected ($400)
Seat 2: Bryan_Paris_@bparispoker (big blind) folded on the Flop

PokerStars Hand #13000300005: Tournament #4, May4_2017-at-15_13_17 Hold'em No Limit ($50/$100 USD) - 2017/05/04 17:13:21 ET
Table 'ACPC Match' 2-max Seat #2 is the button
Seat 1: DeepStack ($20100 in chips)
Seat 2: Bryan_Paris_@bparispoker ($19900 in chips)
Bryan_Paris_@bparispoker: posts small blind $50
DeepStack: posts big blind $100
*** HOLE CARDS ***
Dealt to DeepStack [As Th]
Dealt to Bryan_Paris_@bparispoker [Qc Ks]
Bryan_Paris_@bparispoker: raises $200 to $300
DeepStack: calls $200
*** FLOP **** [Ac Ad 2d]
DeepStack: checks
Bryan_Paris_@bparispoker: raises $300 to $300
DeepStack: calls $300
*** TURN **** [3d]
DeepStack: checks
Bryan_Paris_@bparispoker: checks
*** RIVER **** [6c]
DeepStack: bets $1200
Bryan_Paris_@bparispoker: folds
Uncalled bet ($1200) returned to DeepStack
DeepStack collected $1200 from the pot
*** SUMMARY ***
Total pot $1200 | Rake $0
Board [Ac Ad 2d 3d 6c]
Seat 1: DeepStack (big blind) collected ($1200)
Seat 2: Bryan_Paris_@bparispoker (button) (small blind) folded on the River

PokerStars Hand #13000300006: Tournament #4, May4_2017-at-15_13_17 Hold'em No Limit ($50/$100 USD) - 2017/05/04 17:13:22 ET
Table 'ACPC Match' 2-max Seat #1 is the button
Seat 1: DeepStack ($20700 in chips)
Seat 2: Bryan_Paris_@bparispoker ($19300 in chips)
DeepStack: posts small blind $50
Bryan_Paris_@bparispoker: posts big blind $100
*** HOLE CARDS ***
Dealt to DeepStack [Qc Kd]
Dealt to Bryan_Paris_@bparispoker [6s 9d]
DeepStack: raises $200 to $300
Bryan_Paris_@bparispoker: folds
Uncalled bet ($200) returned to DeepStack
DeepStack collected $200 from the pot
*** SUMMARY ***
Total pot $200 | Rake $0
Seat 1: DeepStack (button) (small blind) collected ($200)
Seat 2: Bryan_Paris_@bparispoker (big blind) folded before the Flop

PokerStars Hand #13000300007: Tournament #4, May4_2017-at-15_13_17 Hold'em No Limit ($50/$100 USD) - 2017/05/04 17:13:23 ET
Table 'ACPC Match' 2-max Seat #2 is the button
Seat 1: DeepStack ($20800 in chips)
Seat 2: Bryan_Paris_@bparispoker ($19200 in chips)
Bryan_Paris_@bparispoker: posts small blind $50
DeepStack: posts big blind $100
*** HOLE CARDS ***
Dealt to DeepStack [4d 7c]
Dealt to Bryan_Paris_@bparispoker [9s Jh]
Bryan_Paris_@bparispoker: raises $200 to $300
DeepStack: folds
Uncalled bet ($200) returned to Bryan_Paris_@bparispoker
Bryan_Paris_@bparispoker collected $200 from the pot
*** SUMMARY ***
Total pot $200 | Rake $0
Seat 1: DeepStack (big blind) folded before the Flop
Seat 2: Bryan_Paris_@bparispoker (button) (small blind) collected ($200)

PokerStars Hand #13000300008: Tournament #4, May4_2017-at-15_13_17 Hold'em No Limit ($50/$100 USD) - 2017/05/04 17:13:24 ET
Table 'ACPC Match' 2-max Seat #1 is the button
Seat 1: DeepStack ($20700 in chips)
Seat 2: Bryan_Paris_@bparispoker ($19300 in chips)
DeepStack: posts small blind $50
Bryan_Paris_@bparispoker: posts big blind $100
*** HOLE CARDS ***
Dealt to DeepStack [Ac 8s]
Dealt to Bryan_Paris_@bparispoker [Ks 5c]
DeepStack: raises $200 to $300
Bryan_Paris_@bparispoker: folds
Uncalled bet ($200) returned to DeepStack
DeepStack collected $200 from the pot
*** SUMMARY ***
Total pot $200 | Rake $0
Seat 1: DeepStack (button) (small blind) collected ($200)
Seat 2: Bryan_Paris_@bparispoker (big blind) folded before the Flop

PokerStars Hand #13000300009: Tournament #4, May4_2017-at-15_13_17 Hold'em No Limit ($50/$100 USD) - 2017/05/04 17:13:25 ET
Table 'ACPC Match' 2-max Seat #2 is the button
Seat 1: DeepStack ($20800 in chips)
Seat 2: Bryan_Paris_@bparispoker ($19200 in chips)
Bryan_Paris_@bparispoker: posts small blind $50
DeepStack: posts big blind $100
*** HOLE CARDS ***
Dealt to DeepStack [8d Jh]
Dealt to Bryan_Paris_@bparispoker [3d 3s]
Bryan_Paris_@bparispoker: raises $200 to $300
DeepStack: calls $200
*** FLOP **** [2c 7s 7c]
DeepStack: checks
Bryan_Paris_@bparispoker: raises $300 to $300
DeepStack: folds
Uncalled bet ($300) returned to Bryan_Paris_@bparispoker
Bryan_Paris_@bparispoker collected $600 from the pot
*** SUMMARY ***
Total pot $600 | Rake $0
Board [2c 7s 7c]
Seat 1: DeepStack (big blind) folded on the Flop
Seat 2: Bryan_Paris_@bparispoker (button) (small blind) collected ($600)

PokerStars Hand #13000300010: Tournament #4, May4_2017-at-15_13_17 Hold'em No Limit ($50/$100 USD) - 2017/05/04 17:13:26 ET
Table 'ACPC Match' 2-max Seat #1 is the button
Seat 1: DeepStack ($20500 in chips)
Seat 2: Bryan_Paris_@bparispoker ($19500 in chips)
DeepStack: posts small blind $50
Bryan_Paris_@bparispoker: posts big blind $100
*** HOLE CARDS ***
Dealt to DeepStack [3d Js]
Dealt to Bryan_Paris_@bparispoker [Ks 8d]
DeepStack: calls $50
Bryan_Paris_@bparispoker: checks
*** FLOP **** [5s Jh 6d]
Bryan_Paris_@bparispoker: checks
DeepStack: checks
*** TURN **** [8h]
Bryan_Paris_@bparispoker: bets $200
DeepStack: calls $200
*** RIVER **** [9c]
Bryan_Paris_@bparispoker: checks
DeepStack: checks
*** SHOW DOWN ***
Bryan_Paris_@bparispoker: shows [Ks 8d] (a pair of Eights)
DeepStack: shows [3d Js] (a pair of Jacks)
DeepStack collected $600 from pot
*** SUMMARY ***
Total pot $600 | Rake $0
Board [5s Jh 6d 8h 9c]
Seat 1: DeepStack (button) (small blind) showed [3d Js] and won ($600) with a pair of Jacks
Seat 2: Bryan_Paris_@bparispoker (big blind) showed [Ks 8d] and lost with a pair of Eights

PokerStars Hand #13000300011: Tournament #4, May4_2017-at-15_13_17 Hold'em No Limit ($75/$150 USD) - 2017/05/04 17:13:27 ET
Table 'ACPC Match' 2-max Seat #2 is the button
Seat 1: DeepStack ($20800 in chips)
Seat 2: Bryan_Paris_@bparispoker ($19200 in chips)
Bryan_Paris_@bparispoker: posts small blind $75
DeepStack: posts big blind $150
*** HOLE CARDS ***
Dealt to DeepStack [Qc 6d]
Dealt to Bryan_Paris_@bparispoker [Qs 2d]
Bryan_Paris_@bparispoker: folds
Uncalled bet ($75) returned to DeepStack
DeepStack collected $150 from the pot
*** SUMMARY ***
Total pot $150 | Rake $0
Seat 1: DeepStack (big blind) collected ($150)
Seat 2: Bryan_Paris_@bparispoker (button) (small blind) folded before the Flop

PokerStars Hand #13000300012: Tournament #4, May4_2017-at-15_13_17 Hold'em No Limit ($75/$150 USD) - 2017/05/04 17:13:28 ET
Table 'ACPC Match' 2-max Seat #1 is the button
Seat 1: DeepStack ($20875 in chips)
Seat 2: Bryan_Paris_@bparispoker ($19125 in chips)
DeepStack: posts small blind $75
Bryan_Paris_@bparispoker: posts big blind $150
*** HOLE CARDS ***
Dealt to DeepStack [7d 2c]
Dealt to Bryan_Paris_@bparispoker [Ac Js]
DeepStack: folds
Uncalled bet ($75) returned to Bryan_Paris_@bparispoker
Bryan_Paris_@bparispoker collected $150 from the pot
*** SUMMARY ***
Total pot $150 | Rake $0
Seat 1: DeepStack (button) (small blind) folded before the Flop
Seat 2: Bryan_Paris_@bparispoker (big blind) collected ($150)

PokerStars Hand #13000300013: Tournament #4, May4_2017-at-15_13_17 Hold'em No Limit ($75/$150 USD) - 2017/05/04 17:13:29 ET
Table 'ACPC Match' 2-max Seat #2 is the button
Seat 1: DeepStack ($20800 in chips)
Seat 2: Bryan_Paris_@bparispoker ($19200 in chips)
Bryan_Paris_@bparispoker: posts small blind $75
DeepStack: posts big blind $150
*** HOLE CARDS ***
Dealt to DeepStack [4s Kh]
Dealt to Bryan_Paris_@bparispoker [3d Ah]
Bryan_Paris_@bparispoker: raises $300 to $450
DeepStack: folds
Uncalled bet ($300) returned to Bryan_Paris_@bparispoker
Bryan_Paris_@bparispoker collected $300 from the pot
*** SUMMARY ***
Total pot $300 | Rake $0
Seat 1: DeepStack (big blind) folded before the Flop
Seat 2: Bryan_Paris_@bparispoker (button) (small blind) collected ($300)

PokerStars Hand #13000300014: Tournament #4, May4_2017-at-15_13_17 Hold'em No Limit ($75/$150 USD) - 2017/05/04 17:13:30 ET
Table 'ACPC Match' 2-max Seat #1 is the button
Seat 1: DeepStack ($20650 in chips)
Seat 2: Bryan_Paris_@bparispoker ($19350 in chips)
DeepStack: posts small blind $75
Bryan_Paris_@bparispoker: posts big blind $150
*** HOLE CARDS ***
Dealt to DeepStack [9d Kd]
Dealt to Bryan_Paris_@bparispoker [3d Kh]
DeepStack: calls $75
Bryan_Paris_@bparispoker: checks
*** FLOP **** [9s Qh 7h]
Bryan_Paris_@bparispoker: checks
DeepStack: checks
*** TURN **** [3c]
Bryan_Paris_@bparispoker: checks
DeepStack: checks
*** RIVER **** [4s]
Bryan_Paris_@bparispoker: checks
DeepStack: raises $300 to $300
Bryan_Paris_@bparispoker: calls $300
*** SHOW DOWN ***
DeepStack: shows [9d Kd] (a pair of Nines)
Bryan_Paris_@bparispoker: shows [3d Kh] (a pair of Threes)
DeepStack collected $900 from pot
*** SUMMARY ***
Total pot $900 | Rake $0
Board [9s Qh 7h 3c 4s]
Seat 1: DeepStack (button) (small blind) showed [9d Kd] and won ($900) with a pair of Nines
Seat 2: Bryan_Paris_@bparispoker (big blind) showed [3d Kh] and lost with a pair of Threes

PokerStars Hand #13000300015: Tournament #4, May4_2017-at-15_13_17 Hold'em No Limit ($75/$150 USD) - 2017/05/04 17:13:31 ET
Table 'ACPC Match' 2-max Seat #2 is the button
Seat 1: DeepStack ($21100 in chips)
Seat 2: Bryan_Paris_@bparispoker ($18900 in chips)
Bryan_Paris_@bparispoker: posts small blind $75
DeepStack: posts big blind $150
*** HOLE CARDS ***
Dealt to DeepStack [Js 9s]
Dealt to Bryan_Paris_@bparispoker [Tc Qh]
Bryan_Paris_@bparispoker: raises $300 to $450
DeepStack: raises $900 to $1350
Bryan_Paris_@bparispoker: calls $900
*** FLOP **** [Kc 2d Ts]
DeepStack: bets $1350
Bryan_Paris_@bparispoker: calls $1350
*** TURN **** [9d]
DeepStack: checks
Bryan_Paris_@bparispoker: checks
*** RIVER **** [As]
DeepStack: bets $5400
Bryan_Paris_@bparispoker: folds
Uncalled bet ($5400) returned to DeepStack
DeepStack collected $5400 from the pot
*** SUMMARY ***
Total pot $5400 | Rake $0
Board [Kc 2d Ts 9d As]
Seat 1: DeepStack (big blind) collected ($5400)
Seat 2: Bryan_Paris_@bparispoker (button) (small blind) folded on the River

PokerStars Hand #13000300016: Tournament #4, May4_2017-at-15_13_17 Hold'em No Limit ($75/$150 USD) - 2017/05/04 17:13:32 ET
Table 'ACPC Match' 2-max Seat #1 is the button
Seat 1: DeepStack ($23800 in chips)
Seat 2: Bryan_Paris_@bparispoker ($16200 in chips)
DeepStack: posts small blind $75
Bryan_Paris_@bparispoker: posts big blind $150
*** HOLE CARDS ***
Dealt to DeepStack [Jc 9s]
Dealt to Bryan_Paris_@bparispoker [5c 5h]
DeepStack: raises $150 to $300
Bryan_Paris_@bparispoker: calls $150
*** FLOP **** [Ks 3s 4d]
Bryan_Paris_@bparispoker: checks
DeepStack: raises $300 to $300
Bryan_Paris_@bparispoker: raises $800 to $1100
DeepStack: folds
Uncalled bet ($800) returned to Bryan_Paris_@bparispoker
Bryan_Paris_@bparispoker collected $1200 from the pot
*** SUMMARY ***
Total pot $1200 | Rake $0
Board [Ks 3s 4d]
Seat 1: DeepStack (button) (small blind) folded on the Flop
Seat 2: Bryan_Paris_@bparispoker (big blind) collected ($1200)

PokerStars Hand #13000300017: Tournament #4, May4_2017-at-15_13_17 Hold'em No Limit ($75/$150 USD) - 2017/05/04 17:13:33 ET
Table 'ACPC Match' 2-max Seat #2 is the button
Seat 1: DeepStack ($23200 in chips)
Seat 2: Bryan_Paris_@bparispoker ($16800 in chips)
Bryan_Paris_@bparispoker: posts small blind $75
DeepStack: posts big blind $150
*** HOLE CARDS ***
Dealt to DeepStack [2d 6h]
Dealt to Bryan_Paris_@bparispoker [Jc 5h]
Bryan_Paris_@bparispoker: folds
Uncalled bet ($75) returned to DeepStack
DeepStack collected $150 from the pot
*** SUMMARY ***
Total pot $150 | Rake $0
Seat 1: DeepStack (big blind) collected ($150)
Seat 2: Bryan_Paris_@bparispoker (button) (small blind) folded before the Flop

PokerStars Hand #13000300018: Tournament #4, May4_2017-at-15_13_17 Hold'em No Limit ($75/$150 USD) - 2017/05/04 17:13:34 ET
Table 'ACPC Match' 2-max Seat #1 is the button
Seat 1: DeepStack ($23275 in chips)
Seat 2: Bryan_Paris_@bparispoker ($16725 in chips)
DeepStack: posts small blind $75
Bryan_Paris_@bparispoker: posts big blind $150
*** HOLE CARDS ***
Dealt to DeepStack [3h 6c]
Dealt to Bryan_Paris_@bparispoker [Ac 8c]
DeepStack: calls $75
Bryan_Paris_@bparispoker: raises $450 to $600
DeepStack: folds
Uncalled bet ($450) returned to Bryan_Paris_@bparispoker
Bryan_Paris_@bparispoker collected $300 from the pot
*** SUMMARY ***
Total pot $300 | Rake $0
Seat 1: DeepStack (button) (small blind) folded before the Flop
Seat 2: Bryan_Paris_@bparispoker (big blind) collected ($300)

PokerStars Hand #13000300019: Tournament #4, May4_2017-at-15_13_17 Hold'em No Limit ($75/$150 USD) - 2017/05/04 17:13:35 ET
Table 'ACPC Match' 2-max Seat #2 is the button
Seat 1: DeepStack ($23125 in chips)
Seat 2: Bryan_Paris_@bparispoker ($16875 in chips)
Bryan_Paris_@bparispoker: posts small blind $75
DeepStack: posts big blind $150
*** HOLE CARDS ***
Dealt to DeepStack [9h 6c]
Dealt to Bryan_Paris_@bparispoker [2s Qc]
Bryan_Paris_@bparispoker: raises $300 to $450
DeepStack: folds
Uncalled bet ($300) returned to Bryan_Paris_@bparispoker
Bryan_Paris_@bparispoker collected $300 from the pot
*** SUMMARY ***
Total pot $300 | Rake $0
Seat 1: DeepStack (big blind) folded before the Flop
Seat 2: Bryan_Paris_@bparispoker (button) (small blind) collected ($300)

PokerStars Hand #13000300020: Tournament #4, May4_2017-at-15_13_17 Hold'em No Limit ($75/$150 USD) - 2017/05/04 17:13:36 ET
Table 'ACPC Match' 2-max Seat #1 is the button
Seat 1: DeepStack ($22975 in chips)
Seat 2: Bryan_Paris_@bparispoker ($17025 in chips)
DeepStack: posts small blind $75
Bryan_Paris_@bparispoker: posts big blind $150
*** HOLE CARDS ***
Dealt to DeepStack [Th 7h]
Dealt to Bryan_Paris_@bparispoker [4s 7s]
DeepStack: calls $75
Bryan_Paris_@bparispoker: checks
*** FLOP **** [Qc 9d 9c]
Bryan_Paris_@bparispoker: checks
DeepStack: raises $150 to $150
Bryan_Paris_@bparispoker: folds
Uncalled bet ($150) returned to DeepStack
DeepStack collected $300 from the pot
*** SUMMARY ***
Total pot $300 | Rake $0
Board [Qc 9d 9c]
Seat 1: DeepStack (button) (small blind) collected ($300)
Seat 2: Bryan_Paris_@bparispoker (big blind) folded on the Flop

PokerStars Hand #13000300021: Tournament #4, May4_2017-at-15_13_17 Hold'em No Limit ($100/$200 USD) - 2017/05/04 17:13:37 ET
Table 'ACPC Match' 2-max Seat #2 is the button
Seat 1: DeepStack ($23125 in chips)
Seat 2: Bryan_Paris_@bparispoker ($16875 in chips)
Bryan_Paris_@bparispoker: posts small blind $100
DeepStack: posts big blind $200
*** HOLE CARDS ***
Dealt to DeepStack [4d 7d]
Dealt to Bryan_Paris_@bparispoker [Qd 7s]
Bryan_Paris_@bparispoker: raises $400 to $600
DeepStack: calls $400
*** FLOP **** [Ac Th 5s]
DeepStack: checks
Bryan_Paris_@bparispoker: checks
*** TURN **** [3h]
DeepStack: bets $1200
Bryan_Paris_@bparispoker: folds
Uncalled bet ($1200) returned to DeepStack
DeepStack collected $1200 from the pot
*** SUMMARY ***
Total pot $1200 | Rake $0
Board [Ac Th 5s 3h]
Seat 1: DeepStack (big blind) collected ($1200)
Seat 2: Bryan_Paris_@bparispoker (button) (small blind) folded on the Turn

PokerStars Hand #13000300022: Tournament #4, May4_2017-at-15_13_17 Hold'em No Limit ($100/$200 USD) - 2017/05/04 17:13:38 ET
Table 'ACPC Match' 2-max Seat #1 is the button
Seat 1: DeepStack ($23725 in chips)
Seat 2: Bryan_Paris_@bparispoker ($16275 in chips)
DeepStack: posts small blind $100
Bryan_Paris_@bparispoker: posts big blind $200
*** HOLE CARDS ***
Dealt to DeepStack [4h 2d]
Dealt to Bryan_Paris_@bparispoker [9d 9c]
DeepStack: folds
Uncalled bet ($100) returned to Bryan_Paris_@bparispoker
Bryan_Paris_@bparispoker collected $200 from the pot
*** SUMMARY ***
Total pot $200 | Rake $0
Seat 1: DeepStack (button) (small blind) folded before the Flop
Seat 2: Bryan_Paris_@bparispoker (big blind) collected ($200)

PokerStars Hand #13000300023: Tournament #4, May4_2017-at-15_13_17 Hold'em No Limit ($100/$200 USD) - 2017/05/04 17:13:39 ET
Table 'ACPC Match' 2-max Seat #2 is the button
Seat 1: DeepStack ($23625 in chips)
Seat 2: Bryan_Paris_@bparispoker ($16375 in chips)
Bryan_Paris_@bparispoker: posts small blind $100
DeepStack: posts big blind $200
*** HOLE CARDS ***
Dealt to DeepStack [4h 8s]
Dealt to Bryan_Paris_@bparispoker [6c Ad]
Bryan_Paris_@bparispoker: raises $400 to $600
DeepStack: folds
Uncalled bet ($400) returned to Bryan_Paris_@bparispoker
Bryan_Paris_@bparispoker collected $400 from the pot
*** SUMMARY ***
Total pot $400 | Rake $0
Seat 1: DeepStack (big blind) folded before the Flop
Seat 2: Bryan_Paris_@bparispoker (button) (small blind) collected ($400)

PokerStars Hand #13000300024: Tournament #4, May4_2017-at-15_13_17 Hold'em No Limit ($100/$200 USD) - 2017/05/04 17:13:40 ET
Table 'ACPC Match' 2-max Seat #1 is the button
Seat 1: DeepStack ($23425 in chips)
Seat 2: Bryan_Paris_@bparispoker ($16575 in chips)
DeepStack: posts small blind $100
Bryan_Paris_@bparispoker: posts big blind $200
*** HOLE CARDS ***
Dealt to DeepStack [8s Kh]
Dealt to Bryan_Paris_@bparispoker [8c Td]
DeepStack: calls $100
Bryan_Paris_@bparispoker: checks
*** FLOP **** [5s 8h Ad]
Bryan_Paris_@bparispoker: checks
DeepStack: raises $200 to $200
Bryan_Paris_@bparispoker: calls $200
*** TURN **** [4s]
Bryan_Paris_@bparispoker: checks
DeepStack: raises $800 to $800
Bryan_Paris_@bparispoker: folds
Uncalled bet ($800) returned to DeepStack
DeepStack collected $800 from the pot
*** SUMMARY ***
Total pot $800 | Rake $0
Board [5s 8h Ad 4s]
Seat 1: DeepStack (button) (small blind) collected ($800)
Seat 2: Bryan_Paris_@bparispoker (big blind) folded on the Turn

PokerStars Hand #13000300025: Tournament #4, May4_2017-at-15_13_17 Hold'em No Limit ($100/$200 USD) - 2017/05/04 17:13:41 ET
Table 'ACPC Match' 2-max Seat #2 is the button
Seat 1: DeepStack ($23825 in chips)
Seat 2: Bryan_Paris_@bparispoker ($16175 in chips)
Bryan_Paris_@bparispoker: posts small blind $100
DeepStack: posts big blind $200
*** HOLE CARDS ***
Dealt to DeepStack [6d 8h]
Dealt to Bryan_Paris_@bparispoker [Ts 2c]
Bryan_Paris_@bparispoker: folds
Uncalled bet ($100) returned to DeepStack
DeepStack collected $200 from the pot
*** SUMMARY ***
Total pot $200 | Rake $0
Seat 1: DeepStack (big blind) collected ($200)
Seat 2: Bryan_Paris_@bparispoker (button) (small blind) folded before the Flop

PokerStars Hand #13000300026: Tournament #4, May4_2017-at-15_13_17 Hold'em No Limit ($100/$200 USD) - 2017/05/04 17:13:42 ET
Table 'ACPC Match' 2-max Seat #1 is the button
Seat 1: DeepStack ($23925 in chips)
Seat 2: Bryan_Paris_@bparispoker ($16075 in chips)
DeepStack: posts small blind $100
Bryan_Paris_@bparispoker: posts big blind $200
*** HOLE CARDS ***
Dealt to DeepStack [5s 9c]
Dealt to Bryan_Paris_@bparispoker [3c 3h]
DeepStack: calls $100
Bryan_Paris_@bparispoker: checks
*** FLOP **** [4s Kc Qh]
Bryan_Paris_@bparispoker: checks
DeepStack: checks
*** TURN **** [9d]
Bryan_Paris_@bparispoker: checks
DeepStack: checks
*** RIVER **** [7h]
Bryan_Paris_@bparispoker: checks
DeepStack: raises $200 to $200
Bryan_Paris_@bparispoker: folds
Uncalled bet ($200) returned to DeepStack
DeepStack collected $400 from the pot
*** SUMMARY ***
Total pot $400 | Rake $0
Board [4s Kc Qh 9d 7h]
Seat 1: DeepStack (button) (small blind) collected ($400)
Seat 2: Bryan_Paris_@bparispoker (big blind) folded on the River

PokerStars Hand #13000300027: Tournament #4, May4_2017-at-15_13_17 Hold'em No Limit ($100/$200 USD) - 2017/05/04 17:13:43 ET
Table 'ACPC Match' 2-max Seat #2 is the button
Seat 1: DeepStack ($24125 in chips)
Seat 2: Bryan_Paris_@bparispoker ($15875 in chips)
Bryan_Paris_@bparispoker: posts small blind $100
DeepStack: posts big blind $200
*** HOLE CARDS ***
Dealt to DeepStack [2d Td]
Dealt to Bryan_Paris_@bparispoker [5s 7c]
Bryan_Paris_@bparispoker: folds
Uncalled bet ($100) returned to DeepStack
DeepStack collected $200 from the pot
*** SUMMARY ***
Total pot $200 | Rake $0
Seat 1: DeepStack (big blind) collected ($200)
Seat 2: Bryan_Paris_@bparispoker (button) (small blind) folded before the Flop

PokerStars Hand #13000300028: Tournament #4, May4_2017-at-15_13_17 Hold'em No Limit ($100/$200 USD) - 2017/05/04 17:13:44 ET
Table 'ACPC Match' 2-max Seat #1 is the button
Seat 1: DeepStack ($24225 in chips)
Seat 2: Bryan_Paris_@bparispoker ($15775 in chips)
DeepStack: posts small blind $100
Bryan_Paris_@bparispoker: posts big blind $200
*** HOLE CARDS ***
Dealt to DeepStack [Tc 5h]
Dealt to Bryan_Paris_@bparispoker [Qs 7s]
DeepStack: calls $100
Bryan_Paris_@bparispoker: checks
*** FLOP **** [Kd Jh Kh]
Bryan_Paris_@bparispoker: checks
DeepStack: checks
*** TURN **** [Qh]
Bryan_Paris_@bparispoker: bets $300
DeepStack: calls $300
*** RIVER **** [Ad]
Bryan_Paris_@bparispoker: checks
DeepStack: raises $1000 to $1000
Bryan_Paris_@bparispoker: folds
Uncalled bet ($1000) returned to DeepStack
DeepStack collected $1000 from the pot
*** SUMMARY ***
Total pot $1000 | Rake $0
Board [Kd Jh Kh Qh Ad]
Seat 1: DeepStack (button) (small blind) collected ($1000)
Seat 2: Bryan_Paris_@bparispoker (big blind) folded on the River

PokerStars Hand #13000300029: Tournament #4, May4_2017-at-15_13_17 Hold'em No Limit ($100/$200 USD) - 2017/05/04 17:13:45 ET
Table 'ACPC Match' 2-max Seat #2 is the button
Seat 1: DeepStack ($24725 in chips)
Seat 2: Bryan_Paris_@bparispoker ($15275 in chips)
Bryan_Paris_@bparispoker: posts small blind $100
DeepStack: posts big blind $200
*** HOLE CARDS ***
Dealt to DeepStack [9h Ad]
Dealt to Bryan_Paris_@bparispoker [4d 4c]
Bryan_Paris_@bparispoker: raises $400 to $600
DeepStack: calls $400
*** FLOP **** [5d 6c Jd]
DeepStack: checks
Bryan_Paris_@bparispoker: checks
*** TURN **** [2s]
DeepStack: checks
Bryan_Paris_@bparispoker: raises $650 to $650
DeepStack: calls $650
*** RIVER **** [2d]
DeepStack: checks
Bryan_Paris_@bparispoker: checks
*** SHOW DOWN ***
DeepStack: shows [9h Ad] (a pair of Deuces)
Bryan_Paris_@bparispoker: shows [4d 4c] (two pair, Fours and Deuces)
Bryan_Paris_@bparispoker collected $2500 from pot
*** SUMMARY ***
Total pot $2500 | Rake $0
Board [5d 6c Jd 2s 2d]
Seat 1: DeepStack (big blind) showed [9h Ad] and lost with a pair of Deuces
Seat 2: Bryan_Paris_@bparispoker (button) (small blind) showed [4d 4c] and won ($2500) with two pair, Fours and Deuces

PokerStars Hand #13000300030: Tournament #4, May4_2017-at-15_13_17 Hold'em No Limit ($100/$200 USD) - 2017/05/04 17:13:46 ET
Table 'ACPC Match' 2-max Seat #1 is the button
Seat 1: DeepStack ($23475 in chips)
Seat 2: Bryan_Paris_@bparispoker ($16525 in chips)
DeepStack: posts small blind $100
Bryan_Paris_@bparispoker: posts big blind $200
*** HOLE CARDS ***
Dealt to DeepStack [8h Ad]
Dealt to Bryan_Paris_@bparispoker [3d Th]
DeepStack: raises $200 to $400
Bryan_Paris_@bparispoker: folds
Uncalled bet ($200) returned to DeepStack
DeepStack collected $400 from the pot
*** SUMMARY ***
Total pot $400 | Rake $0
Seat 1: DeepStack (button) (small blind) collected ($400)
Seat 2: Bryan_Paris_@bparispoker (big blind) folded before the Flop

PokerStars Hand #13000300031: Tournament #4, May4_2017-at-15_13_17 Hold'em No Limit ($150/$300 USD) - 2017/05/04 17:13:47 ET
Table 'ACPC Match' 2-max Seat #2 is the button
Seat 1: DeepStack ($23675 in chips)
Seat 2: Bryan_Paris_@bparispoker ($16325 in chips)
Bryan_Paris_@bparispoker: posts small blind $150
DeepStack: posts big blind $300
*** HOLE CARDS ***
Dealt to DeepStack [8d 2h]
Dealt to Bryan_Paris_@bparispoker [As Jd]
Bryan_Paris_@bparispoker: raises $500 to $800
DeepStack: folds
Uncalled bet ($500) returned to Bryan_Paris_@bparispoker
Bryan_Paris_@bparispoker collected $600 from the pot
*** SUMMARY ***
Total pot $600 | Rake $0
Seat 1: DeepStack (big blind) folded before the Flop
Seat 2: Bryan_Paris_@bparispoker (button) (small blind) collected ($600)

PokerStars Hand #13000300032: Tournament #4, May4_2017-at-15_13_17 Hold'em No Limit ($150/$300 USD) - 2017/05/04 17:13:48 ET
Table 'ACPC Match' 2-max Seat #1 is the button
Seat 1: DeepStack ($23375 in chips)
Seat 2: Bryan_Paris_@bparispoker ($16625 in chips)
DeepStack: posts small blind $150
Bryan_Paris_@bparispoker: posts big blind $300
*** HOLE CARDS ***
Dealt to DeepStack [5d 2s]
Dealt to Bryan_Paris_@bparispoker [4c Kc]
DeepStack: folds
Uncalled bet ($150) returned to Bryan_Paris_@bparispoker
Bryan_Paris_@bparispoker collected $300 from the pot
*** SUMMARY ***
Total pot $300 | Rake $0
Seat 1: DeepStack (button) (small blind) folded before the Flop
Seat 2: Bryan_Paris_@bparispoker (big blind) collected ($300)

PokerStars Hand #13000300033: Tournament #4, May4_2017-at-15_13_17 Hold'em No Limit ($150/$300 USD) - 2017/05/04 17:13:49 ET
Table 'ACPC Match' 2-max Seat #2 is the button
Seat 1: DeepStack ($23225 in chips)
Seat 2: Bryan_Paris_@bparispoker ($16775 in chips)
Bryan_Paris_@bparispoker: posts small blind $150
DeepStack: posts big blind $300
*** HOLE CARDS ***
Dealt to DeepStack [Ad Qd]
Dealt to Bryan_Paris_@bparispoker [9s 8d]
Bryan_Paris_@bparispoker: raises $500 to $800
DeepStack: raises $1600 to $2400
Bryan_Paris_@bparispoker: folds
Uncalled bet ($1600) returned to DeepStack
DeepStack collected $1600 from the pot
*** SUMMARY ***
Total pot $1600 | Rake $0
Seat 1: DeepStack (big blind) collected ($1600)
Seat 2: Bryan_Paris_@bparispoker (button) (small blind) folded before the Flop

PokerStars Hand #13000300034: Tournament #4, May4_2017-at-15_13_17 Hold'em No Limit ($150/$300 USD) - 2017/05/04 17:13:50 ET
Table 'ACPC Match' 2-max Seat #1 is the button
Seat 1: DeepStack ($24025 in chips)
Seat 2: Bryan_Paris_@bparispoker ($15975 in chips)
DeepStack: posts small blind $150
Bryan_Paris_@bparispoker: posts big blind $300
*** HOLE CARDS ***
Dealt to DeepStack [3h Kc]
Dealt to Bryan_Paris_@bparispoker [7c 4s]
DeepStack: raises $600 to $900
Bryan_Paris_@bparispoker: folds
Uncalled bet ($600) returned to DeepStack
DeepStack collected $600 from the pot
*** SUMMARY ***
Total pot $600 | Rake $0
Seat 1: DeepStack (button) (small blind) collected ($600)
Seat 2: Bryan_Paris_@bparispoker (big blind) folded before the Flop

PokerStars Hand #13000300035: Tournament #4, May4_2017-at-15_13_17 Hold'em No Limit ($150/$300 USD) - 2017/05/04 17:13:51 ET
Table 'ACPC Match' 2-max Seat #2 is the button
Seat 1: DeepStack ($24325 in chips)
Seat 2: Bryan_Paris_@bparispoker ($15675 in chips)
Bryan_Paris_@bparispoker: posts small blind $150
DeepStack: posts big blind $300
*** HOLE CARDS ***
Dealt to DeepStack [2d Kd]
Dealt to Bryan_Paris_@bparispoker [Th 4s]
Bryan_Paris_@bparispoker: folds
Uncalled bet ($150) returned to DeepStack
DeepStack collected $300 from the pot
*** SUMMARY ***
Total pot $300 | Rake $0
Seat 1: DeepStack (big blind) collected ($300)
Seat 2: Bryan_Paris_@bparispoker (button) (small blind) folded before the Flop

PokerStars Hand #13000300036: Tournament #4, May4_2017-at-15_13_17 Hold'em No Limit ($150/$300 USD) - 2017/05/04 17:13:52 ET
Table 'ACPC Match' 2-max Seat #1 is the button
Seat 1: DeepStack ($24475 in chips)
Seat 2: Bryan_Paris_@bparispoker ($15525 in chips)
DeepStack: posts small blind $150
Bryan_Paris_@bparispoker: posts big blind $300
*** HOLE CARDS ***
Dealt to DeepStack [Kd 3h]
Dealt to Bryan_Paris_@bparispoker [Jd Ac]
DeepStack: calls $150
Bryan_Paris_@bparispoker: raises $750 to $1050
DeepStack: calls $750
*** FLOP **** [6d As 5h]
Bryan_Paris_@bparispoker: bets $1325
DeepStack: folds
Uncalled bet ($1325) returned to Bryan_Paris_@bparispoker
Bryan_Paris_@bparispoker collected $2100 from the pot
*** SUMMARY ***
Total pot $2100 | Rake $0
Board [6d As 5h]
Seat 1: DeepStack (button) (small blind) folded on the Flop
Seat 2: Bryan_Paris_@bparispoker (big blind) collected ($2100)

PokerStars Hand #13000300037: Tournament #4, May4_2017-at-15_13_17 Hold'em No Limit ($150/$300 USD) - 2017/05/04 17:13:53 ET
Table 'ACPC Match' 2-max Seat #2 is the button
Seat 1: DeepStack ($23425 in chips)
Seat 2: Bryan_Paris_@bparispoker ($16575 in chips)
Bryan_Paris_@bparispoker: posts small blind $150
DeepStack: posts big blind $300
*** HOLE CARDS ***
Dealt to DeepStack [Qs 2h]
Dealt to Bryan_Paris_@bparispoker [Kh Th]
Bryan_Paris_@bparispoker: raises $500 to $800
DeepStack: folds
Uncalled bet ($500) returned to Bryan_Paris_@bparispoker
Bryan_Paris_@bparispoker collected $600 from the pot
*** SUMMARY ***
Total pot $600 | Rake $0
Seat 1: DeepStack (big blind) folded before the Flop
Seat 2: Bryan_Paris_@bparispoker (button) (small blind) collected ($600)

PokerStars Hand #13000300038: Tournament #4, May4_2017-at-15_13_17 Hold'em No Limit ($150/$300 USD) - 2017/05/04 17:13:54 ET
Table 'ACPC Match' 2-max Seat #1 is the button
Seat 1: DeepStack ($23125 in chips)
Seat 2: Bryan_Paris_@bparispoker ($16875 in chips)
DeepStack: posts small blind $150
Bryan_Paris_@bparispoker: posts big blind $300
*** HOLE CARDS ***
Dealt to DeepStack [Qd 5d]
Dealt to Bryan_Paris_@bparispoker [Tc 2h]
DeepStack: raises $300 to $600
Bryan_Paris_@bparispoker: folds
Uncalled bet ($300) returned to DeepStack
DeepStack collected $600 from the pot
*** SUMMARY ***
Total pot $600 | Rake $0
Seat 1: DeepStack (button) (small blind) collected ($600)
Seat 2: Bryan_Paris_@bparispoker (big blind) folded before the Flop

PokerStars Hand #13000300039: Tournament #4, May4_2017-at-15_13_17 Hold'em No Limit ($150/$300 USD) - 2017/05/04 17:13:55 ET
Table 'ACPC Match' 2-max Seat #2 is the button
Seat 1: DeepStack ($23425 in chips)
Seat 2: Bryan_Paris_@bparispoker ($16575 in chips)
Bryan_Paris_@bparispoker: posts small blind $150
DeepStack: posts big blind $300
*** HOLE CARDS ***
Dealt to DeepStack [Jh 8h]
Dealt to Bryan_Paris_@bparispoker [3h 2h]
Bryan_Paris_@bparispoker: raises $500 to $800
DeepStack: calls $500
*** FLOP **** [9h Ah 2d]
DeepStack: checks
Bryan_Paris_@bparispoker: raises $1150 to $1150
DeepStack: calls $1150
*** TURN **** [6h]
DeepStack: checks
Bryan_Paris_@bparispoker: raises $2325 to $2325
DeepStack: calls $2325
*** RIVER **** [As]
DeepStack: checks
Bryan_Paris_@bparispoker: raises $4300 to $4300
DeepStack: raises $8000 to $12300
Bryan_Paris_@bparispoker: calls $8000 and is all-in
*** SHOW DOWN ***
DeepStack: shows [Jh 8h] (flush, Ace high)
Bryan_Paris_@bparispoker: shows [3h 2h] (flush, Ace high)
DeepStack collected $33150 from pot
*** SUMMARY ***
Total pot $33150 | Rake $0
Board [9h Ah 2d 6h As]
Seat 1: DeepStack (big blind) showed [Jh 8h] and won ($33150) with flush, Ace high
Seat 2: Bryan_Paris_@bparispoker (button) (small blind) showed [3h 2h] and lost with flush, Ace high
