PokerStars Hand #13000100001: Tournament #2, May4_2017-at-13_52_41 Hold'em No Limit ($50/$100 USD) - 2017/05/04 15:52:41 ET
Table 'ACPC Match' 2-max Seat #2 is the button
Seat 1: DeepStack ($20000 in chips)
Seat 2: Bryan_Paris_@bparispoker ($20000 in chips)
Bryan_Paris_@bparispoker: posts small blind $50
DeepStack: posts big blind $100
*** HOLE CARDS ***
Dealt to DeepStack [3d 8c]
Dealt to Bryan_Paris_@bparispoker [2c 5s]
Bryan_Paris_@bparispoker: folds
Uncalled bet ($50) returned to DeepStack
DeepStack collected $100 from the pot
*** SUMMARY ***
Total pot $100 | Rake $0
Seat 1: DeepStack (big blind) collected ($100)
Seat 2: Bryan_Paris_@bparispoker (button) (small blind) folded before the Flop

PokerStars Hand #13000100002: Tournament #2, May4_2017-at-13_52_41 Hold'em No Limit ($50/$100 USD) - 2017/05/04 15:52:42 ET
Table 'ACPC Match' 2-max Seat #1 is the button
Seat 1: DeepStack ($20050 in chips)
Seat 2: Bryan_Paris_@bparispoker ($19950 in chips)
DeepStack: posts small blind $50
Bryan_Paris_@bparispoker: posts big blind $100
*** HOLE CARDS ***
Dealt to DeepStack [3h Js]
Dealt to Bryan_Paris_@bparispoker [Ks 2c]
DeepStack: calls $50
Bryan_Paris_@bparispoker: checks
*** FLOP **** [5c 9h 7c]
Bryan_Paris_@bparispoker: checks
DeepStack: checks
*** TURN **** [5s]
Bryan_Paris_@bparispoker: checks
DeepStack: checks
*** RIVER **** [Qh]
Bryan_Paris_@bparispoker: checks
DeepStack: checks
*** SHOW DOWN ***
Bryan_Paris_@bparispoker: shows [Ks 2c] (a pair of Fives)
DeepStack: shows [3h Js] (a pair of Fives)
Bryan_Paris_@bparispoker collected $200 from pot
*** SUMMARY ***
Total pot $200 | Rake $0
Board [5c 9h 7c 5s Qh]
Seat 1: DeepStack (button) (small blind) showed [3h Js] and lost with a pair of Fives
Seat 2: Bryan_Paris_@bparispoker (big blind) showed [Ks 2c] and won ($200) with a pair of Fives

PokerStars Hand #13000100003: Tournament #2, May4_2017-at-13_52_41 Hold'em No Limit ($50/$100 USD) - 2017/05/04 15:52:43 ET
Table 'ACPC Match' 2-max Seat #2 is the button
Seat 1: DeepStack ($19950 in chips)
Seat 2: Bryan_Paris_@bparispoker ($20050 in chips)
Bryan_Paris_@bparispoker: posts small blind $50
DeepStack: posts big blind $100
*** HOLE CARDS ***
Dealt to DeepStack [Th Ks]
Dealt to Bryan_Paris_@bparispoker [Kd Kc]
Bryan_Paris_@bparispoker: raises $200 to $300
DeepStack: raises $600 to $900
Bryan_Paris_@bparispoker: raises $1750 to $2650
DeepStack: folds
Uncalled bet ($1750) returned to Bryan_Paris_@bparispoker
Bryan_Paris_@bparispoker collected $1800 from the pot
*** SUMMARY ***
Total pot $1800 | Rake $0
Seat 1: DeepStack (big blind) folded before the Flop
Seat 2: Bryan_Paris_@bparispoker (button) (small blind) collected ($1800)

PokerStars Hand #13000100004: Tournament #2, May4_2017-at-13_52_41 Hold'em No Limit ($50/$100 USD) - 2017/05/04 15:52:44 ET
Table 'ACPC Match' 2-max Seat #1 is the button
Seat 1: DeepStack ($19050 in chips)
Seat 2: Bryan_Paris_@bparispoker ($20950 in chips)
DeepStack: posts small blind $50
Bryan_Paris_@bparispoker: posts big blind $100
*** HOLE CARDS ***
Dealt to DeepStack [Jc 7d]
Dealt to Bryan_Paris_@bparispoker [5s 8h]
DeepStack: raises $200 to $300
Bryan_Paris_@bparispoker: folds
Uncalled bet ($200) returned to DeepStack
DeepStack collected $200 from the pot
*** SUMMARY ***
Total pot $200 | Rake $0
Seat 1: DeepStack (button) (small blind) collected ($200)
Seat 2: Bryan_Paris_@bparispoker (big blind) folded before the Flop

PokerStars Hand #13000100005: Tournament #2, May4_2017-at-13_52_41 Hold'em No Limit ($50/$100 USD) - 2017/05/04 15:52:45 ET
Table 'ACPC Match' 2-max Seat #2 is the button
Seat 1: DeepStack ($19150 in chips)
Seat 2: Bryan_Paris_@bparispoker ($20850 in chips)
Bryan_Paris_@bparispoker: posts small blind $50
DeepStack: posts big blind $100
*** HOLE CARDS ***
Dealt to DeepStack [Ad 6c]
Dealt to Bryan_Paris_@bparispoker [4d Ts]
Bryan_Paris_@bparispoker: folds
Uncalled bet ($50) returned to DeepStack
DeepStack collected $100 from the pot
*** SUMMARY ***
Total pot $100 | Rake $0
Seat 1: DeepStack (big blind) collected ($100)
Seat 2: Bryan_Paris_@bparispoker (button) (small blind) folded before the Flop

PokerStars Hand #13000100006: Tournament #2, May4_2017-at-13_52_41 Hold'em No Limit ($50/$100 USD) - 2017/05/04 15:52:46 ET
Table 'ACPC Match' 2-max Seat #1 is the button
Seat 1: DeepStack ($19200 in chips)
Seat 2: Bryan_Paris_@bparispoker ($20800 in chips)
DeepStack: posts small blind $50
Bryan_Paris_@bparispoker: posts big blind $100
*** HOLE CARDS ***
Dealt to DeepStack [6c 7h]
Dealt to Bryan_Paris_@bparispoker [9c 5c]
DeepStack: raises $100 to $200
Bryan_Paris_@bparispoker: calls $100
*** FLOP **** [8s Qh 8d]
Bryan_Paris_@bparispoker: checks
DeepStack: checks
*** TURN **** [Kc]
Bryan_Paris_@bparispoker: checks
DeepStack: checks
*** RIVER **** [5d]
Bryan_Paris_@bparispoker: checks
DeepStack: raises $200 to $200
Bryan_Paris_@bparispoker: calls $200
*** SHOW DOWN ***
DeepStack: shows [6c 7h] (a pair of Eights)
Bryan_Paris_@bparispoker: shows [9c 5c] (two pair, Eights and Fives)
Bryan_Paris_@bparispoker collected $800 from pot
*** SUMMARY ***
Total pot $800 | Rake $0
Board [8s Qh 8d Kc 5d]
Seat 1: DeepStack (button) (small blind) showed [6c 7h] and lost with a pair of Eights
Seat 2: Bryan_Paris_@bparispoker (big blind) showed [9c 5c] and won ($800) with two pair, Eights and Fives

PokerStars Hand #13000100007: Tournament #2, May4_2017-at-13_52_41 Hold'em No Limit ($50/$100 USD) - 2017/05/04 15:52:47 ET
Table 'ACPC Match' 2-max Seat #2 is the button
Seat 1: DeepStack ($18800 in chips)
Seat 2: Bryan_Paris_@bparispoker ($21200 in chips)
Bryan_Paris_@bparispoker: posts small blind $50
DeepStack: posts big blind $100
*** HOLE CARDS ***
Dealt to DeepStack [Jh As]
Dealt to Bryan_Paris_@bparispoker [Kh 9h]
Bryan_Paris_@bparispoker: raises $200 to $300
DeepStack: calls $200
*** FLOP **** [Ad 2d 4c]
DeepStack: checks
Bryan_Paris_@bparispoker: raises $300 to $300
DeepStack: calls $300
*** TURN **** [8h]
DeepStack: checks
Bryan_Paris_@bparispoker: checks
*** RIVER **** [Jc]
DeepStack: bets $600
Bryan_Paris_@bparispoker: folds
Uncalled bet ($600) returned to DeepStack
DeepStack collected $1200 from the pot
*** SUMMARY ***
Total pot $1200 | Rake $0
Board [Ad 2d 4c 8h Jc]
Seat 1: DeepStack (big blind) collected ($1200)
Seat 2: Bryan_Paris_@bparispoker (button) (small blind) folded on the River

PokerStars Hand #13000100008: Tournament #2, May4_2017-at-13_52_41 Hold'em No Limit ($50/$100 USD) - 2017/05/04 15:52:48 ET
Table 'ACPC Match' 2-max Seat #1 is the button
Seat 1: DeepStack ($19400 in chips)
Seat 2: Bryan_Paris_@bparispoker ($20600 in chips)
DeepStack: posts small blind $50
Bryan_Paris_@bparispoker: posts big blind $100
*** HOLE CARDS ***
Dealt to DeepStack [Qc Th]
Dealt to Bryan_Paris_@bparispoker [4s Qh]
DeepStack: raises $200 to $300
Bryan_Paris_@bparispoker: folds
Uncalled bet ($200) returned to DeepStack
DeepStack collected $200 from the pot
*** SUMMARY ***
Total pot $200 | Rake $0
Seat 1: DeepStack (button) (small blind) collected ($200)
Seat 2: Bryan_Paris_@bparispoker (big blind) folded before the Flop

PokerStars Hand #13000100009: Tournament #2, May4_2017-at-13_52_41 Hold'em No Limit ($50/$100 USD) - 2017/05/04 15:52:49 ET
Table 'ACPC Match' 2-max Seat #2 is the button
Seat 1: DeepStack ($19500 in chips)
Seat 2: Bryan_Paris_@bparispoker ($20500 in chips)
Bryan_Paris_@bparispoker: posts small blind $50
DeepStack: posts big blind $100
*** HOLE CARDS ***
Dealt to DeepStack [Js 8s]
Dealt to Bryan_Paris_@bparispoker [Kd 5h]
Bryan_Paris_@bparispoker: raises $200 to $300
DeepStack: raises $600 to $900
Bryan_Paris_@bparispoker: folds
Uncalled bet ($600) returned to DeepStack
DeepStack collected $600 from the pot
*** SUMMARY ***
Total pot $600 | Rake $0
Seat 1: DeepStack (big blind) collected ($600)
Seat 2: Bryan_Paris_@bparispoker (button) (small blind) folded before the Flop

PokerStars Hand #13000100010: Tournament #2, May4_2017-at-13_52_41 Hold'em No Limit ($50/$100 USD) - 2017/05/04 15:52:50 ET
Table 'ACPC Match' 2-max Seat #1 is the button
Seat 1: DeepStack ($19800 in chips)
Seat 2: Bryan_Paris_@bparispoker ($20200 in chips)
DeepStack: posts small blind $50
Bryan_Paris_@bparispoker: posts big blind $100
*** HOLE CARDS ***
Dealt to DeepStack [7s Ah]
Dealt to Bryan_Paris_@bparispoker [Kd 2s]
DeepStack: raises $200 to $300
Bryan_Paris_@bparispoker: folds
Uncalled bet ($200) returned to DeepStack
DeepStack collected $200 from the pot
*** SUMMARY ***
Total pot $200 | Rake $0
Seat 1: DeepStack (button) (small blind) collected ($200)
Seat 2: Bryan_Paris_@bparispoker (big blind) folded before the Flop

PokerStars Hand #13000100011: Tournament #2, May4_2017-at-13_52_41 Hold'em No Limit ($75/$150 USD) - 2017/05/04 15:52:51 ET
Table 'ACPC Match' 2-max Seat #2 is the button
Seat 1: DeepStack ($19900 in chips)
Seat 2: Bryan_Paris_@bparispoker ($20100 in chips)
Bryan_Paris_@bparispoker: posts small blind $75
DeepStack: posts big blind $150
*** HOLE CARDS ***
Dealt to DeepStack [As 8d]
Dealt to Bryan_Paris_@bparispoker [Jc Jd]
Bryan_Paris_@bparispoker: raises $300 to $450
DeepStack: calls $300
*** FLOP **** [Ks 5s 5h]
DeepStack: checks
Bryan_Paris_@bparispoker: checks
*** TURN **** [4s]
DeepStack: checks
Bryan_Paris_@bparispoker: raises $375 to $375
DeepStack: calls $375
*** RIVER **** [8c]
DeepStack: checks
Bryan_Paris_@bparispoker: checks
*** SHOW DOWN ***
DeepStack: shows [As 8d] (two pair, Eights and Fives)
Bryan_Paris_@bparispoker: shows [Jc Jd] (two pair, Jacks and Fives)
Bryan_Paris_@bparispoker collected $1650 from pot
*** SUMMARY ***
Total pot $1650 | Rake $0
Board [Ks 5s 5h 4s 8c]
Seat 1: DeepStack (big blind) showed [As 8d] and lost with two pair, Eights and Fives
Seat 2: Bryan_Paris_@bparispoker (button) (small blind) showed [Jc Jd] and won ($1650) with two pair, Jacks and Fives

PokerStars Hand #13000100012: Tournament #2, May4_2017-at-13_52_41 Hold'em No Limit ($75/$150 USD) - 2017/05/04 15:52:52 ET
Table 'ACPC Match' 2-max Seat #1 is the button
Seat 1: DeepStack ($19075 in chips)
Seat 2: Bryan_Paris_@bparispoker ($20925 in chips)
DeepStack: posts small blind $75
Bryan_Paris_@bparispoker: posts big blind $150
*** HOLE CARDS ***
Dealt to DeepStack [7d 8d]
Dealt to Bryan_Paris_@bparispoker [2h 6h]
DeepStack: raises $300 to $450
Bryan_Paris_@bparispoker: folds
Uncalled bet ($300) returned to DeepStack
DeepStack collected $300 from the pot
*** SUMMARY ***
Total pot $300 | Rake $0
Seat 1: DeepStack (button) (small blind) collected ($300)
Seat 2: Bryan_Paris_@bparispoker (big blind) folded before the Flop

PokerStars Hand #13000100013: Tournament #2, May4_2017-at-13_52_41 Hold'em No Limit ($75/$150 USD) - 2017/05/04 15:52:53 ET
Table 'ACPC Match' 2-max Seat #2 is the button
Seat 1: DeepStack ($19225 in chips)
Seat 2: Bryan_Paris_@bparispoker ($20775 in chips)
Bryan_Paris_@bparispoker: posts small blind $75
DeepStack: posts big blind $150
*** HOLE CARDS ***
Dealt to DeepStack [Qh 9d]
Dealt to Bryan_Paris_@bparispoker [Ad Qd]
Bryan_Paris_@bparispoker: raises $300 to $450
DeepStack: calls $300
*** FLOP **** [7d 6h 4d]
DeepStack: checks
Bryan_Paris_@bparispoker: raises $900 to $900
DeepStack: folds
Uncalled bet ($900) returned to Bryan_Paris_@bparispoker
Bryan_Paris_@bparispoker collected $900 from the pot
*** SUMMARY ***
Total pot $900 | Rake $0
Board [7d 6h 4d]
Seat 1: DeepStack (big blind) folded on the Flop
Seat 2: Bryan_Paris_@bparispoker (button) (small blind) collected ($900)

PokerStars Hand #13000100014: Tournament #2, May4_2017-at-13_52_41 Hold'em No Limit ($75/$150 USD) - 2017/05/04 15:52:54 ET
Table 'ACPC Match' 2-max Seat #1 is the button
Seat 1: DeepStack ($18775 in chips)
Seat 2: Bryan_Paris_@bparispoker ($21225 in chips)
DeepStack: posts small blind $75
Bryan_Paris_@bparispoker: posts big blind $150
*** HOLE CARDS ***
Dealt to DeepStack [7h Kc]
Dealt to Bryan_Paris_@bparispoker [Ac Td]
DeepStack: raises $150 to $300
Bryan_Paris_@bparispoker: raises $1025 to $1325
DeepStack: folds
Uncalled bet ($1025) returned to Bryan_Paris_@bparispoker
Bryan_Paris_@bparispoker collected $600 from the pot
*** SUMMARY ***
Total pot $600 | Rake $0
Seat 1: DeepStack (button) (small blind) folded before the Flop
Seat 2: Bryan_Paris_@bparispoker (big blind) collected ($600)

PokerStars Hand #13000100015: Tournament #2, May4_2017-at-13_52_41 Hold'em No Limit ($75/$150 USD) - 2017/05/04 15:52:55 ET
Table 'ACPC Match' 2-max Seat #2 is the button
Seat 1: DeepStack ($18475 in chips)
Seat 2: Bryan_Paris_@bparispoker ($21525 in chips)
Bryan_Paris_@bparispoker: posts small blind $75
DeepStack: posts big blind $150
*** HOLE CARDS ***
Dealt to DeepStack [3c 9s]
Dealt to Bryan_Paris_@bparispoker [Kd 5d]
Bryan_Paris_@bparispoker: raises $300 to $450
DeepStack: folds
Uncalled bet ($300) returned to Bryan_Paris_@bparispoker
Bryan_Paris_@bparispoker collected $300 from the pot
*** SUMMARY ***
Total pot $300 | Rake $0
Seat 1: DeepStack (big blind) folded before the Flop
Seat 2: Bryan_Paris_@bparispoker (button) (small blind) collected ($300)

PokerStars Hand #13000100016: Tournament #2, May4_2017-at-13_52_41 Hold'em No Limit ($75/$150 USD) - 2017/05/04 15:52:56 ET
Table 'ACPC Match' 2-max Seat #1 is the button
Seat 1: DeepStack ($18325 in chips)
Seat 2: Bryan_Paris_@bparispoker ($21675 in chips)
DeepStack: posts small blind $75
Bryan_Paris_@bparispoker: posts big blind $150
*** HOLE CARDS ***
Dealt to DeepStack [5c Jd]
Dealt to Bryan_Paris_@bparispoker [Kh 3d]
DeepStack: calls $75
Bryan_Paris_@bparispoker: checks
*** FLOP **** [9s Ts Ac]
Bryan_Paris_@bparispoker: checks
DeepStack: checks
*** TURN **** [4d]
Bryan_Paris_@bparispoker: checks
DeepStack: checks
*** RIVER **** [Ah]
Bryan_Paris_@bparispoker: checks
DeepStack: checks
*** SHOW DOWN ***
Bryan_Paris_@bparispoker: shows [Kh 3d] (a pair of Aces)
DeepStack: shows [5c Jd] (a pair of Aces)
Bryan_Paris_@bparispoker collected $300 from pot
*** SUMMARY ***
Total pot $300 | Rake $0
Board [9s Ts Ac 4d Ah]
Seat 1: DeepStack (button) (small blind) showed [5c Jd] and lost with a pair of Aces
Seat 2: Bryan_Paris_@bparispoker (big blind) showed [Kh 3d] and won ($300) with a pair of Aces

PokerStars Hand #13000100017: Tournament #2, May4_2017-at-13_52_41 Hold'em No Limit ($75/$150 USD) - 2017/05/04 15:52:57 ET
Table 'ACPC Match' 2-max Seat #2 is the button
Seat 1: DeepStack ($18175 in chips)
Seat 2: Bryan_Paris_@bparispoker ($21825 in chips)
Bryan_Paris_@bparispoker: posts small blind $75
DeepStack: posts big blind $150
*** HOLE CARDS ***
Dealt to DeepStack [2h Qc]
Dealt to Bryan_Paris_@bparispoker [4d 7d]
Bryan_Paris_@bparispoker: raises $300 to $450
DeepStack: folds
Uncalled bet ($300) returned to Bryan_Paris_@bparispoker
Bryan_Paris_@bparispoker collected $300 from the pot
*** SUMMARY ***
Total pot $300 | Rake $0
Seat 1: DeepStack (big blind) folded before the Flop
Seat 2: Bryan_Paris_@bparispoker (button) (small blind) collected ($300)

PokerStars Hand #13000100018: Tournament #2, May4_2017-at-13_52_41 Hold'em No Limit ($75/$150 USD) - 2017/05/04 15:52:58 ET
Table 'ACPC Match' 2-max Seat #1 is the button
Seat 1: DeepStack ($18025 in chips)
Seat 2: Bryan_Paris_@bparispoker ($21975 in chips)
DeepStack: posts small blind $75
Bryan_Paris_@bparispoker: posts big blind $150
*** HOLE CARDS ***
Dealt to DeepStack [Jd 3d]
Dealt to Bryan_Paris_@bparispoker [Th 4s]
DeepStack: raises $150 to $300
Bryan_Paris_@bparispoker: folds
Uncalled bet ($150) returned to DeepStack
DeepStack collected $300 from the pot
*** SUMMARY ***
Total pot $300 | Rake $0
Seat 1: DeepStack (button) (small blind) collected ($300)
Seat 2: Bryan_Paris_@bparispoker (big blind) folded before the Flop

PokerStars Hand #13000100019: Tournament #2, May4_2017-at-13_52_41 Hold'em No Limit ($75/$150 USD) - 2017/05/04 15:52:59 ET
Table 'ACPC Match' 2-max Seat #2 is the button
Seat 1: DeepStack ($18175 in chips)
Seat 2: Bryan_Paris_@bparispoker ($21825 in chips)
Bryan_Paris_@bparispoker: posts small blind $75
DeepStack: posts big blind $150
*** HOLE CARDS ***
Dealt to DeepStack [2h Ad]
Dealt to Bryan_Paris_@bparispoker [As Qs]
Bryan_Paris_@bparispoker: raises $300 to $450
DeepStack: calls $300
*** FLOP **** [5d 7d 6d]
DeepStack: bets $450
Bryan_Paris_@bparispoker: folds
Uncalled bet ($450) returned to DeepStack
DeepStack collected $900 from the pot
*** SUMMARY ***
Total pot $900 | Rake $0
Board [5d 7d 6d]
Seat 1: DeepStack (big blind) collected ($900)
Seat 2: Bryan_Paris_@bparispoker (button) (small blind) folded on the Flop

PokerStars Hand #13000100020: Tournament #2, May4_2017-at-13_52_41 Hold'em No Limit ($75/$150 USD) - 2017/05/04 15:53:00 ET
Table 'ACPC Match' 2-max Seat #1 is the button
Seat 1: DeepStack ($18625 in chips)
Seat 2: Bryan_Paris_@bparispoker ($21375 in chips)
DeepStack: posts small blind $75
Bryan_Paris_@bparispoker: posts big blind $150
*** HOLE CARDS ***
Dealt to DeepStack [2d 9c]
Dealt to Bryan_Paris_@bparispoker [Qs 7s]
DeepStack: folds
Uncalled bet ($75) returned to Bryan_Paris_@bparispoker
Bryan_Paris_@bparispoker collected $150 from the pot
*** SUMMARY ***
Total pot $150 | Rake $0
Seat 1: DeepStack (button) (small blind) folded before the Flop
Seat 2: Bryan_Paris_@bparispoker (big blind) collected ($150)

PokerStars Hand #13000100021: Tournament #2, May4_2017-at-13_52_41 Hold'em No Limit ($100/$200 USD) - 2017/05/04 15:53:01 ET
Table 'ACPC Match' 2-max Seat #2 is the button
Seat 1: DeepStack ($18550 in chips)
Seat 2: Bryan_Paris_@bparispoker ($21450 in chips)
Bryan_Paris_@bparispoker: posts small blind $100
DeepStack: posts big blind $200
*** HOLE CARDS ***
Dealt to DeepStack [Jd 6c]
Dealt to Bryan_Paris_@bparispoker [Jh 7h]
Bryan_Paris_@bparispoker: raises $400 to $600
DeepStack: folds
Uncalled bet ($400) returned to Bryan_Paris_@bparispoker
Bryan_Paris_@bparispoker collected $400 from the pot
*** SUMMARY ***
Total pot $400 | Rake $0
Seat 1: DeepStack (big blind) folded before the Flop
Seat 2: Bryan_Paris_@bparispoker (button) (small blind) collected ($400)

PokerStars Hand #13000100022: Tournament #2, May4_2017-at-13_52_41 Hold'em No Limit ($100/$200 USD) - 2017/05/04 15:53:02 ET
Table 'ACPC Match' 2-max Seat #1 is the button
Seat 1: DeepStack ($18350 in chips)
Seat 2: Bryan_Paris_@bparispoker ($21650 in chips)
DeepStack: posts small blind $100
Bryan_Paris_@bparispoker: posts big blind $200
*** HOLE CARDS ***
Dealt to DeepStack [9s 3c]
Dealt to Bryan_Paris_@bparispoker [2s Td]
DeepStack: folds
Uncalled bet ($100) returned to Bryan_Paris_@bparispoker
Bryan_Paris_@bparispoker collected $200 from the pot
*** SUMMARY ***
Total pot $200 | Rake $0
Seat 1: DeepStack (button) (small blind) folded before the Flop
Seat 2: Bryan_Paris_@bparispoker (big blind) collected ($200)

PokerStars Hand #13000100023: Tournament #2, May4_2017-at-13_52_41 Hold'em No Limit ($100/$200 USD) - 2017/05/04 15:53:03 ET
Table 'ACPC Match' 2-max Seat #2 is the button
Seat 1: DeepStack ($18250 in chips)
Seat 2: Bryan_Paris_@bparispoker ($21750 in chips)
Bryan_Paris_@bparispoker: posts small blind $100
DeepStack: posts big blind $200
*** HOLE CARDS ***
Dealt to DeepStack [9h 2c]
Dealt to Bryan_Paris_@bparispoker [6d 2s]
Bryan_Paris_@bparispoker: folds
Uncalled bet ($100) returned to DeepStack
DeepStack collected $200 from the pot
*** SUMMARY ***
Total pot $200 | Rake $0
Seat 1: DeepStack (big blind) collected ($200)
Seat 2: Bryan_Paris_@bparispoker (button) (small blind) folded before the Flop

PokerStars Hand #13000100024: Tournament #2, May4_2017-at-13_52_41 Hold'em No Limit ($100/$200 USD) - 2017/05/04 15:53:04 ET
Table 'ACPC Match' 2-max Seat #1 is the button
Seat 1: DeepStack ($18350 in chips)
Seat 2: Bryan_Paris_@bparispoker ($21650 in chips)
DeepStack: posts small blind $100
Bryan_Paris_@bparispoker: posts big blind $200
*** HOLE CARDS ***
Dealt to DeepStack [Ah Js]
Dealt to Bryan_Paris_@bparispoker [Kc 8d]
DeepStack: raises $200 to $400
Bryan_Paris_@bparispoker: calls $200
*** FLOP **** [Jc 3d 9s]
Bryan_Paris_@bparispoker: checks
DeepStack: raises $800 to $800
Bryan_Paris_@bparispoker: folds
Uncalled bet ($800) returned to DeepStack
DeepStack collected $800 from the pot
*** SUMMARY ***
Total pot $800 | Rake $0
Board [Jc 3d 9s]
Seat 1: DeepStack (button) (small blind) collected ($800)
Seat 2: Bryan_Paris_@bparispoker (big blind) folded on the Flop

PokerStars Hand #13000100025: Tournament #2, May4_2017-at-13_52_41 Hold'em No Limit ($100/$200 USD) - 2017/05/04 15:53:05 ET
Table 'ACPC Match' 2-max Seat #2 is the button
Seat 1: DeepStack ($18750 in chips)
Seat 2: Bryan_Paris_@bparispoker ($21250 in chips)
Bryan_Paris_@bparispoker: posts small blind $100
DeepStack: posts big blind $200
*** HOLE CARDS ***
Dealt to DeepStack [6h 2s]
Dealt to Bryan_Paris_@bparispoker [5d Jh]
Bryan_Paris_@bparispoker: raises $400 to $600
DeepStack: folds
Uncalled bet ($400) returned to Bryan_Paris_@bparispoker
Bryan_Paris_@bparispoker collected $400 from the pot
*** SUMMARY ***
Total pot $400 | Rake $0
Seat 1: DeepStack (big blind) folded before the Flop
Seat 2: Bryan_Paris_@bparispoker (button) (small blind) collected ($400)

PokerStars Hand #13000100026: Tournament #2, May4_2017-at-13_52_41 Hold'em No Limit ($100/$200 USD) - 2017/05/04 15:53:06 ET
Table 'ACPC Match' 2-max Seat #1 is the button
Seat 1: DeepStack ($18550 in chips)
Seat 2: Bryan_Paris_@bparispoker ($21450 in chips)
DeepStack: posts small blind $100
Bryan_Paris_@bparispoker: posts big blind $200
*** HOLE CARDS ***
Dealt to DeepStack [6h 7h]
Dealt to Bryan_Paris_@bparispoker [Jc 4s]
DeepStack: raises $400 to $600
Bryan_Paris_@bparispoker: folds
Uncalled bet ($400) returned to DeepStack
DeepStack collected $400 from the pot
*** SUMMARY ***
Total pot $400 | Rake $0
Seat 1: DeepStack (button) (small blind) collected ($400)
Seat 2: Bryan_Paris_@bparispoker (big blind) folded before the Flop

PokerStars Hand #13000100027: Tournament #2, May4_2017-at-13_52_41 Hold'em No Limit ($100/$200 USD) - 2017/05/04 15:53:07 ET
Table 'ACPC Match' 2-max Seat #2 is the button
Seat 1: DeepStack ($18750 in chips)
Seat 2: Bryan_Paris_@bparispoker ($21250 in chips)
Bryan_Paris_@bparispoker: posts small blind $100
DeepStack: posts big blind $200
*** HOLE CARDS ***
Dealt to DeepStack [Ad Ah]
Dealt to Bryan_Paris_@bparispoker [2h 4h]
Bryan_Paris_@bparispoker: raises $400 to $600
DeepStack: raises $1200 to $1800
Bryan_Paris_@bparispoker: folds
Uncalled bet ($1200) returned to DeepStack
DeepStack collected $1200 from the pot
*** SUMMARY ***
Total pot $1200 | Rake $0
Seat 1: DeepStack (big blind) collected ($1200)
Seat 2: Bryan_Paris_@bparispoker (button) (small blind) folded before the Flop

PokerStars Hand #13000100028: Tournament #2, May4_2017-at-13_52_41 Hold'em No Limit ($100/$200 USD) - 2017/05/04 15:53:08 ET
Table 'ACPC Match' 2-max Seat #1 is the button
Seat 1: DeepStack ($19350 in chips)
Seat 2: Bryan_Paris_@bparispoker ($20650 in chips)
DeepStack: posts small blind $100
Bryan_Paris_@bparispoker: posts big blind $200
*** HOLE CARDS ***
Dealt to DeepStack [7c Qc]
Dealt to Bryan_Paris_@bparispoker [9d 2c]
DeepStack: raises $400 to $600
Bryan_Paris_@bparispoker: folds
Uncalled bet ($400) returned to DeepStack
DeepStack collected $400 from the pot
*** SUMMARY ***
Total pot $400 | Rake $0
Seat 1: DeepStack (button) (small blind) collected ($400)
Seat 2: Bryan_Paris_@bparispoker (big blind) folded before the Flop

PokerStars Hand #13000100029: Tournament #2, May4_2017-at-13_52_41 Hold'em No Limit ($100/$200 USD) - 2017/05/04 15:53:09 ET
Table 'ACPC Match' 2-max Seat #2 is the button
Seat 1: DeepStack ($19550 in chips)
Seat 2: Bryan_Paris_@bparispoker ($20450 in chips)
Bryan_Paris_@bparispoker: posts small blind $100
DeepStack: posts big blind $200
*** HOLE CARDS ***
Dealt to DeepStack [As 9h]
Dealt to Bryan_Paris_@bparispoker [2d 8s]
Bryan_Paris_@bparispoker: folds
Uncalled bet ($100) returned to DeepStack
DeepStack collected $200 from the pot
*** SUMMARY ***
Total pot $200 | Rake $0
Seat 1: DeepStack (big blind) collected ($200)
Seat 2: Bryan_Paris_@bparispoker (button) (small blind) folded before the Flop

PokerStars Hand #13000100030: Tournament #2, May4_2017-at-13_52_41 Hold'em No Limit ($100/$200 USD) - 2017/05/04 15:53:10 ET
Table 'ACPC Match' 2-max Seat #1 is the button
Seat 1: DeepStack ($19650 in chips)
Seat 2: Bryan_Paris_@bparispoker ($20350 in chips)
DeepStack: posts small blind $100
Bryan_Paris_@bparispoker: posts big blind $200
*** HOLE CARDS ***
Dealt to DeepStack [7h Kd]
Dealt to Bryan_Paris_@bparispoker [Qd Jd]
DeepStack: raises $200 to $400
Bryan_Paris_@bparispoker: raises $1150 to $1550
DeepStack: folds
Uncalled bet ($1150) returned to Bryan_Paris_@bparispoker
Bryan_Paris_@bparispoker collected $800 from the pot
*** SUMMARY ***
Total pot $800 | Rake $0
Seat 1: DeepStack (button) (small blind) folded before the Flop
Seat 2: Bryan_Paris_@bparispoker (big blind) collected ($800)

PokerStars Hand #13000100031: Tournament #2, May4_2017-at-13_52_41 Hold'em No Limit ($150/$300 USD) - 2017/05/04 15:53:11 ET
Table 'ACPC Match' 2-max Seat #2 is the button
Seat 1: DeepStack ($19250 in chips)
Seat 2: Bryan_Paris_@bparispoker ($20750 in chips)
Bryan_Paris_@bparispoker: posts small blind $150
DeepStack: posts big blind $300
*** HOLE CARDS ***
Dealt to DeepStack [9c Qd]
Dealt to Bryan_Paris_@bparispoker [4h Ad]
Bryan_Paris_@bparispoker: raises $500 to $800
DeepStack: calls $500
*** FLOP **** [Jc 8d 3d]
DeepStack: checks
Bryan_Paris_@bparispoker: raises $1350 to $1350
DeepStack: calls $1350
*** TURN **** [Kh]
DeepStack: checks
Bryan_Paris_@bparispoker: raises $3100 to $3100
DeepStack: folds
Uncalled bet ($3100) returned to Bryan_Paris_@bparispoker
Bryan_Paris_@bparispoker collected $4300 from the pot
*** SUMMARY ***
Total pot $4300 | Rake $0
Board [Jc 8d 3d Kh]
Seat 1: DeepStack (big blind) folded on the Turn
Seat 2: Bryan_Paris_@bparispoker (button) (small blind) collected ($4300)

PokerStars Hand #13000100032: Tournament #2, May4_2017-at-13_52_41 Hold'em No Limit ($150/$300 USD) - 2017/05/04 15:53:12 ET
Table 'ACPC Match' 2-max Seat #1 is the button
Seat 1: DeepStack ($17100 in chips)
Seat 2: Bryan_Paris_@bparispoker ($22900 in chips)
DeepStack: posts small blind $150
Bryan_Paris_@bparispoker: posts big blind $300
*** HOLE CARDS ***
Dealt to DeepStack [3s 5h]
Dealt to Bryan_Paris_@bparispoker [5d Ah]
DeepStack: raises $300 to $600
Bryan_Paris_@bparispoker: calls $300
*** FLOP **** [7s 2c 3d]
Bryan_Paris_@bparispoker: checks
DeepStack: checks
*** TURN **** [Jd]
Bryan_Paris_@bparispoker: checks
DeepStack: checks
*** RIVER **** [Qs]
Bryan_Paris_@bparispoker: checks
DeepStack: checks
*** SHOW DOWN ***
Bryan_Paris_@bparispoker: shows [5d Ah] (Ace high)
DeepStack: shows [3s 5h] (a pair of Threes)
DeepStack collected $1200 from pot
*** SUMMARY ***
Total pot $1200 | Rake $0
Board [7s 2c 3d Jd Qs]
Seat 1: DeepStack (button) (small blind) showed [3s 5h] and won ($1200) with a pair of Threes
Seat 2: Bryan_Paris_@bparispoker (big blind) showed [5d Ah] and lost with Ace high

PokerStars Hand #13000100033: Tournament #2, May4_2017-at-13_52_41 Hold'em No Limit ($150/$300 USD) - 2017/05/04 15:53:13 ET
Table 'ACPC Match' 2-max Seat #2 is the button
Seat 1: DeepStack ($17700 in chips)
Seat 2: Bryan_Paris_@bparispoker ($22300 in chips)
Bryan_Paris_@bparispoker: posts small blind $150
DeepStack: posts big blind $300
*** HOLE CARDS ***
Dealt to DeepStack [Ts 2h]
Dealt to Bryan_Paris_@bparispoker [Jh 6s]
Bryan_Paris_@bparispoker: raises $500 to $800
DeepStack: folds
Uncalled bet ($500) returned to Bryan_Paris_@bparispoker
Bryan_Paris_@bparispoker collected $600 from the pot
*** SUMMARY ***
Total pot $600 | Rake $0
Seat 1: DeepStack (big blind) folded before the Flop
Seat 2: Bryan_Paris_@bparispoker (button) (small blind) collected ($600)

PokerStars Hand #13000100034: Tournament #2, May4_2017-at-13_52_41 Hold'em No Limit ($150/$300 USD) - 2017/05/04 15:53:14 ET
Table 'ACPC Match' 2-max Seat #1 is the button
Seat 1: DeepStack ($17400 in chips)
Seat 2: Bryan_Paris_@bparispoker ($22600 in chips)
DeepStack: posts small blind $150
Bryan_Paris_@bparispoker: posts big blind $300
*** HOLE CARDS ***
Dealt to DeepStack [2c Qh]
Dealt to Bryan_Paris_@bparispoker [Jh 7c]
DeepStack: calls $150
Bryan_Paris_@bparispoker: checks
*** FLOP **** [2s Jd 4s]
Bryan_Paris_@bparispoker: checks
DeepStack: raises $300 to $300
Bryan_Paris_@bparispoker: raises $1000 to $1300
DeepStack: folds
Uncalled bet ($1000) returned to Bryan_Paris_@bparispoker
Bryan_Paris_@bparispoker collected $1200 from the pot
*** SUMMARY ***
Total pot $1200 | Rake $0
Board [2s Jd 4s]
Seat 1: DeepStack (button) (small blind) folded on the Flop
Seat 2: Bryan_Paris_@bparispoker (big blind) collected ($1200)

PokerStars Hand #13000100035: Tournament #2, May4_2017-at-13_52_41 Hold'em No Limit ($150/$300 USD) - 2017/05/04 15:53:15 ET
Table 'ACPC Match' 2-max Seat #2 is the button
Seat 1: DeepStack ($16800 in chips)
Seat 2: Bryan_Paris_@bparispoker ($23200 in chips)
Bryan_Paris_@bparispoker: posts small blind $150
DeepStack: posts big blind $300
*** HOLE CARDS ***
Dealt to DeepStack [Th 9c]
Dealt to Bryan_Paris_@bparispoker [2s 2d]
Bryan_Paris_@bparispoker: raises $500 to $800
DeepStack: calls $500
*** FLOP **** [Ts Jd 6h]
DeepStack: checks
Bryan_Paris_@bparispoker: checks
*** TURN **** [4s]
DeepStack: checks
Bryan_Paris_@bparispoker: checks
*** RIVER **** [Td]
DeepStack: bets $3200
Bryan_Paris_@bparispoker: folds
Uncalled bet ($3200) returned to DeepStack
DeepStack collected $1600 from the pot
*** SUMMARY ***
Total pot $1600 | Rake $0
Board [Ts Jd 6h 4s Td]
Seat 1: DeepStack (big blind) collected ($1600)
Seat 2: Bryan_Paris_@bparispoker (button) (small blind) folded on the River

PokerStars Hand #13000100036: Tournament #2, May4_2017-at-13_52_41 Hold'em No Limit ($150/$300 USD) - 2017/05/04 15:53:16 ET
Table 'ACPC Match' 2-max Seat #1 is the button
Seat 1: DeepStack ($17600 in chips)
Seat 2: Bryan_Paris_@bparispoker ($22400 in chips)
DeepStack: posts small blind $150
Bryan_Paris_@bparispoker: posts big blind $300
*** HOLE CARDS ***
Dealt to DeepStack [Jh Qd]
Dealt to Bryan_Paris_@bparispoker [8s Th]
DeepStack: raises $300 to $600
Bryan_Paris_@bparispoker: calls $300
*** FLOP **** [8h 7c 5d]
Bryan_Paris_@bparispoker: checks
DeepStack: raises $600 to $600
Bryan_Paris_@bparispoker: raises $1700 to $2300
DeepStack: folds
Uncalled bet ($1700) returned to Bryan_Paris_@bparispoker
Bryan_Paris_@bparispoker collected $2400 from the pot
*** SUMMARY ***
Total pot $2400 | Rake $0
Board [8h 7c 5d]
Seat 1: DeepStack (button) (small blind) folded on the Flop
Seat 2: Bryan_Paris_@bparispoker (big blind) collected ($2400)

PokerStars Hand #13000100037: Tournament #2, May4_2017-at-13_52_41 Hold'em No Limit ($150/$300 USD) - 2017/05/04 15:53:17 ET
Table 'ACPC Match' 2-max Seat #2 is the button
Seat 1: DeepStack ($16400 in chips)
Seat 2: Bryan_Paris_@bparispoker ($23600 in chips)
Bryan_Paris_@bparispoker: posts small blind $150
DeepStack: posts big blind $300
*** HOLE CARDS ***
Dealt to DeepStack [Kh Qc]
Dealt to Bryan_Paris_@bparispoker [8h Qd]
Bryan_Paris_@bparispoker: raises $500 to $800
DeepStack: raises $1600 to $2400
Bryan_Paris_@bparispoker: folds
Uncalled bet ($1600) returned to DeepStack
DeepStack collected $1600 from the pot
*** SUMMARY ***
Total pot $1600 | Rake $0
Seat 1: DeepStack (big blind) collected ($1600)
Seat 2: Bryan_Paris_@bparispoker (button) (small blind) folded before the Flop

PokerStars Hand #13000100038: Tournament #2, May4_2017-at-13_52_41 Hold'em No Limit ($150/$300 USD) - 2017/05/04 15:53:18 ET
Table 'ACPC Match' 2-max Seat #1 is the button
Seat 1: DeepStack ($17200 in chips)
Seat 2: Bryan_Paris_@bparispoker ($22800 in chips)
DeepStack: posts small blind $150
Bryan_Paris_@bparispoker: posts big blind $300
*** HOLE CARDS ***
Dealt to DeepStack [8c 3h]
Dealt to Bryan_Paris_@bparispoker [Ad 5h]
DeepStack: folds
Uncalled bet ($150) returned to Bryan_Paris_@bparispoker
Bryan_Paris_@bparispoker collected $300 from the pot
*** SUMMARY ***
Total pot $300 | Rake $0
Seat 1: DeepStack (button) (small blind) folded before the Flop
Seat 2: Bryan_Paris_@bparispoker (big blind) collected ($300)

PokerStars Hand #13000100039: Tournament #2, May4_2017-at-13_52_41 Hold'em No Limit ($150/$300 USD) - 2017/05/04 15:53:19 ET
Table 'ACPC Match' 2-max Seat #2 is the button
Seat 1: DeepStack ($17050 in chips)
Seat 2: Bryan_Paris_@bparispoker ($22950 in chips)
Bryan_Paris_@bparispoker: posts small blind $150
DeepStack: posts big blind $300
*** HOLE CARDS ***
Dealt to DeepStack [Ac 5s]
Dealt to Bryan_Paris_@bparispoker [7h 9c]
Bryan_Paris_@bparispoker: raises $500 to $800
DeepStack: calls $500
*** FLOP **** [2d 6s 5h]
DeepStack: checks
Bryan_Paris_@bparispoker: raises $1400 to $1400
DeepStack: calls $1400
*** TURN **** [4s]
DeepStack: checks
Bryan_Paris_@bparispoker: raises $3250 to $3250
DeepStack: folds
Uncalled bet ($3250) returned to Bryan_Paris_@bparispoker
Bryan_Paris_@bparispoker collected $4400 from the pot
*** SUMMARY ***
Total pot $4400 | Rake $0
Board [2d 6s 5h 4s]
Seat 1: DeepStack (big blind) folded on the Turn
Seat 2: Bryan_Paris_@bparispoker (button) (small blind) collected ($4400)

PokerStars Hand #13000100040: Tournament #2, May4_2017-at-13_52_41 Hold'em No Limit ($150/$300 USD) - 2017/05/04 15:53:20 ET
Table 'ACPC Match' 2-max Seat #1 is the button
Seat 1: DeepStack ($14850 in chips)
Seat 2: Bryan_Paris_@bparispoker ($25150 in chips)
DeepStack: posts small blind $150
Bryan_Paris_@bparispoker: posts big blind $300
*** HOLE CARDS ***
Dealt to DeepStack [Qs 2c]
Dealt to Bryan_Paris_@bparispoker [6s 8h]
DeepStack: calls $150
Bryan_Paris_@bparispoker: checks
*** FLOP **** [3d Qd 5c]
Bryan_Paris_@bparispoker: checks
DeepStack: raises $300 to $300
Bryan_Paris_@bparispoker: folds
Uncalled bet ($300) returned to DeepStack
DeepStack collected $600 from the pot
*** SUMMARY ***
Total pot $600 | Rake $0
Board [3d Qd 5c]
Seat 1: DeepStack (button) (small blind) collected ($600)
Seat 2: Bryan_Paris_@bparispoker (big blind) folded on the Flop

PokerStars Hand #13000100041: Tournament #2, May4_2017-at-13_52_41 Hold'em No Limit ($200/$400 USD) - 2017/05/04 15:53:21 ET
Table 'ACPC Match' 2-max Seat #2 is the button
Seat 1: DeepStack ($15150 in chips)
Seat 2: Bryan_Paris_@bparispoker ($24850 in chips)
Bryan_Paris_@bparispoker: posts small blind $200
DeepStack: posts big blind $400
*** HOLE CARDS ***
Dealt to DeepStack [5c 5d]
Dealt to Bryan_Paris_@bparispoker [Ad 3h]
Bryan_Paris_@bparispoker: raises $700 to $1100
DeepStack: raises $14050 to $15150 and is all-in
Bryan_Paris_@bparispoker: folds
Uncalled bet ($14050) returned to DeepStack
DeepStack collected $2200 from the pot
*** SUMMARY ***
Total pot $2200 | Rake $0
Seat 1: DeepStack (big blind) collected ($2200)
Seat 2: Bryan_Paris_@bparispoker (button) (small blind) folded before the Flop

PokerStars Hand #13000100042: Tournament #2, May4_2017-at-13_52_41 Hold'em No Limit ($200/$400 USD) - 2017/05/04 15:53:22 ET
Table 'ACPC Match' 2-max Seat #1 is the button
Seat 1: DeepStack ($16250 in chips)
Seat 2: Bryan_Paris_@bparispoker ($23750 in chips)
DeepStack: posts small blind $200
Bryan_Paris_@bparispoker: posts big blind $400
*** HOLE CARDS ***
Dealt to DeepStack [9d 5s]
Dealt to Bryan_Paris_@bparispoker [Kh Th]
DeepStack: calls $200
Bryan_Paris_@bparispoker: raises $1150 to $1550
DeepStack: folds
Uncalled bet ($1150) returned to Bryan_Paris_@bparispoker
Bryan_Paris_@bparispoker collected $800 from the pot
*** SUMMARY ***
Total pot $800 | Rake $0
Seat 1: DeepStack (button) (small blind) folded before the Flop
Seat 2: Bryan_Paris_@bparispoker (big blind) collected ($800)

PokerStars Hand #13000100043: Tournament #2, May4_2017-at-13_52_41 Hold'em No Limit ($200/$400 USD) - 2017/05/04 15:53:23 ET
Table 'ACPC Match' 2-max Seat #2 is the button
Seat 1: DeepStack ($15850 in chips)
Seat 2: Bryan_Paris_@bparispoker ($24150 in chips)
Bryan_Paris_@bparispoker: posts small blind $200
DeepStack: posts big blind $400
*** HOLE CARDS ***
Dealt to DeepStack [8d 3d]
Dealt to Bryan_Paris_@bparispoker [5s Qc]
Bryan_Paris_@bparispoker: raises $650 to $1050
DeepStack: calls $650
*** FLOP **** [6h Tc 6s]
DeepStack: checks
Bryan_Paris_@bparispoker: checks
*** TURN **** [2c]
DeepStack: checks
Bryan_Paris_@bparispoker: checks
*** RIVER **** [4h]
DeepStack: checks
Bryan_Paris_@bparispoker: checks
*** SHOW DOWN ***
DeepStack: shows [8d 3d] (a pair of Sixes)
Bryan_Paris_@bparispoker: shows [5s Qc] (a pair of Sixes)
Bryan_Paris_@bparispoker collected $2100 from pot
*** SUMMARY ***
Total pot $2100 | Rake $0
Board [6h Tc 6s 2c 4h]
Seat 1: DeepStack (big blind) showed [8d 3d] and lost with a pair of Sixes
Seat 2: Bryan_Paris_@bparispoker (button) (small blind) showed [5s Qc] and won ($2100) with a pair of Sixes

PokerStars Hand #13000100044: Tournament #2, May4_2017-at-13_52_41 Hold'em No Limit ($200/$400 USD) - 2017/05/04 15:53:24 ET
Table 'ACPC Match' 2-max Seat #1 is the button
Seat 1: DeepStack ($14800 in chips)
Seat 2: Bryan_Paris_@bparispoker ($25200 in chips)
DeepStack: posts small blind $200
Bryan_Paris_@bparispoker: posts big blind $400
*** HOLE CARDS ***
Dealt to DeepStack [9h 2h]
Dealt to Bryan_Paris_@bparispoker [2c Ks]
DeepStack: raises $400 to $800
Bryan_Paris_@bparispoker: calls $400
*** FLOP **** [5s 4s 3s]
Bryan_Paris_@bparispoker: checks
DeepStack: raises $800 to $800
Bryan_Paris_@bparispoker: raises $1800 to $2600
DeepStack: folds
Uncalled bet ($1800) returned to Bryan_Paris_@bparispoker
Bryan_Paris_@bparispoker collected $3200 from the pot
*** SUMMARY ***
Total pot $3200 | Rake $0
Board [5s 4s 3s]
Seat 1: DeepStack (button) (small blind) folded on the Flop
Seat 2: Bryan_Paris_@bparispoker (big blind) collected ($3200)

PokerStars Hand #13000100045: Tournament #2, May4_2017-at-13_52_41 Hold'em No Limit ($200/$400 USD) - 2017/05/04 15:53:25 ET
Table 'ACPC Match' 2-max Seat #2 is the button
Seat 1: DeepStack ($13200 in chips)
Seat 2: Bryan_Paris_@bparispoker ($26800 in chips)
Bryan_Paris_@bparispoker: posts small blind $200
DeepStack: posts big blind $400
*** HOLE CARDS ***
Dealt to DeepStack [9d 7h]
Dealt to Bryan_Paris_@bparispoker [Kd 6s]
Bryan_Paris_@bparispoker: raises $650 to $1050
DeepStack: calls $650
*** FLOP **** [3d 5s Js]
DeepStack: checks
Bryan_Paris_@bparispoker: raises $1450 to $1450
DeepStack: folds
Uncalled bet ($1450) returned to Bryan_Paris_@bparispoker
Bryan_Paris_@bparispoker collected $2100 from the pot
*** SUMMARY ***
Total pot $2100 | Rake $0
Board [3d 5s Js]
Seat 1: DeepStack (big blind) folded on the Flop
Seat 2: Bryan_Paris_@bparispoker (button) (small blind) collected ($2100)

PokerStars Hand #13000100046: Tournament #2, May4_2017-at-13_52_41 Hold'em No Limit ($200/$400 USD) - 2017/05/04 15:53:26 ET
Table 'ACPC Match' 2-max Seat #1 is the button
Seat 1: DeepStack ($12150 in chips)
Seat 2: Bryan_Paris_@bparispoker ($27850 in chips)
DeepStack: posts small blind $200
Bryan_Paris_@bparispoker: posts big blind $400
*** HOLE CARDS ***
Dealt to DeepStack [Td Js]
Dealt to Bryan_Paris_@bparispoker [9d 5h]
DeepStack: raises $400 to $800
Bryan_Paris_@bparispoker: folds
Uncalled bet ($400) returned to DeepStack
DeepStack collected $800 from the pot
*** SUMMARY ***
Total pot $800 | Rake $0
Seat 1: DeepStack (button) (small blind) collected ($800)
Seat 2: Bryan_Paris_@bparispoker (big blind) folded before the Flop

PokerStars Hand #13000100047: Tournament #2, May4_2017-at-13_52_41 Hold'em No Limit ($200/$400 USD) - 2017/05/04 15:53:27 ET
Table 'ACPC Match' 2-max Seat #2 is the button
Seat 1: DeepStack ($12550 in chips)
Seat 2: Bryan_Paris_@bparispoker ($27450 in chips)
Bryan_Paris_@bparispoker: posts small blind $200
DeepStack: posts big blind $400
*** HOLE CARDS ***
Dealt to DeepStack [4c Ah]
Dealt to Bryan_Paris_@bparispoker [7s 8s]
Bryan_Paris_@bparispoker: raises $650 to $1050
DeepStack: raises $11500 to $12550 and is all-in
Bryan_Paris_@bparispoker: folds
Uncalled bet ($11500) returned to DeepStack
DeepStack collected $2100 from the pot
*** SUMMARY ***
Total pot $2100 | Rake $0
Seat 1: DeepStack (big blind) collected ($2100)
Seat 2: Bryan_Paris_@bparispoker (button) (small blind) folded before the Flop

PokerStars Hand #13000100048: Tournament #2, May4_2017-at-13_52_41 Hold'em No Limit ($200/$400 USD) - 2017/05/04 15:53:28 ET
Table 'ACPC Match' 2-max Seat #1 is the button
Seat 1: DeepStack ($13600 in chips)
Seat 2: Bryan_Paris_@bparispoker ($26400 in chips)
DeepStack: posts small blind $200
Bryan_Paris_@bparispoker: posts big blind $400
*** HOLE CARDS ***
Dealt to DeepStack [Ac 3d]
Dealt to Bryan_Paris_@bparispoker [Qs 4d]
DeepStack: raises $400 to $800
Bryan_Paris_@bparispoker: calls $400
*** FLOP **** [4c 3h Td]
Bryan_Paris_@bparispoker: checks
DeepStack: raises $1600 to $1600
Bryan_Paris_@bparispoker: calls $1600
*** TURN **** [2c]
Bryan_Paris_@bparispoker: checks
DeepStack: raises $2400 to $2400
Bryan_Paris_@bparispoker: calls $2400
*** RIVER **** [9h]
Bryan_Paris_@bparispoker: checks
DeepStack: checks
*** SHOW DOWN ***
Bryan_Paris_@bparispoker: shows [Qs 4d] (a pair of Fours)
DeepStack: shows [Ac 3d] (a pair of Threes)
Bryan_Paris_@bparispoker collected $9600 from pot
*** SUMMARY ***
Total pot $9600 | Rake $0
Board [4c 3h Td 2c 9h]
Seat 1: DeepStack (button) (small blind) showed [Ac 3d] and lost with a pair of Threes
Seat 2: Bryan_Paris_@bparispoker (big blind) showed [Qs 4d] and won ($9600) with a pair of Fours

PokerStars Hand #13000100049: Tournament #2, May4_2017-at-13_52_41 Hold'em No Limit ($200/$400 USD) - 2017/05/04 15:53:29 ET
Table 'ACPC Match' 2-max Seat #2 is the button
Seat 1: DeepStack ($8800 in chips)
Seat 2: Bryan_Paris_@bparispoker ($31200 in chips)
Bryan_Paris_@bparispoker: posts small blind $200
DeepStack: posts big blind $400
*** HOLE CARDS ***
Dealt to DeepStack [Jd 5d]
Dealt to Bryan_Paris_@bparispoker [Td 7s]
Bryan_Paris_@bparispoker: raises $400 to $800
DeepStack: calls $400
*** FLOP **** [4h As Ac]
DeepStack: checks
Bryan_Paris_@bparispoker: raises $500 to $500
DeepStack: folds
Uncalled bet ($500) returned to Bryan_Paris_@bparispoker
Bryan_Paris_@bparispoker collected $1600 from the pot
*** SUMMARY ***
Total pot $1600 | Rake $0
Board [4h As Ac]
Seat 1: DeepStack (big blind) folded on the Flop
Seat 2: Bryan_Paris_@bparispoker (button) (small blind) collected ($1600)

PokerStars Hand #13000100050: Tournament #2, May4_2017-at-13_52_41 Hold'em No Limit ($200/$400 USD) - 2017/05/04 15:53:30 ET
Table 'ACPC Match' 2-max Seat #1 is the button
Seat 1: DeepStack ($8000 in chips)
Seat 2: Bryan_Paris_@bparispoker ($32000 in chips)
DeepStack: posts small blind $200
Bryan_Paris_@bparispoker: posts big blind $400
*** HOLE CARDS ***
Dealt to DeepStack [7h 8c]
Dealt to Bryan_Paris_@bparispoker [5c Qh]
DeepStack: calls $200
Bryan_Paris_@bparispoker: checks
*** FLOP **** [Jh 3d Tc]
Bryan_Paris_@bparispoker: checks
DeepStack: raises $400 to $400
Bryan_Paris_@bparispoker: folds
Uncalled bet ($400) returned to DeepStack
DeepStack collected $800 from the pot
*** SUMMARY ***
Total pot $800 | Rake $0
Board [Jh 3d Tc]
Seat 1: DeepStack (button) (small blind) collected ($800)
Seat 2: Bryan_Paris_@bparispoker (big blind) folded on the Flop

PokerStars Hand #13000100051: Tournament #2, May4_2017-at-13_52_41 Hold'em No Limit ($300/$600 USD) - 2017/05/04 15:53:31 ET
Table 'ACPC Match' 2-max Seat #2 is the button
Seat 1: DeepStack ($8400 in chips)
Seat 2: Bryan_Paris_@bparispoker ($31600 in chips)
Bryan_Paris_@bparispoker: posts small blind $300
DeepStack: posts big blind $600
*** HOLE CARDS ***
Dealt to DeepStack [2h 9d]
Dealt to Bryan_Paris_@bparispoker [7s 5s]
Bryan_Paris_@bparispoker: calls $300
DeepStack: checks
*** FLOP **** [8d Qc 5h]
DeepStack: checks
Bryan_Paris_@bparispoker: raises $750 to $750
DeepStack: folds
Uncalled bet ($750) returned to Bryan_Paris_@bparispoker
Bryan_Paris_@bparispoker collected $1200 from the pot
*** SUMMARY ***
Total pot $1200 | Rake $0
Board [8d Qc 5h]
Seat 1: DeepStack (big blind) folded on the Flop
Seat 2: Bryan_Paris_@bparispoker (button) (small blind) collected ($1200)

PokerStars Hand #13000100052: Tournament #2, May4_2017-at-13_52_41 Hold'em No Limit ($300/$600 USD) - 2017/05/04 15:53:32 ET
Table 'ACPC Match' 2-max Seat #1 is the button
Seat 1: DeepStack ($7800 in chips)
Seat 2: Bryan_Paris_@bparispoker ($32200 in chips)
DeepStack: posts small blind $300
Bryan_Paris_@bparispoker: posts big blind $600
*** HOLE CARDS ***
Dealt to DeepStack [6d Ah]
Dealt to Bryan_Paris_@bparispoker [2d Th]
DeepStack: raises $7200 to $7800 and is all-in
Bryan_Paris_@bparispoker: folds
Uncalled bet ($7200) returned to DeepStack
DeepStack collected $1200 from the pot
*** SUMMARY ***
Total pot $1200 | Rake $0
Seat 1: DeepStack (button) (small blind) collected ($1200)
Seat 2: Bryan_Paris_@bparispoker (big blind) folded before the Flop

PokerStars Hand #13000100053: Tournament #2, May4_2017-at-13_52_41 Hold'em No Limit ($300/$600 USD) - 2017/05/04 15:53:33 ET
Table 'ACPC Match' 2-max Seat #2 is the button
Seat 1: DeepStack ($8400 in chips)
Seat 2: Bryan_Paris_@bparispoker ($31600 in chips)
Bryan_Paris_@bparispoker: posts small blind $300
DeepStack: posts big blind $600
*** HOLE CARDS ***
Dealt to DeepStack [Qs 4s]
Dealt to Bryan_Paris_@bparispoker [6c Ts]
Bryan_Paris_@bparispoker: calls $300
DeepStack: checks
*** FLOP **** [3s Kd Qh]
DeepStack: checks
Bryan_Paris_@bparispoker: checks
*** TURN **** [7c]
DeepStack: checks
Bryan_Paris_@bparispoker: checks
*** RIVER **** [4d]
DeepStack: bets $600
Bryan_Paris_@bparispoker: folds
Uncalled bet ($600) returned to DeepStack
DeepStack collected $1200 from the pot
*** SUMMARY ***
Total pot $1200 | Rake $0
Board [3s Kd Qh 7c 4d]
Seat 1: DeepStack (big blind) collected ($1200)
Seat 2: Bryan_Paris_@bparispoker (button) (small blind) folded on the River

PokerStars Hand #13000100054: Tournament #2, May4_2017-at-13_52_41 Hold'em No Limit ($300/$600 USD) - 2017/05/04 15:53:34 ET
Table 'ACPC Match' 2-max Seat #1 is the button
Seat 1: DeepStack ($9000 in chips)
Seat 2: Bryan_Paris_@bparispoker ($31000 in chips)
DeepStack: posts small blind $300
Bryan_Paris_@bparispoker: posts big blind $600
*** HOLE CARDS ***
Dealt to DeepStack [8h Tc]
Dealt to Bryan_Paris_@bparispoker [7c 3h]
DeepStack: raises $600 to $1200
Bryan_Paris_@bparispoker: folds
Uncalled bet ($600) returned to DeepStack
DeepStack collected $1200 from the pot
*** SUMMARY ***
Total pot $1200 | Rake $0
Seat 1: DeepStack (button) (small blind) collected ($1200)
Seat 2: Bryan_Paris_@bparispoker (big blind) folded before the Flop

PokerStars Hand #13000100055: Tournament #2, May4_2017-at-13_52_41 Hold'em No Limit ($300/$600 USD) - 2017/05/04 15:53:35 ET
Table 'ACPC Match' 2-max Seat #2 is the button
Seat 1: DeepStack ($9600 in chips)
Seat 2: Bryan_Paris_@bparispoker ($30400 in chips)
Bryan_Paris_@bparispoker: posts small blind $300
DeepStack: posts big blind $600
*** HOLE CARDS ***
Dealt to DeepStack [9c Js]
Dealt to Bryan_Paris_@bparispoker [Ks 9h]
Bryan_Paris_@bparispoker: raises $29800 to $30400 and is all-in
DeepStack: folds
Uncalled bet ($29800) returned to Bryan_Paris_@bparispoker
Bryan_Paris_@bparispoker collected $1200 from the pot
*** SUMMARY ***
Total pot $1200 | Rake $0
Seat 1: DeepStack (big blind) folded before the Flop
Seat 2: Bryan_Paris_@bparispoker (button) (small blind) collected ($1200)

PokerStars Hand #13000100056: Tournament #2, May4_2017-at-13_52_41 Hold'em No Limit ($300/$600 USD) - 2017/05/04 15:53:36 ET
Table 'ACPC Match' 2-max Seat #1 is the button
Seat 1: DeepStack ($9000 in chips)
Seat 2: Bryan_Paris_@bparispoker ($31000 in chips)
DeepStack: posts small blind $300
Bryan_Paris_@bparispoker: posts big blind $600
*** HOLE CARDS ***
Dealt to DeepStack [Kd Kh]
Dealt to Bryan_Paris_@bparispoker [Qd 7s]
DeepStack: raises $600 to $1200
Bryan_Paris_@bparispoker: calls $600
*** FLOP **** [2h Th 8c]
Bryan_Paris_@bparispoker: checks
DeepStack: raises $2400 to $2400
Bryan_Paris_@bparispoker: folds
Uncalled bet ($2400) returned to DeepStack
DeepStack collected $2400 from the pot
*** SUMMARY ***
Total pot $2400 | Rake $0
Board [2h Th 8c]
Seat 1: DeepStack (button) (small blind) collected ($2400)
Seat 2: Bryan_Paris_@bparispoker (big blind) folded on the Flop

PokerStars Hand #13000100057: Tournament #2, May4_2017-at-13_52_41 Hold'em No Limit ($300/$600 USD) - 2017/05/04 15:53:37 ET
Table 'ACPC Match' 2-max Seat #2 is the button
Seat 1: DeepStack ($10200 in chips)
Seat 2: Bryan_Paris_@bparispoker ($29800 in chips)
Bryan_Paris_@bparispoker: posts small blind $300
DeepStack: posts big blind $600
*** HOLE CARDS ***
Dealt to DeepStack [8h Kd]
Dealt to Bryan_Paris_@bparispoker [8c Jh]
Bryan_Paris_@bparispoker: calls $300
DeepStack: checks
*** FLOP **** [Th Ac Qc]
DeepStack: checks
Bryan_Paris_@bparispoker: raises $900 to $900
DeepStack: calls $900
*** TURN **** [Ks]
DeepStack: checks
Bryan_Paris_@bparispoker: raises $1300 to $1300
DeepStack: calls $1300
*** RIVER **** [Tc]
DeepStack: checks
Bryan_Paris_@bparispoker: checks
*** SHOW DOWN ***
DeepStack: shows [8h Kd] (two pair, Kings and Tens)
Bryan_Paris_@bparispoker: shows [8c Jh] (straight, Ace high)
Bryan_Paris_@bparispoker collected $5600 from pot
*** SUMMARY ***
Total pot $5600 | Rake $0
Board [Th Ac Qc Ks Tc]
Seat 1: DeepStack (big blind) showed [8h Kd] and lost with two pair, Kings and Tens
Seat 2: Bryan_Paris_@bparispoker (button) (small blind) showed [8c Jh] and won ($5600) with straight, Ace high

PokerStars Hand #13000100058: Tournament #2, May4_2017-at-13_52_41 Hold'em No Limit ($300/$600 USD) - 2017/05/04 15:53:38 ET
Table 'ACPC Match' 2-max Seat #1 is the button
Seat 1: DeepStack ($7400 in chips)
Seat 2: Bryan_Paris_@bparispoker ($32600 in chips)
DeepStack: posts small blind $300
Bryan_Paris_@bparispoker: posts big blind $600
*** HOLE CARDS ***
Dealt to DeepStack [2s Jh]
Dealt to Bryan_Paris_@bparispoker [Kd 9s]
DeepStack: calls $300
Bryan_Paris_@bparispoker: raises $32000 to $32600 and is all-in
DeepStack: folds
Uncalled bet ($32000) returned to Bryan_Paris_@bparispoker
Bryan_Paris_@bparispoker collected $1200 from the pot
*** SUMMARY ***
Total pot $1200 | Rake $0
Seat 1: DeepStack (button) (small blind) folded before the Flop
Seat 2: Bryan_Paris_@bparispoker (big blind) collected ($1200)

PokerStars Hand #13000100059: Tournament #2, May4_2017-at-13_52_41 Hold'em No Limit ($300/$600 USD) - 2017/05/04 15:53:39 ET
Table 'ACPC Match' 2-max Seat #2 is the button
Seat 1: DeepStack ($6800 in chips)
Seat 2: Bryan_Paris_@bparispoker ($33200 in chips)
Bryan_Paris_@bparispoker: posts small blind $300
DeepStack: posts big blind $600
*** HOLE CARDS ***
Dealt to DeepStack [7s Ad]
Dealt to Bryan_Paris_@bparispoker [2h 2c]
Bryan_Paris_@bparispoker: raises $32600 to $33200 and is all-in
DeepStack: calls $6200 and is all-in
Uncalled bet ($26400) returned to Bryan_Paris_@bparispoker
*** FLOP **** [4d 3c 7d]
*** TURN **** [Qs]
*** RIVER **** [Kd]
*** SHOW DOWN ***
Bryan_Paris_@bparispoker: shows [2h 2c] (a pair of Deuces)
DeepStack: shows [7s Ad] (a pair of Sevens)
DeepStack collected $13600 from pot
*** SUMMARY ***
Total pot $13600 | Rake $0
Board [4d 3c 7d Qs Kd]
Seat 1: DeepStack (big blind) showed [7s Ad] and won ($13600) with a pair of Sevens
Seat 2: Bryan_Paris_@bparispoker (button) (small blind) showed [2h 2c] and lost with a pair of Deuces

PokerStars Hand #13000100060: Tournament #2, May4_2017-at-13_52_41 Hold'em No Limit ($300/$600 USD) - 2017/05/04 15:53:40 ET
Table 'ACPC Match' 2-max Seat #1 is the button
Seat 1: DeepStack ($13600 in chips)
Seat 2: Bryan_Paris_@bparispoker ($26400 in chips)
DeepStack: posts small blind $300
Bryan_Paris_@bparispoker: posts big blind $600
*** HOLE CARDS ***
Dealt to DeepStack [7c 7d]
Dealt to Bryan_Paris_@bparispoker [2h Qd]
DeepStack: raises $600 to $1200
Bryan_Paris_@bparispoker: folds
Uncalled bet ($600) returned to DeepStack
DeepStack collected $1200 from the pot
*** SUMMARY ***
Total pot $1200 | Rake $0
Seat 1: DeepStack (button) (small blind) collected ($1200)
Seat 2: Bryan_Paris_@bparispoker (big blind) folded before the Flop

PokerStars Hand #13000100061: Tournament #2, May4_2017-at-13_52_41 Hold'em No Limit ($400/$800 USD) - 2017/05/04 15:53:41 ET
Table 'ACPC Match' 2-max Seat #2 is the button
Seat 1: DeepStack ($14200 in chips)
Seat 2: Bryan_Paris_@bparispoker ($25800 in chips)
Bryan_Paris_@bparispoker: posts small blind $400
DeepStack: posts big blind $800
*** HOLE CARDS ***
Dealt to DeepStack [Jd 6c]
Dealt to Bryan_Paris_@bparispoker [Kd 9d]
Bryan_Paris_@bparispoker: raises $800 to $1600
DeepStack: calls $800
*** FLOP **** [3h As 6h]
DeepStack: checks
Bryan_Paris_@bparispoker: raises $1450 to $1450
DeepStack: raises $3050 to $4500
Bryan_Paris_@bparispoker: folds
Uncalled bet ($3050) returned to DeepStack
DeepStack collected $6100 from the pot
*** SUMMARY ***
Total pot $6100 | Rake $0
Board [3h As 6h]
Seat 1: DeepStack (big blind) collected ($6100)
Seat 2: Bryan_Paris_@bparispoker (button) (small blind) folded on the Flop

PokerStars Hand #13000100062: Tournament #2, May4_2017-at-13_52_41 Hold'em No Limit ($400/$800 USD) - 2017/05/04 15:53:42 ET
Table 'ACPC Match' 2-max Seat #1 is the button
Seat 1: DeepStack ($17250 in chips)
Seat 2: Bryan_Paris_@bparispoker ($22750 in chips)
DeepStack: posts small blind $400
Bryan_Paris_@bparispoker: posts big blind $800
*** HOLE CARDS ***
Dealt to DeepStack [Jh 9c]
Dealt to Bryan_Paris_@bparispoker [4s 8c]
DeepStack: calls $400
Bryan_Paris_@bparispoker: checks
*** FLOP **** [3d 6c 5s]
Bryan_Paris_@bparispoker: checks
DeepStack: raises $800 to $800
Bryan_Paris_@bparispoker: raises $1900 to $2700
DeepStack: folds
Uncalled bet ($1900) returned to Bryan_Paris_@bparispoker
Bryan_Paris_@bparispoker collected $3200 from the pot
*** SUMMARY ***
Total pot $3200 | Rake $0
Board [3d 6c 5s]
Seat 1: DeepStack (button) (small blind) folded on the Flop
Seat 2: Bryan_Paris_@bparispoker (big blind) collected ($3200)

PokerStars Hand #13000100063: Tournament #2, May4_2017-at-13_52_41 Hold'em No Limit ($400/$800 USD) - 2017/05/04 15:53:43 ET
Table 'ACPC Match' 2-max Seat #2 is the button
Seat 1: DeepStack ($15650 in chips)
Seat 2: Bryan_Paris_@bparispoker ($24350 in chips)
Bryan_Paris_@bparispoker: posts small blind $400
DeepStack: posts big blind $800
*** HOLE CARDS ***
Dealt to DeepStack [6h Ah]
Dealt to Bryan_Paris_@bparispoker [7d 3s]
Bryan_Paris_@bparispoker: folds
Uncalled bet ($400) returned to DeepStack
DeepStack collected $800 from the pot
*** SUMMARY ***
Total pot $800 | Rake $0
Seat 1: DeepStack (big blind) collected ($800)
Seat 2: Bryan_Paris_@bparispoker (button) (small blind) folded before the Flop

PokerStars Hand #13000100064: Tournament #2, May4_2017-at-13_52_41 Hold'em No Limit ($400/$800 USD) - 2017/05/04 15:53:44 ET
Table 'ACPC Match' 2-max Seat #1 is the button
Seat 1: DeepStack ($16050 in chips)
Seat 2: Bryan_Paris_@bparispoker ($23950 in chips)
DeepStack: posts small blind $400
Bryan_Paris_@bparispoker: posts big blind $800
*** HOLE CARDS ***
Dealt to DeepStack [Qh 8d]
Dealt to Bryan_Paris_@bparispoker [Ad Ah]
DeepStack: calls $400
Bryan_Paris_@bparispoker: raises $1500 to $2300
DeepStack: calls $1500
*** FLOP **** [2d Qs Js]
Bryan_Paris_@bparispoker: bets $3150
DeepStack: raises $10600 to $13750 and is all-in
Bryan_Paris_@bparispoker: calls $10600
*** TURN **** [6h]
*** RIVER **** [2c]
*** SHOW DOWN ***
DeepStack: shows [Qh 8d] (two pair, Queens and Deuces)
Bryan_Paris_@bparispoker: shows [Ad Ah] (two pair, Aces and Deuces)
Bryan_Paris_@bparispoker collected $32100 from pot
*** SUMMARY ***
Total pot $32100 | Rake $0
Board [2d Qs Js 6h 2c]
Seat 1: DeepStack (button) (small blind) showed [Qh 8d] and lost with two pair, Queens and Deuces
Seat 2: Bryan_Paris_@bparispoker (big blind) showed [Ad Ah] and won ($32100) with two pair, Aces and Deuces
