PokerStars Hand #13000000001: Tournament #1, May4_2017-at-13_1_19 Hold'em No Limit ($50/$100 USD) - 2017/05/04 15:01:19 ET
Table 'ACPC Match' 2-max Seat #2 is the button
Seat 1: DeepStack ($20000 in chips)
Seat 2: Bryan_Paris_@bparispoker ($20000 in chips)
Bryan_Paris_@bparispoker: posts small blind $50
DeepStack: posts big blind $100
*** HOLE CARDS ***
Dealt to DeepStack [Kd 6s]
Dealt to Bryan_Paris_@bparispoker [As 2s]
Bryan_Paris_@bparispoker: raises $200 to $300
DeepStack: calls $200
*** FLOP **** [5s 8h 7d]
DeepStack: checks
Bryan_Paris_@bparispoker: raises $600 to $600
DeepStack: raises $1800 to $2400
Bryan_Paris_@bparispoker: folds
Uncalled bet ($1800) returned to DeepStack
DeepStack collected $1800 from the pot
*** SUMMARY ***
Total pot $1800 | Rake $0
Board [5s 8h 7d]
Seat 1: DeepStack (big blind) collected ($1800)
Seat 2: Bryan_Paris_@bparispoker (button) (small blind) folded on the Flop

PokerStars Hand #13000000002: Tournament #1, May4_2017-at-13_1_19 Hold'em No Limit ($50/$100 USD) - 2017/05/04 15:01:20 ET
Table 'ACPC Match' 2-max Seat #1 is the button
Seat 1: DeepStack ($20900 in chips)
Seat 2: Bryan_Paris_@bparispoker ($19100 in chips)
DeepStack: posts small blind $50
Bryan_Paris_@bparispoker: posts big blind $100
*** HOLE CARDS ***
Dealt to DeepStack [Ah 5d]
Dealt to Bryan_Paris_@bparispoker [7c Qs]
DeepStack: calls $50
Bryan_Paris_@bparispoker: checks
*** FLOP **** [Qc Jd 4s]
Bryan_Paris_@bparispoker: checks
DeepStack: checks
*** TURN **** [5h]
Bryan_Paris_@bparispoker: bets $300
DeepStack: calls $300
*** RIVER **** [8d]
Bryan_Paris_@bparispoker: bets $600
DeepStack: folds
Uncalled bet ($600) returned to Bryan_Paris_@bparispoker
Bryan_Paris_@bparispoker collected $800 from the pot
*** SUMMARY ***
Total pot $800 | Rake $0
Board [Qc Jd 4s 5h 8d]
Seat 1: DeepStack (button) (small blind) folded on the River
Seat 2: Bryan_Paris_@bparispoker (big blind) collected ($800)

PokerStars Hand #13000000003: Tournament #1, May4_2017-at-13_1_19 Hold'em No Limit ($50/$100 USD) - 2017/05/04 15:01:21 ET
Table 'ACPC Match' 2-max Seat #2 is the button
Seat 1: DeepStack ($20500 in chips)
Seat 2: Bryan_Paris_@bparispoker ($19500 in chips)
Bryan_Paris_@bparispoker: posts small blind $50
DeepStack: posts big blind $100
*** HOLE CARDS ***
Dealt to DeepStack [Ts 7d]
Dealt to Bryan_Paris_@bparispoker [9c 2c]
Bryan_Paris_@bparispoker: calls $50
DeepStack: checks
*** FLOP **** [Tc Kd Jc]
DeepStack: checks
Bryan_Paris_@bparispoker: raises $200 to $200
DeepStack: folds
Uncalled bet ($200) returned to Bryan_Paris_@bparispoker
Bryan_Paris_@bparispoker collected $200 from the pot
*** SUMMARY ***
Total pot $200 | Rake $0
Board [Tc Kd Jc]
Seat 1: DeepStack (big blind) folded on the Flop
Seat 2: Bryan_Paris_@bparispoker (button) (small blind) collected ($200)

PokerStars Hand #13000000004: Tournament #1, May4_2017-at-13_1_19 Hold'em No Limit ($50/$100 USD) - 2017/05/04 15:01:22 ET
Table 'ACPC Match' 2-max Seat #1 is the button
Seat 1: DeepStack ($20400 in chips)
Seat 2: Bryan_Paris_@bparispoker ($19600 in chips)
DeepStack: posts small blind $50
Bryan_Paris_@bparispoker: posts big blind $100
*** HOLE CARDS ***
Dealt to DeepStack [6s 3c]
Dealt to Bryan_Paris_@bparispoker [Qd Kh]
DeepStack: calls $50
Bryan_Paris_@bparispoker: raises $350 to $450
DeepStack: folds
Uncalled bet ($350) returned to Bryan_Paris_@bparispoker
Bryan_Paris_@bparispoker collected $200 from the pot
*** SUMMARY ***
Total pot $200 | Rake $0
Seat 1: DeepStack (button) (small blind) folded before the Flop
Seat 2: Bryan_Paris_@bparispoker (big blind) collected ($200)

PokerStars Hand #13000000005: Tournament #1, May4_2017-at-13_1_19 Hold'em No Limit ($50/$100 USD) - 2017/05/04 15:01:23 ET
Table 'ACPC Match' 2-max Seat #2 is the button
Seat 1: DeepStack ($20300 in chips)
Seat 2: Bryan_Paris_@bparispoker ($19700 in chips)
Bryan_Paris_@bparispoker: posts small blind $50
DeepStack: posts big blind $100
*** HOLE CARDS ***
Dealt to DeepStack [3h 6s]
Dealt to Bryan_Paris_@bparispoker [9h 7d]
Bryan_Paris_@bparispoker: raises $200 to $300
DeepStack: folds
Uncalled bet ($200) returned to Bryan_Paris_@bparispoker
Bryan_Paris_@bparispoker collected $200 from the pot
*** SUMMARY ***
Total pot $200 | Rake $0
Seat 1: DeepStack (big blind) folded before the Flop
Seat 2: Bryan_Paris_@bparispoker (button) (small blind) collected ($200)

PokerStars Hand #13000000006: Tournament #1, May4_2017-at-13_1_19 Hold'em No Limit ($50/$100 USD) - 2017/05/04 15:01:24 ET
Table 'ACPC Match' 2-max Seat #1 is the button
Seat 1: DeepStack ($20200 in chips)
Seat 2: Bryan_Paris_@bparispoker ($19800 in chips)
DeepStack: posts small blind $50
Bryan_Paris_@bparispoker: posts big blind $100
*** HOLE CARDS ***
Dealt to DeepStack [Jh 5c]
Dealt to Bryan_Paris_@bparispoker [6s 2c]
DeepStack: raises $200 to $300
Bryan_Paris_@bparispoker: folds
Uncalled bet ($200) returned to DeepStack
DeepStack collected $200 from the pot
*** SUMMARY ***
Total pot $200 | Rake $0
Seat 1: DeepStack (button) (small blind) collected ($200)
Seat 2: Bryan_Paris_@bparispoker (big blind) folded before the Flop

PokerStars Hand #13000000007: Tournament #1, May4_2017-at-13_1_19 Hold'em No Limit ($50/$100 USD) - 2017/05/04 15:01:25 ET
Table 'ACPC Match' 2-max Seat #2 is the button
Seat 1: DeepStack ($20300 in chips)
Seat 2: Bryan_Paris_@bparispoker ($19700 in chips)
Bryan_Paris_@bparispoker: posts small blind $50
DeepStack: posts big blind $100
*** HOLE CARDS ***
Dealt to DeepStack [Jd 4d]
Dealt to Bryan_Paris_@bparispoker [6s Th]
Bryan_Paris_@bparispoker: calls $50
DeepStack: checks
*** FLOP **** [Tc Qs 5c]
DeepStack: checks
Bryan_Paris_@bparispoker: raises $150 to $150
DeepStack: folds
Uncalled bet ($150) returned to Bryan_Paris_@bparispoker
Bryan_Paris_@bparispoker collected $200 from the pot
*** SUMMARY ***
Total pot $200 | Rake $0
Board [Tc Qs 5c]
Seat 1: DeepStack (big blind) folded on the Flop
Seat 2: Bryan_Paris_@bparispoker (button) (small blind) collected ($200)

PokerStars Hand #13000000008: Tournament #1, May4_2017-at-13_1_19 Hold'em No Limit ($50/$100 USD) - 2017/05/04 15:01:26 ET
Table 'ACPC Match' 2-max Seat #1 is the button
Seat 1: DeepStack ($20200 in chips)
Seat 2: Bryan_Paris_@bparispoker ($19800 in chips)
DeepStack: posts small blind $50
Bryan_Paris_@bparispoker: posts big blind $100
*** HOLE CARDS ***
Dealt to DeepStack [5s 6h]
Dealt to Bryan_Paris_@bparispoker [6c 9s]
DeepStack: raises $200 to $300
Bryan_Paris_@bparispoker: folds
Uncalled bet ($200) returned to DeepStack
DeepStack collected $200 from the pot
*** SUMMARY ***
Total pot $200 | Rake $0
Seat 1: DeepStack (button) (small blind) collected ($200)
Seat 2: Bryan_Paris_@bparispoker (big blind) folded before the Flop

PokerStars Hand #13000000009: Tournament #1, May4_2017-at-13_1_19 Hold'em No Limit ($50/$100 USD) - 2017/05/04 15:01:27 ET
Table 'ACPC Match' 2-max Seat #2 is the button
Seat 1: DeepStack ($20300 in chips)
Seat 2: Bryan_Paris_@bparispoker ($19700 in chips)
Bryan_Paris_@bparispoker: posts small blind $50
DeepStack: posts big blind $100
*** HOLE CARDS ***
Dealt to DeepStack [Qs Ah]
Dealt to Bryan_Paris_@bparispoker [2s 5s]
Bryan_Paris_@bparispoker: calls $50
DeepStack: raises $200 to $300
Bryan_Paris_@bparispoker: calls $200
*** FLOP **** [Qd Jd 8s]
DeepStack: bets $300
Bryan_Paris_@bparispoker: folds
Uncalled bet ($300) returned to DeepStack
DeepStack collected $600 from the pot
*** SUMMARY ***
Total pot $600 | Rake $0
Board [Qd Jd 8s]
Seat 1: DeepStack (big blind) collected ($600)
Seat 2: Bryan_Paris_@bparispoker (button) (small blind) folded on the Flop

PokerStars Hand #13000000010: Tournament #1, May4_2017-at-13_1_19 Hold'em No Limit ($50/$100 USD) - 2017/05/04 15:01:28 ET
Table 'ACPC Match' 2-max Seat #1 is the button
Seat 1: DeepStack ($20600 in chips)
Seat 2: Bryan_Paris_@bparispoker ($19400 in chips)
DeepStack: posts small blind $50
Bryan_Paris_@bparispoker: posts big blind $100
*** HOLE CARDS ***
Dealt to DeepStack [Ks 3c]
Dealt to Bryan_Paris_@bparispoker [9c Qd]
DeepStack: calls $50
Bryan_Paris_@bparispoker: checks
*** FLOP **** [3d 9s Kc]
Bryan_Paris_@bparispoker: checks
DeepStack: raises $100 to $100
Bryan_Paris_@bparispoker: calls $100
*** TURN **** [2c]
Bryan_Paris_@bparispoker: checks
DeepStack: raises $200 to $200
Bryan_Paris_@bparispoker: calls $200
*** RIVER **** [Tc]
Bryan_Paris_@bparispoker: checks
DeepStack: raises $800 to $800
Bryan_Paris_@bparispoker: calls $800
*** SHOW DOWN ***
DeepStack: shows [Ks 3c] (two pair, Kings and Threes)
Bryan_Paris_@bparispoker: shows [9c Qd] (a pair of Nines)
DeepStack collected $2400 from pot
*** SUMMARY ***
Total pot $2400 | Rake $0
Board [3d 9s Kc 2c Tc]
Seat 1: DeepStack (button) (small blind) showed [Ks 3c] and won ($2400) with two pair, Kings and Threes
Seat 2: Bryan_Paris_@bparispoker (big blind) showed [9c Qd] and lost with a pair of Nines

PokerStars Hand #13000000011: Tournament #1, May4_2017-at-13_1_19 Hold'em No Limit ($75/$150 USD) - 2017/05/04 15:01:29 ET
Table 'ACPC Match' 2-max Seat #2 is the button
Seat 1: DeepStack ($21800 in chips)
Seat 2: Bryan_Paris_@bparispoker ($18200 in chips)
Bryan_Paris_@bparispoker: posts small blind $75
DeepStack: posts big blind $150
*** HOLE CARDS ***
Dealt to DeepStack [Js Tc]
Dealt to Bryan_Paris_@bparispoker [4s 6d]
Bryan_Paris_@bparispoker: calls $75
DeepStack: raises $300 to $450
Bryan_Paris_@bparispoker: folds
Uncalled bet ($300) returned to DeepStack
DeepStack collected $300 from the pot
*** SUMMARY ***
Total pot $300 | Rake $0
Seat 1: DeepStack (big blind) collected ($300)
Seat 2: Bryan_Paris_@bparispoker (button) (small blind) folded before the Flop

PokerStars Hand #13000000012: Tournament #1, May4_2017-at-13_1_19 Hold'em No Limit ($75/$150 USD) - 2017/05/04 15:01:30 ET
Table 'ACPC Match' 2-max Seat #1 is the button
Seat 1: DeepStack ($21950 in chips)
Seat 2: Bryan_Paris_@bparispoker ($18050 in chips)
DeepStack: posts small blind $75
Bryan_Paris_@bparispoker: posts big blind $150
*** HOLE CARDS ***
Dealt to DeepStack [6c 3d]
Dealt to Bryan_Paris_@bparispoker [Ts Jh]
DeepStack: calls $75
Bryan_Paris_@bparispoker: checks
*** FLOP **** [4c Td Jc]
Bryan_Paris_@bparispoker: checks
DeepStack: raises $150 to $150
Bryan_Paris_@bparispoker: raises $600 to $750
DeepStack: folds
Uncalled bet ($600) returned to Bryan_Paris_@bparispoker
Bryan_Paris_@bparispoker collected $600 from the pot
*** SUMMARY ***
Total pot $600 | Rake $0
Board [4c Td Jc]
Seat 1: DeepStack (button) (small blind) folded on the Flop
Seat 2: Bryan_Paris_@bparispoker (big blind) collected ($600)

PokerStars Hand #13000000013: Tournament #1, May4_2017-at-13_1_19 Hold'em No Limit ($75/$150 USD) - 2017/05/04 15:01:31 ET
Table 'ACPC Match' 2-max Seat #2 is the button
Seat 1: DeepStack ($21650 in chips)
Seat 2: Bryan_Paris_@bparispoker ($18350 in chips)
Bryan_Paris_@bparispoker: posts small blind $75
DeepStack: posts big blind $150
*** HOLE CARDS ***
Dealt to DeepStack [8h Kd]
Dealt to Bryan_Paris_@bparispoker [2d 4c]
Bryan_Paris_@bparispoker: folds
Uncalled bet ($75) returned to DeepStack
DeepStack collected $150 from the pot
*** SUMMARY ***
Total pot $150 | Rake $0
Seat 1: DeepStack (big blind) collected ($150)
Seat 2: Bryan_Paris_@bparispoker (button) (small blind) folded before the Flop

PokerStars Hand #13000000014: Tournament #1, May4_2017-at-13_1_19 Hold'em No Limit ($75/$150 USD) - 2017/05/04 15:01:32 ET
Table 'ACPC Match' 2-max Seat #1 is the button
Seat 1: DeepStack ($21725 in chips)
Seat 2: Bryan_Paris_@bparispoker ($18275 in chips)
DeepStack: posts small blind $75
Bryan_Paris_@bparispoker: posts big blind $150
*** HOLE CARDS ***
Dealt to DeepStack [Td 4s]
Dealt to Bryan_Paris_@bparispoker [Ts 8s]
DeepStack: calls $75
Bryan_Paris_@bparispoker: checks
*** FLOP **** [Ac Jh 5s]
Bryan_Paris_@bparispoker: checks
DeepStack: raises $150 to $150
Bryan_Paris_@bparispoker: folds
Uncalled bet ($150) returned to DeepStack
DeepStack collected $300 from the pot
*** SUMMARY ***
Total pot $300 | Rake $0
Board [Ac Jh 5s]
Seat 1: DeepStack (button) (small blind) collected ($300)
Seat 2: Bryan_Paris_@bparispoker (big blind) folded on the Flop

PokerStars Hand #13000000015: Tournament #1, May4_2017-at-13_1_19 Hold'em No Limit ($75/$150 USD) - 2017/05/04 15:01:33 ET
Table 'ACPC Match' 2-max Seat #2 is the button
Seat 1: DeepStack ($21875 in chips)
Seat 2: Bryan_Paris_@bparispoker ($18125 in chips)
Bryan_Paris_@bparispoker: posts small blind $75
DeepStack: posts big blind $150
*** HOLE CARDS ***
Dealt to DeepStack [8c Jd]
Dealt to Bryan_Paris_@bparispoker [Tc Jc]
Bryan_Paris_@bparispoker: raises $300 to $450
DeepStack: calls $300
*** FLOP **** [3s 6s Js]
DeepStack: checks
Bryan_Paris_@bparispoker: raises $575 to $575
DeepStack: calls $575
*** TURN **** [6c]
DeepStack: checks
Bryan_Paris_@bparispoker: checks
*** RIVER **** [9s]
DeepStack: bets $1025
Bryan_Paris_@bparispoker: folds
Uncalled bet ($1025) returned to DeepStack
DeepStack collected $2050 from the pot
*** SUMMARY ***
Total pot $2050 | Rake $0
Board [3s 6s Js 6c 9s]
Seat 1: DeepStack (big blind) collected ($2050)
Seat 2: Bryan_Paris_@bparispoker (button) (small blind) folded on the River

PokerStars Hand #13000000016: Tournament #1, May4_2017-at-13_1_19 Hold'em No Limit ($75/$150 USD) - 2017/05/04 15:01:34 ET
Table 'ACPC Match' 2-max Seat #1 is the button
Seat 1: DeepStack ($22900 in chips)
Seat 2: Bryan_Paris_@bparispoker ($17100 in chips)
DeepStack: posts small blind $75
Bryan_Paris_@bparispoker: posts big blind $150
*** HOLE CARDS ***
Dealt to DeepStack [Kh 8c]
Dealt to Bryan_Paris_@bparispoker [4d 3c]
DeepStack: raises $300 to $450
Bryan_Paris_@bparispoker: folds
Uncalled bet ($300) returned to DeepStack
DeepStack collected $300 from the pot
*** SUMMARY ***
Total pot $300 | Rake $0
Seat 1: DeepStack (button) (small blind) collected ($300)
Seat 2: Bryan_Paris_@bparispoker (big blind) folded before the Flop

PokerStars Hand #13000000017: Tournament #1, May4_2017-at-13_1_19 Hold'em No Limit ($75/$150 USD) - 2017/05/04 15:01:35 ET
Table 'ACPC Match' 2-max Seat #2 is the button
Seat 1: DeepStack ($23050 in chips)
Seat 2: Bryan_Paris_@bparispoker ($16950 in chips)
Bryan_Paris_@bparispoker: posts small blind $75
DeepStack: posts big blind $150
*** HOLE CARDS ***
Dealt to DeepStack [Kd Ts]
Dealt to Bryan_Paris_@bparispoker [Jh Tc]
Bryan_Paris_@bparispoker: raises $300 to $450
DeepStack: calls $300
*** FLOP **** [7c Qd 4s]
DeepStack: checks
Bryan_Paris_@bparispoker: raises $600 to $600
DeepStack: calls $600
*** TURN **** [Td]
DeepStack: checks
Bryan_Paris_@bparispoker: raises $1400 to $1400
DeepStack: calls $1400
*** RIVER **** [5c]
DeepStack: checks
Bryan_Paris_@bparispoker: checks
*** SHOW DOWN ***
DeepStack: shows [Kd Ts] (a pair of Tens)
Bryan_Paris_@bparispoker: shows [Jh Tc] (a pair of Tens)
DeepStack collected $4900 from pot
*** SUMMARY ***
Total pot $4900 | Rake $0
Board [7c Qd 4s Td 5c]
Seat 1: DeepStack (big blind) showed [Kd Ts] and won ($4900) with a pair of Tens
Seat 2: Bryan_Paris_@bparispoker (button) (small blind) showed [Jh Tc] and lost with a pair of Tens

PokerStars Hand #13000000018: Tournament #1, May4_2017-at-13_1_19 Hold'em No Limit ($75/$150 USD) - 2017/05/04 15:01:36 ET
Table 'ACPC Match' 2-max Seat #1 is the button
Seat 1: DeepStack ($25500 in chips)
Seat 2: Bryan_Paris_@bparispoker ($14500 in chips)
DeepStack: posts small blind $75
Bryan_Paris_@bparispoker: posts big blind $150
*** HOLE CARDS ***
Dealt to DeepStack [Kh 4d]
Dealt to Bryan_Paris_@bparispoker [5s 9c]
DeepStack: calls $75
Bryan_Paris_@bparispoker: checks
*** FLOP **** [9d Ad Ah]
Bryan_Paris_@bparispoker: checks
DeepStack: raises $150 to $150
Bryan_Paris_@bparispoker: calls $150
*** TURN **** [7d]
Bryan_Paris_@bparispoker: checks
DeepStack: checks
*** RIVER **** [Ac]
Bryan_Paris_@bparispoker: bets $400
DeepStack: calls $400
*** SHOW DOWN ***
Bryan_Paris_@bparispoker: shows [5s 9c] (full house, Aces and Nines)
DeepStack: shows [Kh 4d] (three of a kind, Aces)
Bryan_Paris_@bparispoker collected $1400 from pot
*** SUMMARY ***
Total pot $1400 | Rake $0
Board [9d Ad Ah 7d Ac]
Seat 1: DeepStack (button) (small blind) showed [Kh 4d] and lost with three of a kind, Aces
Seat 2: Bryan_Paris_@bparispoker (big blind) showed [5s 9c] and won ($1400) with full house, Aces and Nines

PokerStars Hand #13000000019: Tournament #1, May4_2017-at-13_1_19 Hold'em No Limit ($75/$150 USD) - 2017/05/04 15:01:37 ET
Table 'ACPC Match' 2-max Seat #2 is the button
Seat 1: DeepStack ($24800 in chips)
Seat 2: Bryan_Paris_@bparispoker ($15200 in chips)
Bryan_Paris_@bparispoker: posts small blind $75
DeepStack: posts big blind $150
*** HOLE CARDS ***
Dealt to DeepStack [5h Js]
Dealt to Bryan_Paris_@bparispoker [5d 6d]
Bryan_Paris_@bparispoker: raises $300 to $450
DeepStack: folds
Uncalled bet ($300) returned to Bryan_Paris_@bparispoker
Bryan_Paris_@bparispoker collected $300 from the pot
*** SUMMARY ***
Total pot $300 | Rake $0
Seat 1: DeepStack (big blind) folded before the Flop
Seat 2: Bryan_Paris_@bparispoker (button) (small blind) collected ($300)

PokerStars Hand #13000000020: Tournament #1, May4_2017-at-13_1_19 Hold'em No Limit ($75/$150 USD) - 2017/05/04 15:01:38 ET
Table 'ACPC Match' 2-max Seat #1 is the button
Seat 1: DeepStack ($24650 in chips)
Seat 2: Bryan_Paris_@bparispoker ($15350 in chips)
DeepStack: posts small blind $75
Bryan_Paris_@bparispoker: posts big blind $150
*** HOLE CARDS ***
Dealt to DeepStack [Tc Ac]
Dealt to Bryan_Paris_@bparispoker [6h Kc]
DeepStack: raises $300 to $450
Bryan_Paris_@bparispoker: calls $300
*** FLOP **** [3c Ks 5h]
Bryan_Paris_@bparispoker: checks
DeepStack: checks
*** TURN **** [7s]
Bryan_Paris_@bparispoker: bets $700
DeepStack: folds
Uncalled bet ($700) returned to Bryan_Paris_@bparispoker
Bryan_Paris_@bparispoker collected $900 from the pot
*** SUMMARY ***
Total pot $900 | Rake $0
Board [3c Ks 5h 7s]
Seat 1: DeepStack (button) (small blind) folded on the Turn
Seat 2: Bryan_Paris_@bparispoker (big blind) collected ($900)

PokerStars Hand #13000000021: Tournament #1, May4_2017-at-13_1_19 Hold'em No Limit ($100/$200 USD) - 2017/05/04 15:01:39 ET
Table 'ACPC Match' 2-max Seat #2 is the button
Seat 1: DeepStack ($24200 in chips)
Seat 2: Bryan_Paris_@bparispoker ($15800 in chips)
Bryan_Paris_@bparispoker: posts small blind $100
DeepStack: posts big blind $200
*** HOLE CARDS ***
Dealt to DeepStack [8h Jh]
Dealt to Bryan_Paris_@bparispoker [7h 9d]
Bryan_Paris_@bparispoker: calls $100
DeepStack: raises $400 to $600
Bryan_Paris_@bparispoker: calls $400
*** FLOP **** [7d 5s 3c]
DeepStack: bets $600
Bryan_Paris_@bparispoker: raises $1200 to $1800
DeepStack: folds
Uncalled bet ($1200) returned to Bryan_Paris_@bparispoker
Bryan_Paris_@bparispoker collected $2400 from the pot
*** SUMMARY ***
Total pot $2400 | Rake $0
Board [7d 5s 3c]
Seat 1: DeepStack (big blind) folded on the Flop
Seat 2: Bryan_Paris_@bparispoker (button) (small blind) collected ($2400)

PokerStars Hand #13000000022: Tournament #1, May4_2017-at-13_1_19 Hold'em No Limit ($100/$200 USD) - 2017/05/04 15:01:40 ET
Table 'ACPC Match' 2-max Seat #1 is the button
Seat 1: DeepStack ($23000 in chips)
Seat 2: Bryan_Paris_@bparispoker ($17000 in chips)
DeepStack: posts small blind $100
Bryan_Paris_@bparispoker: posts big blind $200
*** HOLE CARDS ***
Dealt to DeepStack [2s Ah]
Dealt to Bryan_Paris_@bparispoker [3d Jd]
DeepStack: raises $200 to $400
Bryan_Paris_@bparispoker: calls $200
*** FLOP **** [2h Kc Qc]
Bryan_Paris_@bparispoker: checks
DeepStack: checks
*** TURN **** [2d]
Bryan_Paris_@bparispoker: checks
DeepStack: raises $800 to $800
Bryan_Paris_@bparispoker: folds
Uncalled bet ($800) returned to DeepStack
DeepStack collected $800 from the pot
*** SUMMARY ***
Total pot $800 | Rake $0
Board [2h Kc Qc 2d]
Seat 1: DeepStack (button) (small blind) collected ($800)
Seat 2: Bryan_Paris_@bparispoker (big blind) folded on the Turn

PokerStars Hand #13000000023: Tournament #1, May4_2017-at-13_1_19 Hold'em No Limit ($100/$200 USD) - 2017/05/04 15:01:41 ET
Table 'ACPC Match' 2-max Seat #2 is the button
Seat 1: DeepStack ($23400 in chips)
Seat 2: Bryan_Paris_@bparispoker ($16600 in chips)
Bryan_Paris_@bparispoker: posts small blind $100
DeepStack: posts big blind $200
*** HOLE CARDS ***
Dealt to DeepStack [7s 2d]
Dealt to Bryan_Paris_@bparispoker [6c 7c]
Bryan_Paris_@bparispoker: raises $400 to $600
DeepStack: folds
Uncalled bet ($400) returned to Bryan_Paris_@bparispoker
Bryan_Paris_@bparispoker collected $400 from the pot
*** SUMMARY ***
Total pot $400 | Rake $0
Seat 1: DeepStack (big blind) folded before the Flop
Seat 2: Bryan_Paris_@bparispoker (button) (small blind) collected ($400)

PokerStars Hand #13000000024: Tournament #1, May4_2017-at-13_1_19 Hold'em No Limit ($100/$200 USD) - 2017/05/04 15:01:42 ET
Table 'ACPC Match' 2-max Seat #1 is the button
Seat 1: DeepStack ($23200 in chips)
Seat 2: Bryan_Paris_@bparispoker ($16800 in chips)
DeepStack: posts small blind $100
Bryan_Paris_@bparispoker: posts big blind $200
*** HOLE CARDS ***
Dealt to DeepStack [Tc 9d]
Dealt to Bryan_Paris_@bparispoker [Jc 2d]
DeepStack: raises $200 to $400
Bryan_Paris_@bparispoker: calls $200
*** FLOP **** [4d 3s 4c]
Bryan_Paris_@bparispoker: checks
DeepStack: checks
*** TURN **** [2h]
Bryan_Paris_@bparispoker: bets $500
DeepStack: folds
Uncalled bet ($500) returned to Bryan_Paris_@bparispoker
Bryan_Paris_@bparispoker collected $800 from the pot
*** SUMMARY ***
Total pot $800 | Rake $0
Board [4d 3s 4c 2h]
Seat 1: DeepStack (button) (small blind) folded on the Turn
Seat 2: Bryan_Paris_@bparispoker (big blind) collected ($800)

PokerStars Hand #13000000025: Tournament #1, May4_2017-at-13_1_19 Hold'em No Limit ($100/$200 USD) - 2017/05/04 15:01:43 ET
Table 'ACPC Match' 2-max Seat #2 is the button
Seat 1: DeepStack ($22800 in chips)
Seat 2: Bryan_Paris_@bparispoker ($17200 in chips)
Bryan_Paris_@bparispoker: posts small blind $100
DeepStack: posts big blind $200
*** HOLE CARDS ***
Dealt to DeepStack [2h Td]
Dealt to Bryan_Paris_@bparispoker [Jh 6d]
Bryan_Paris_@bparispoker: raises $400 to $600
DeepStack: folds
Uncalled bet ($400) returned to Bryan_Paris_@bparispoker
Bryan_Paris_@bparispoker collected $400 from the pot
*** SUMMARY ***
Total pot $400 | Rake $0
Seat 1: DeepStack (big blind) folded before the Flop
Seat 2: Bryan_Paris_@bparispoker (button) (small blind) collected ($400)

PokerStars Hand #13000000026: Tournament #1, May4_2017-at-13_1_19 Hold'em No Limit ($100/$200 USD) - 2017/05/04 15:01:44 ET
Table 'ACPC Match' 2-max Seat #1 is the button
Seat 1: DeepStack ($22600 in chips)
Seat 2: Bryan_Paris_@bparispoker ($17400 in chips)
DeepStack: posts small blind $100
Bryan_Paris_@bparispoker: posts big blind $200
*** HOLE CARDS ***
Dealt to DeepStack [7s 7d]
Dealt to Bryan_Paris_@bparispoker [4s Jd]
DeepStack: raises $200 to $400
Bryan_Paris_@bparispoker: calls $200
*** FLOP **** [Qc Jh 2c]
Bryan_Paris_@bparispoker: checks
DeepStack: checks
*** TURN **** [9c]
Bryan_Paris_@bparispoker: bets $500
DeepStack: folds
Uncalled bet ($500) returned to Bryan_Paris_@bparispoker
Bryan_Paris_@bparispoker collected $800 from the pot
*** SUMMARY ***
Total pot $800 | Rake $0
Board [Qc Jh 2c 9c]
Seat 1: DeepStack (button) (small blind) folded on the Turn
Seat 2: Bryan_Paris_@bparispoker (big blind) collected ($800)

PokerStars Hand #13000000027: Tournament #1, May4_2017-at-13_1_19 Hold'em No Limit ($100/$200 USD) - 2017/05/04 15:01:45 ET
Table 'ACPC Match' 2-max Seat #2 is the button
Seat 1: DeepStack ($22200 in chips)
Seat 2: Bryan_Paris_@bparispoker ($17800 in chips)
Bryan_Paris_@bparispoker: posts small blind $100
DeepStack: posts big blind $200
*** HOLE CARDS ***
Dealt to DeepStack [4s Jc]
Dealt to Bryan_Paris_@bparispoker [6c 5d]
Bryan_Paris_@bparispoker: raises $400 to $600
DeepStack: folds
Uncalled bet ($400) returned to Bryan_Paris_@bparispoker
Bryan_Paris_@bparispoker collected $400 from the pot
*** SUMMARY ***
Total pot $400 | Rake $0
Seat 1: DeepStack (big blind) folded before the Flop
Seat 2: Bryan_Paris_@bparispoker (button) (small blind) collected ($400)

PokerStars Hand #13000000028: Tournament #1, May4_2017-at-13_1_19 Hold'em No Limit ($100/$200 USD) - 2017/05/04 15:01:46 ET
Table 'ACPC Match' 2-max Seat #1 is the button
Seat 1: DeepStack ($22000 in chips)
Seat 2: Bryan_Paris_@bparispoker ($18000 in chips)
DeepStack: posts small blind $100
Bryan_Paris_@bparispoker: posts big blind $200
*** HOLE CARDS ***
Dealt to DeepStack [9s 8s]
Dealt to Bryan_Paris_@bparispoker [Ac 2d]
DeepStack: raises $400 to $600
Bryan_Paris_@bparispoker: calls $400
*** FLOP **** [Kc 3h 4d]
Bryan_Paris_@bparispoker: checks
DeepStack: checks
*** TURN **** [8c]
Bryan_Paris_@bparispoker: checks
DeepStack: raises $600 to $600
Bryan_Paris_@bparispoker: calls $600
*** RIVER **** [Ks]
Bryan_Paris_@bparispoker: checks
DeepStack: checks
*** SHOW DOWN ***
Bryan_Paris_@bparispoker: shows [Ac 2d] (a pair of Kings)
DeepStack: shows [9s 8s] (two pair, Kings and Eights)
DeepStack collected $2400 from pot
*** SUMMARY ***
Total pot $2400 | Rake $0
Board [Kc 3h 4d 8c Ks]
Seat 1: DeepStack (button) (small blind) showed [9s 8s] and won ($2400) with two pair, Kings and Eights
Seat 2: Bryan_Paris_@bparispoker (big blind) showed [Ac 2d] and lost with a pair of Kings

PokerStars Hand #13000000029: Tournament #1, May4_2017-at-13_1_19 Hold'em No Limit ($100/$200 USD) - 2017/05/04 15:01:47 ET
Table 'ACPC Match' 2-max Seat #2 is the button
Seat 1: DeepStack ($23200 in chips)
Seat 2: Bryan_Paris_@bparispoker ($16800 in chips)
Bryan_Paris_@bparispoker: posts small blind $100
DeepStack: posts big blind $200
*** HOLE CARDS ***
Dealt to DeepStack [9s 9d]
Dealt to Bryan_Paris_@bparispoker [2d Kd]
Bryan_Paris_@bparispoker: raises $400 to $600
DeepStack: raises $1200 to $1800
Bryan_Paris_@bparispoker: calls $1200
*** FLOP **** [Ks As Tc]
DeepStack: checks
Bryan_Paris_@bparispoker: checks
*** TURN **** [4c]
DeepStack: checks
Bryan_Paris_@bparispoker: raises $1200 to $1200
DeepStack: folds
Uncalled bet ($1200) returned to Bryan_Paris_@bparispoker
Bryan_Paris_@bparispoker collected $3600 from the pot
*** SUMMARY ***
Total pot $3600 | Rake $0
Board [Ks As Tc 4c]
Seat 1: DeepStack (big blind) folded on the Turn
Seat 2: Bryan_Paris_@bparispoker (button) (small blind) collected ($3600)

PokerStars Hand #13000000030: Tournament #1, May4_2017-at-13_1_19 Hold'em No Limit ($100/$200 USD) - 2017/05/04 15:01:48 ET
Table 'ACPC Match' 2-max Seat #1 is the button
Seat 1: DeepStack ($21400 in chips)
Seat 2: Bryan_Paris_@bparispoker ($18600 in chips)
DeepStack: posts small blind $100
Bryan_Paris_@bparispoker: posts big blind $200
*** HOLE CARDS ***
Dealt to DeepStack [Kc 4s]
Dealt to Bryan_Paris_@bparispoker [Ah 6s]
DeepStack: calls $100
Bryan_Paris_@bparispoker: checks
*** FLOP **** [As 5c 6d]
Bryan_Paris_@bparispoker: checks
DeepStack: checks
*** TURN **** [4h]
Bryan_Paris_@bparispoker: bets $500
DeepStack: raises $700 to $1200
Bryan_Paris_@bparispoker: raises $2400 to $3600
DeepStack: folds
Uncalled bet ($2400) returned to Bryan_Paris_@bparispoker
Bryan_Paris_@bparispoker collected $2800 from the pot
*** SUMMARY ***
Total pot $2800 | Rake $0
Board [As 5c 6d 4h]
Seat 1: DeepStack (button) (small blind) folded on the Turn
Seat 2: Bryan_Paris_@bparispoker (big blind) collected ($2800)

PokerStars Hand #13000000031: Tournament #1, May4_2017-at-13_1_19 Hold'em No Limit ($150/$300 USD) - 2017/05/04 15:01:49 ET
Table 'ACPC Match' 2-max Seat #2 is the button
Seat 1: DeepStack ($20000 in chips)
Seat 2: Bryan_Paris_@bparispoker ($20000 in chips)
Bryan_Paris_@bparispoker: posts small blind $150
DeepStack: posts big blind $300
*** HOLE CARDS ***
Dealt to DeepStack [7h 9c]
Dealt to Bryan_Paris_@bparispoker [Kd 6s]
Bryan_Paris_@bparispoker: raises $500 to $800
DeepStack: raises $1600 to $2400
Bryan_Paris_@bparispoker: folds
Uncalled bet ($1600) returned to DeepStack
DeepStack collected $1600 from the pot
*** SUMMARY ***
Total pot $1600 | Rake $0
Seat 1: DeepStack (big blind) collected ($1600)
Seat 2: Bryan_Paris_@bparispoker (button) (small blind) folded before the Flop

PokerStars Hand #13000000032: Tournament #1, May4_2017-at-13_1_19 Hold'em No Limit ($150/$300 USD) - 2017/05/04 15:01:50 ET
Table 'ACPC Match' 2-max Seat #1 is the button
Seat 1: DeepStack ($20800 in chips)
Seat 2: Bryan_Paris_@bparispoker ($19200 in chips)
DeepStack: posts small blind $150
Bryan_Paris_@bparispoker: posts big blind $300
*** HOLE CARDS ***
Dealt to DeepStack [Qc 2h]
Dealt to Bryan_Paris_@bparispoker [9s Ts]
DeepStack: calls $150
Bryan_Paris_@bparispoker: raises $800 to $1100
DeepStack: folds
Uncalled bet ($800) returned to Bryan_Paris_@bparispoker
Bryan_Paris_@bparispoker collected $600 from the pot
*** SUMMARY ***
Total pot $600 | Rake $0
Seat 1: DeepStack (button) (small blind) folded before the Flop
Seat 2: Bryan_Paris_@bparispoker (big blind) collected ($600)

PokerStars Hand #13000000033: Tournament #1, May4_2017-at-13_1_19 Hold'em No Limit ($150/$300 USD) - 2017/05/04 15:01:51 ET
Table 'ACPC Match' 2-max Seat #2 is the button
Seat 1: DeepStack ($20500 in chips)
Seat 2: Bryan_Paris_@bparispoker ($19500 in chips)
Bryan_Paris_@bparispoker: posts small blind $150
DeepStack: posts big blind $300
*** HOLE CARDS ***
Dealt to DeepStack [7d 6s]
Dealt to Bryan_Paris_@bparispoker [As 5d]
Bryan_Paris_@bparispoker: raises $500 to $800
DeepStack: calls $500
*** FLOP **** [Td Qs 7s]
DeepStack: checks
Bryan_Paris_@bparispoker: raises $1600 to $1600
DeepStack: calls $1600
*** TURN **** [Jh]
DeepStack: checks
Bryan_Paris_@bparispoker: checks
*** RIVER **** [8s]
DeepStack: bets $4800
Bryan_Paris_@bparispoker: folds
Uncalled bet ($4800) returned to DeepStack
DeepStack collected $4800 from the pot
*** SUMMARY ***
Total pot $4800 | Rake $0
Board [Td Qs 7s Jh 8s]
Seat 1: DeepStack (big blind) collected ($4800)
Seat 2: Bryan_Paris_@bparispoker (button) (small blind) folded on the River

PokerStars Hand #13000000034: Tournament #1, May4_2017-at-13_1_19 Hold'em No Limit ($150/$300 USD) - 2017/05/04 15:01:52 ET
Table 'ACPC Match' 2-max Seat #1 is the button
Seat 1: DeepStack ($22900 in chips)
Seat 2: Bryan_Paris_@bparispoker ($17100 in chips)
DeepStack: posts small blind $150
Bryan_Paris_@bparispoker: posts big blind $300
*** HOLE CARDS ***
Dealt to DeepStack [Tc 5d]
Dealt to Bryan_Paris_@bparispoker [6d 4s]
DeepStack: calls $150
Bryan_Paris_@bparispoker: checks
*** FLOP **** [4d 8h 7c]
Bryan_Paris_@bparispoker: checks
DeepStack: raises $600 to $600
Bryan_Paris_@bparispoker: raises $1700 to $2300
DeepStack: folds
Uncalled bet ($1700) returned to Bryan_Paris_@bparispoker
Bryan_Paris_@bparispoker collected $1800 from the pot
*** SUMMARY ***
Total pot $1800 | Rake $0
Board [4d 8h 7c]
Seat 1: DeepStack (button) (small blind) folded on the Flop
Seat 2: Bryan_Paris_@bparispoker (big blind) collected ($1800)

PokerStars Hand #13000000035: Tournament #1, May4_2017-at-13_1_19 Hold'em No Limit ($150/$300 USD) - 2017/05/04 15:01:53 ET
Table 'ACPC Match' 2-max Seat #2 is the button
Seat 1: DeepStack ($22000 in chips)
Seat 2: Bryan_Paris_@bparispoker ($18000 in chips)
Bryan_Paris_@bparispoker: posts small blind $150
DeepStack: posts big blind $300
*** HOLE CARDS ***
Dealt to DeepStack [5c Kc]
Dealt to Bryan_Paris_@bparispoker [As Js]
Bryan_Paris_@bparispoker: raises $500 to $800
DeepStack: calls $500
*** FLOP **** [6s Qh 9c]
DeepStack: bets $1600
Bryan_Paris_@bparispoker: calls $1600
*** TURN **** [8s]
DeepStack: checks
Bryan_Paris_@bparispoker: checks
*** RIVER **** [Ah]
DeepStack: checks
Bryan_Paris_@bparispoker: raises $3350 to $3350
DeepStack: folds
Uncalled bet ($3350) returned to Bryan_Paris_@bparispoker
Bryan_Paris_@bparispoker collected $4800 from the pot
*** SUMMARY ***
Total pot $4800 | Rake $0
Board [6s Qh 9c 8s Ah]
Seat 1: DeepStack (big blind) folded on the River
Seat 2: Bryan_Paris_@bparispoker (button) (small blind) collected ($4800)

PokerStars Hand #13000000036: Tournament #1, May4_2017-at-13_1_19 Hold'em No Limit ($150/$300 USD) - 2017/05/04 15:01:54 ET
Table 'ACPC Match' 2-max Seat #1 is the button
Seat 1: DeepStack ($19600 in chips)
Seat 2: Bryan_Paris_@bparispoker ($20400 in chips)
DeepStack: posts small blind $150
Bryan_Paris_@bparispoker: posts big blind $300
*** HOLE CARDS ***
Dealt to DeepStack [2s 7s]
Dealt to Bryan_Paris_@bparispoker [Qc 4d]
DeepStack: raises $600 to $900
Bryan_Paris_@bparispoker: folds
Uncalled bet ($600) returned to DeepStack
DeepStack collected $600 from the pot
*** SUMMARY ***
Total pot $600 | Rake $0
Seat 1: DeepStack (button) (small blind) collected ($600)
Seat 2: Bryan_Paris_@bparispoker (big blind) folded before the Flop

PokerStars Hand #13000000037: Tournament #1, May4_2017-at-13_1_19 Hold'em No Limit ($150/$300 USD) - 2017/05/04 15:01:55 ET
Table 'ACPC Match' 2-max Seat #2 is the button
Seat 1: DeepStack ($19900 in chips)
Seat 2: Bryan_Paris_@bparispoker ($20100 in chips)
Bryan_Paris_@bparispoker: posts small blind $150
DeepStack: posts big blind $300
*** HOLE CARDS ***
Dealt to DeepStack [5s Th]
Dealt to Bryan_Paris_@bparispoker [3d Qh]
Bryan_Paris_@bparispoker: raises $500 to $800
DeepStack: folds
Uncalled bet ($500) returned to Bryan_Paris_@bparispoker
Bryan_Paris_@bparispoker collected $600 from the pot
*** SUMMARY ***
Total pot $600 | Rake $0
Seat 1: DeepStack (big blind) folded before the Flop
Seat 2: Bryan_Paris_@bparispoker (button) (small blind) collected ($600)

PokerStars Hand #13000000038: Tournament #1, May4_2017-at-13_1_19 Hold'em No Limit ($150/$300 USD) - 2017/05/04 15:01:56 ET
Table 'ACPC Match' 2-max Seat #1 is the button
Seat 1: DeepStack ($19600 in chips)
Seat 2: Bryan_Paris_@bparispoker ($20400 in chips)
DeepStack: posts small blind $150
Bryan_Paris_@bparispoker: posts big blind $300
*** HOLE CARDS ***
Dealt to DeepStack [3d 5c]
Dealt to Bryan_Paris_@bparispoker [Ad 7c]
DeepStack: calls $150
Bryan_Paris_@bparispoker: checks
*** FLOP **** [3c 3s 4c]
Bryan_Paris_@bparispoker: checks
DeepStack: checks
*** TURN **** [6h]
Bryan_Paris_@bparispoker: checks
DeepStack: checks
*** RIVER **** [Qc]
Bryan_Paris_@bparispoker: checks
DeepStack: raises $600 to $600
Bryan_Paris_@bparispoker: calls $600
*** SHOW DOWN ***
DeepStack: shows [3d 5c] (three of a kind, Threes)
Bryan_Paris_@bparispoker: shows [Ad 7c] (a pair of Threes)
DeepStack collected $1800 from pot
*** SUMMARY ***
Total pot $1800 | Rake $0
Board [3c 3s 4c 6h Qc]
Seat 1: DeepStack (button) (small blind) showed [3d 5c] and won ($1800) with three of a kind, Threes
Seat 2: Bryan_Paris_@bparispoker (big blind) showed [Ad 7c] and lost with a pair of Threes

PokerStars Hand #13000000039: Tournament #1, May4_2017-at-13_1_19 Hold'em No Limit ($150/$300 USD) - 2017/05/04 15:01:57 ET
Table 'ACPC Match' 2-max Seat #2 is the button
Seat 1: DeepStack ($20500 in chips)
Seat 2: Bryan_Paris_@bparispoker ($19500 in chips)
Bryan_Paris_@bparispoker: posts small blind $150
DeepStack: posts big blind $300
*** HOLE CARDS ***
Dealt to DeepStack [Td 2s]
Dealt to Bryan_Paris_@bparispoker [Ks 4c]
Bryan_Paris_@bparispoker: raises $500 to $800
DeepStack: folds
Uncalled bet ($500) returned to Bryan_Paris_@bparispoker
Bryan_Paris_@bparispoker collected $600 from the pot
*** SUMMARY ***
Total pot $600 | Rake $0
Seat 1: DeepStack (big blind) folded before the Flop
Seat 2: Bryan_Paris_@bparispoker (button) (small blind) collected ($600)

PokerStars Hand #13000000040: Tournament #1, May4_2017-at-13_1_19 Hold'em No Limit ($150/$300 USD) - 2017/05/04 15:01:58 ET
Table 'ACPC Match' 2-max Seat #1 is the button
Seat 1: DeepStack ($20200 in chips)
Seat 2: Bryan_Paris_@bparispoker ($19800 in chips)
DeepStack: posts small blind $150
Bryan_Paris_@bparispoker: posts big blind $300
*** HOLE CARDS ***
Dealt to DeepStack [6h 5d]
Dealt to Bryan_Paris_@bparispoker [7s 7h]
DeepStack: raises $300 to $600
Bryan_Paris_@bparispoker: raises $1500 to $2100
DeepStack: folds
Uncalled bet ($1500) returned to Bryan_Paris_@bparispoker
Bryan_Paris_@bparispoker collected $1200 from the pot
*** SUMMARY ***
Total pot $1200 | Rake $0
Seat 1: DeepStack (button) (small blind) folded before the Flop
Seat 2: Bryan_Paris_@bparispoker (big blind) collected ($1200)

PokerStars Hand #13000000041: Tournament #1, May4_2017-at-13_1_19 Hold'em No Limit ($200/$400 USD) - 2017/05/04 15:01:59 ET
Table 'ACPC Match' 2-max Seat #2 is the button
Seat 1: DeepStack ($19600 in chips)
Seat 2: Bryan_Paris_@bparispoker ($20400 in chips)
Bryan_Paris_@bparispoker: posts small blind $200
DeepStack: posts big blind $400
*** HOLE CARDS ***
Dealt to DeepStack [6c 8d]
Dealt to Bryan_Paris_@bparispoker [7d Kh]
Bryan_Paris_@bparispoker: raises $700 to $1100
DeepStack: calls $700
*** FLOP **** [3c 8h Qs]
DeepStack: checks
Bryan_Paris_@bparispoker: checks
*** TURN **** [6h]
DeepStack: bets $2200
Bryan_Paris_@bparispoker: folds
Uncalled bet ($2200) returned to DeepStack
DeepStack collected $2200 from the pot
*** SUMMARY ***
Total pot $2200 | Rake $0
Board [3c 8h Qs 6h]
Seat 1: DeepStack (big blind) collected ($2200)
Seat 2: Bryan_Paris_@bparispoker (button) (small blind) folded on the Turn

PokerStars Hand #13000000042: Tournament #1, May4_2017-at-13_1_19 Hold'em No Limit ($200/$400 USD) - 2017/05/04 15:02:00 ET
Table 'ACPC Match' 2-max Seat #1 is the button
Seat 1: DeepStack ($20700 in chips)
Seat 2: Bryan_Paris_@bparispoker ($19300 in chips)
DeepStack: posts small blind $200
Bryan_Paris_@bparispoker: posts big blind $400
*** HOLE CARDS ***
Dealt to DeepStack [2h 8h]
Dealt to Bryan_Paris_@bparispoker [Th 2d]
DeepStack: raises $800 to $1200
Bryan_Paris_@bparispoker: folds
Uncalled bet ($800) returned to DeepStack
DeepStack collected $800 from the pot
*** SUMMARY ***
Total pot $800 | Rake $0
Seat 1: DeepStack (button) (small blind) collected ($800)
Seat 2: Bryan_Paris_@bparispoker (big blind) folded before the Flop

PokerStars Hand #13000000043: Tournament #1, May4_2017-at-13_1_19 Hold'em No Limit ($200/$400 USD) - 2017/05/04 15:02:01 ET
Table 'ACPC Match' 2-max Seat #2 is the button
Seat 1: DeepStack ($21100 in chips)
Seat 2: Bryan_Paris_@bparispoker ($18900 in chips)
Bryan_Paris_@bparispoker: posts small blind $200
DeepStack: posts big blind $400
*** HOLE CARDS ***
Dealt to DeepStack [Th 9d]
Dealt to Bryan_Paris_@bparispoker [As 8d]
Bryan_Paris_@bparispoker: raises $700 to $1100
DeepStack: calls $700
*** FLOP **** [7c 4c 8h]
DeepStack: checks
Bryan_Paris_@bparispoker: raises $2050 to $2050
DeepStack: calls $2050
*** TURN **** [Ks]
DeepStack: checks
Bryan_Paris_@bparispoker: raises $4250 to $4250
DeepStack: calls $4250
*** RIVER **** [Ts]
DeepStack: checks
Bryan_Paris_@bparispoker: checks
*** SHOW DOWN ***
DeepStack: shows [Th 9d] (a pair of Tens)
Bryan_Paris_@bparispoker: shows [As 8d] (a pair of Eights)
DeepStack collected $14800 from pot
*** SUMMARY ***
Total pot $14800 | Rake $0
Board [7c 4c 8h Ks Ts]
Seat 1: DeepStack (big blind) showed [Th 9d] and won ($14800) with a pair of Tens
Seat 2: Bryan_Paris_@bparispoker (button) (small blind) showed [As 8d] and lost with a pair of Eights

PokerStars Hand #13000000044: Tournament #1, May4_2017-at-13_1_19 Hold'em No Limit ($200/$400 USD) - 2017/05/04 15:02:02 ET
Table 'ACPC Match' 2-max Seat #1 is the button
Seat 1: DeepStack ($28500 in chips)
Seat 2: Bryan_Paris_@bparispoker ($11500 in chips)
DeepStack: posts small blind $200
Bryan_Paris_@bparispoker: posts big blind $400
*** HOLE CARDS ***
Dealt to DeepStack [6h Ks]
Dealt to Bryan_Paris_@bparispoker [Ac 3s]
DeepStack: calls $200
Bryan_Paris_@bparispoker: checks
*** FLOP **** [6c Kc 9c]
Bryan_Paris_@bparispoker: checks
DeepStack: raises $400 to $400
Bryan_Paris_@bparispoker: raises $1400 to $1800
DeepStack: calls $1400
*** TURN **** [Ad]
Bryan_Paris_@bparispoker: bets $1800
DeepStack: calls $1800
*** RIVER **** [Tc]
Bryan_Paris_@bparispoker: bets $7500 and is all-in
DeepStack: folds
Uncalled bet ($7500) returned to Bryan_Paris_@bparispoker
Bryan_Paris_@bparispoker collected $8000 from the pot
*** SUMMARY ***
Total pot $8000 | Rake $0
Board [6c Kc 9c Ad Tc]
Seat 1: DeepStack (button) (small blind) folded on the River
Seat 2: Bryan_Paris_@bparispoker (big blind) collected ($8000)

PokerStars Hand #13000000045: Tournament #1, May4_2017-at-13_1_19 Hold'em No Limit ($200/$400 USD) - 2017/05/04 15:02:03 ET
Table 'ACPC Match' 2-max Seat #2 is the button
Seat 1: DeepStack ($24500 in chips)
Seat 2: Bryan_Paris_@bparispoker ($15500 in chips)
Bryan_Paris_@bparispoker: posts small blind $200
DeepStack: posts big blind $400
*** HOLE CARDS ***
Dealt to DeepStack [2d 3c]
Dealt to Bryan_Paris_@bparispoker [4s 4h]
Bryan_Paris_@bparispoker: raises $600 to $1000
DeepStack: folds
Uncalled bet ($600) returned to Bryan_Paris_@bparispoker
Bryan_Paris_@bparispoker collected $800 from the pot
*** SUMMARY ***
Total pot $800 | Rake $0
Seat 1: DeepStack (big blind) folded before the Flop
Seat 2: Bryan_Paris_@bparispoker (button) (small blind) collected ($800)

PokerStars Hand #13000000046: Tournament #1, May4_2017-at-13_1_19 Hold'em No Limit ($200/$400 USD) - 2017/05/04 15:02:04 ET
Table 'ACPC Match' 2-max Seat #1 is the button
Seat 1: DeepStack ($24100 in chips)
Seat 2: Bryan_Paris_@bparispoker ($15900 in chips)
DeepStack: posts small blind $200
Bryan_Paris_@bparispoker: posts big blind $400
*** HOLE CARDS ***
Dealt to DeepStack [4c 5d]
Dealt to Bryan_Paris_@bparispoker [8h 3c]
DeepStack: raises $400 to $800
Bryan_Paris_@bparispoker: folds
Uncalled bet ($400) returned to DeepStack
DeepStack collected $800 from the pot
*** SUMMARY ***
Total pot $800 | Rake $0
Seat 1: DeepStack (button) (small blind) collected ($800)
Seat 2: Bryan_Paris_@bparispoker (big blind) folded before the Flop

PokerStars Hand #13000000047: Tournament #1, May4_2017-at-13_1_19 Hold'em No Limit ($200/$400 USD) - 2017/05/04 15:02:05 ET
Table 'ACPC Match' 2-max Seat #2 is the button
Seat 1: DeepStack ($24500 in chips)
Seat 2: Bryan_Paris_@bparispoker ($15500 in chips)
Bryan_Paris_@bparispoker: posts small blind $200
DeepStack: posts big blind $400
*** HOLE CARDS ***
Dealt to DeepStack [7c 4d]
Dealt to Bryan_Paris_@bparispoker [3h 9h]
Bryan_Paris_@bparispoker: raises $600 to $1000
DeepStack: folds
Uncalled bet ($600) returned to Bryan_Paris_@bparispoker
Bryan_Paris_@bparispoker collected $800 from the pot
*** SUMMARY ***
Total pot $800 | Rake $0
Seat 1: DeepStack (big blind) folded before the Flop
Seat 2: Bryan_Paris_@bparispoker (button) (small blind) collected ($800)

PokerStars Hand #13000000048: Tournament #1, May4_2017-at-13_1_19 Hold'em No Limit ($200/$400 USD) - 2017/05/04 15:02:06 ET
Table 'ACPC Match' 2-max Seat #1 is the button
Seat 1: DeepStack ($24100 in chips)
Seat 2: Bryan_Paris_@bparispoker ($15900 in chips)
DeepStack: posts small blind $200
Bryan_Paris_@bparispoker: posts big blind $400
*** HOLE CARDS ***
Dealt to DeepStack [4c 9s]
Dealt to Bryan_Paris_@bparispoker [Qc 2s]
DeepStack: calls $200
Bryan_Paris_@bparispoker: checks
*** FLOP **** [3d Jc 5c]
Bryan_Paris_@bparispoker: checks
DeepStack: raises $400 to $400
Bryan_Paris_@bparispoker: folds
Uncalled bet ($400) returned to DeepStack
DeepStack collected $800 from the pot
*** SUMMARY ***
Total pot $800 | Rake $0
Board [3d Jc 5c]
Seat 1: DeepStack (button) (small blind) collected ($800)
Seat 2: Bryan_Paris_@bparispoker (big blind) folded on the Flop

PokerStars Hand #13000000049: Tournament #1, May4_2017-at-13_1_19 Hold'em No Limit ($200/$400 USD) - 2017/05/04 15:02:07 ET
Table 'ACPC Match' 2-max Seat #2 is the button
Seat 1: DeepStack ($24500 in chips)
Seat 2: Bryan_Paris_@bparispoker ($15500 in chips)
Bryan_Paris_@bparispoker: posts small blind $200
DeepStack: posts big blind $400
*** HOLE CARDS ***
Dealt to DeepStack [9s 2d]
Dealt to Bryan_Paris_@bparispoker [Kd Qc]
Bryan_Paris_@bparispoker: raises $700 to $1100
DeepStack: folds
Uncalled bet ($700) returned to Bryan_Paris_@bparispoker
Bryan_Paris_@bparispoker collected $800 from the pot
*** SUMMARY ***
Total pot $800 | Rake $0
Seat 1: DeepStack (big blind) folded before the Flop
Seat 2: Bryan_Paris_@bparispoker (button) (small blind) collected ($800)

PokerStars Hand #13000000050: Tournament #1, May4_2017-at-13_1_19 Hold'em No Limit ($200/$400 USD) - 2017/05/04 15:02:08 ET
Table 'ACPC Match' 2-max Seat #1 is the button
Seat 1: DeepStack ($24100 in chips)
Seat 2: Bryan_Paris_@bparispoker ($15900 in chips)
DeepStack: posts small blind $200
Bryan_Paris_@bparispoker: posts big blind $400
*** HOLE CARDS ***
Dealt to DeepStack [As Ks]
Dealt to Bryan_Paris_@bparispoker [8h 3h]
DeepStack: calls $200
Bryan_Paris_@bparispoker: checks
*** FLOP **** [4h Tc Ts]
Bryan_Paris_@bparispoker: checks
DeepStack: raises $400 to $400
Bryan_Paris_@bparispoker: folds
Uncalled bet ($400) returned to DeepStack
DeepStack collected $800 from the pot
*** SUMMARY ***
Total pot $800 | Rake $0
Board [4h Tc Ts]
Seat 1: DeepStack (button) (small blind) collected ($800)
Seat 2: Bryan_Paris_@bparispoker (big blind) folded on the Flop

PokerStars Hand #13000000051: Tournament #1, May4_2017-at-13_1_19 Hold'em No Limit ($300/$600 USD) - 2017/05/04 15:02:09 ET
Table 'ACPC Match' 2-max Seat #2 is the button
Seat 1: DeepStack ($24500 in chips)
Seat 2: Bryan_Paris_@bparispoker ($15500 in chips)
Bryan_Paris_@bparispoker: posts small blind $300
DeepStack: posts big blind $600
*** HOLE CARDS ***
Dealt to DeepStack [7c Qh]
Dealt to Bryan_Paris_@bparispoker [9d Kd]
Bryan_Paris_@bparispoker: raises $700 to $1300
DeepStack: calls $700
*** FLOP **** [Ts 6c 7h]
DeepStack: checks
Bryan_Paris_@bparispoker: raises $1700 to $1700
DeepStack: raises $3000 to $4700
Bryan_Paris_@bparispoker: folds
Uncalled bet ($3000) returned to DeepStack
DeepStack collected $6000 from the pot
*** SUMMARY ***
Total pot $6000 | Rake $0
Board [Ts 6c 7h]
Seat 1: DeepStack (big blind) collected ($6000)
Seat 2: Bryan_Paris_@bparispoker (button) (small blind) folded on the Flop

PokerStars Hand #13000000052: Tournament #1, May4_2017-at-13_1_19 Hold'em No Limit ($300/$600 USD) - 2017/05/04 15:02:10 ET
Table 'ACPC Match' 2-max Seat #1 is the button
Seat 1: DeepStack ($27500 in chips)
Seat 2: Bryan_Paris_@bparispoker ($12500 in chips)
DeepStack: posts small blind $300
Bryan_Paris_@bparispoker: posts big blind $600
*** HOLE CARDS ***
Dealt to DeepStack [Th 3s]
Dealt to Bryan_Paris_@bparispoker [Kd 3c]
DeepStack: calls $300
Bryan_Paris_@bparispoker: checks
*** FLOP **** [Jc 6d 9h]
Bryan_Paris_@bparispoker: checks
DeepStack: checks
*** TURN **** [Qc]
Bryan_Paris_@bparispoker: checks
DeepStack: checks
*** RIVER **** [6c]
Bryan_Paris_@bparispoker: checks
DeepStack: checks
*** SHOW DOWN ***
Bryan_Paris_@bparispoker: shows [Kd 3c] (a pair of Sixes)
DeepStack: shows [Th 3s] (a pair of Sixes)
Bryan_Paris_@bparispoker collected $1200 from pot
*** SUMMARY ***
Total pot $1200 | Rake $0
Board [Jc 6d 9h Qc 6c]
Seat 1: DeepStack (button) (small blind) showed [Th 3s] and lost with a pair of Sixes
Seat 2: Bryan_Paris_@bparispoker (big blind) showed [Kd 3c] and won ($1200) with a pair of Sixes

PokerStars Hand #13000000053: Tournament #1, May4_2017-at-13_1_19 Hold'em No Limit ($300/$600 USD) - 2017/05/04 15:02:11 ET
Table 'ACPC Match' 2-max Seat #2 is the button
Seat 1: DeepStack ($26900 in chips)
Seat 2: Bryan_Paris_@bparispoker ($13100 in chips)
Bryan_Paris_@bparispoker: posts small blind $300
DeepStack: posts big blind $600
*** HOLE CARDS ***
Dealt to DeepStack [Qc Ac]
Dealt to Bryan_Paris_@bparispoker [Ks 7c]
Bryan_Paris_@bparispoker: raises $700 to $1300
DeepStack: raises $2600 to $3900
Bryan_Paris_@bparispoker: folds
Uncalled bet ($2600) returned to DeepStack
DeepStack collected $2600 from the pot
*** SUMMARY ***
Total pot $2600 | Rake $0
Seat 1: DeepStack (big blind) collected ($2600)
Seat 2: Bryan_Paris_@bparispoker (button) (small blind) folded before the Flop

PokerStars Hand #13000000054: Tournament #1, May4_2017-at-13_1_19 Hold'em No Limit ($300/$600 USD) - 2017/05/04 15:02:12 ET
Table 'ACPC Match' 2-max Seat #1 is the button
Seat 1: DeepStack ($28200 in chips)
Seat 2: Bryan_Paris_@bparispoker ($11800 in chips)
DeepStack: posts small blind $300
Bryan_Paris_@bparispoker: posts big blind $600
*** HOLE CARDS ***
Dealt to DeepStack [2h 2c]
Dealt to Bryan_Paris_@bparispoker [Jh 2d]
DeepStack: raises $11200 to $11800
Bryan_Paris_@bparispoker: folds
Uncalled bet ($11200) returned to DeepStack
DeepStack collected $1200 from the pot
*** SUMMARY ***
Total pot $1200 | Rake $0
Seat 1: DeepStack (button) (small blind) collected ($1200)
Seat 2: Bryan_Paris_@bparispoker (big blind) folded before the Flop

PokerStars Hand #13000000055: Tournament #1, May4_2017-at-13_1_19 Hold'em No Limit ($300/$600 USD) - 2017/05/04 15:02:13 ET
Table 'ACPC Match' 2-max Seat #2 is the button
Seat 1: DeepStack ($28800 in chips)
Seat 2: Bryan_Paris_@bparispoker ($11200 in chips)
Bryan_Paris_@bparispoker: posts small blind $300
DeepStack: posts big blind $600
*** HOLE CARDS ***
Dealt to DeepStack [9h 7c]
Dealt to Bryan_Paris_@bparispoker [Kc 3c]
Bryan_Paris_@bparispoker: calls $300
DeepStack: checks
*** FLOP **** [Jc Ad Ks]
DeepStack: checks
Bryan_Paris_@bparispoker: raises $600 to $600
DeepStack: folds
Uncalled bet ($600) returned to Bryan_Paris_@bparispoker
Bryan_Paris_@bparispoker collected $1200 from the pot
*** SUMMARY ***
Total pot $1200 | Rake $0
Board [Jc Ad Ks]
Seat 1: DeepStack (big blind) folded on the Flop
Seat 2: Bryan_Paris_@bparispoker (button) (small blind) collected ($1200)

PokerStars Hand #13000000056: Tournament #1, May4_2017-at-13_1_19 Hold'em No Limit ($300/$600 USD) - 2017/05/04 15:02:14 ET
Table 'ACPC Match' 2-max Seat #1 is the button
Seat 1: DeepStack ($28200 in chips)
Seat 2: Bryan_Paris_@bparispoker ($11800 in chips)
DeepStack: posts small blind $300
Bryan_Paris_@bparispoker: posts big blind $600
*** HOLE CARDS ***
Dealt to DeepStack [7h 4s]
Dealt to Bryan_Paris_@bparispoker [7c 3s]
DeepStack: calls $300
Bryan_Paris_@bparispoker: checks
*** FLOP **** [Jd Js Ad]
Bryan_Paris_@bparispoker: checks
DeepStack: checks
*** TURN **** [9s]
Bryan_Paris_@bparispoker: checks
DeepStack: checks
*** RIVER **** [3h]
Bryan_Paris_@bparispoker: checks
DeepStack: checks
*** SHOW DOWN ***
Bryan_Paris_@bparispoker: shows [7c 3s] (two pair, Jacks and Threes)
DeepStack: shows [7h 4s] (a pair of Jacks)
Bryan_Paris_@bparispoker collected $1200 from pot
*** SUMMARY ***
Total pot $1200 | Rake $0
Board [Jd Js Ad 9s 3h]
Seat 1: DeepStack (button) (small blind) showed [7h 4s] and lost with a pair of Jacks
Seat 2: Bryan_Paris_@bparispoker (big blind) showed [7c 3s] and won ($1200) with two pair, Jacks and Threes

PokerStars Hand #13000000057: Tournament #1, May4_2017-at-13_1_19 Hold'em No Limit ($300/$600 USD) - 2017/05/04 15:02:15 ET
Table 'ACPC Match' 2-max Seat #2 is the button
Seat 1: DeepStack ($27600 in chips)
Seat 2: Bryan_Paris_@bparispoker ($12400 in chips)
Bryan_Paris_@bparispoker: posts small blind $300
DeepStack: posts big blind $600
*** HOLE CARDS ***
Dealt to DeepStack [Ks 6d]
Dealt to Bryan_Paris_@bparispoker [9s 5h]
Bryan_Paris_@bparispoker: calls $300
DeepStack: raises $11800 to $12400
Bryan_Paris_@bparispoker: folds
Uncalled bet ($11800) returned to DeepStack
DeepStack collected $1200 from the pot
*** SUMMARY ***
Total pot $1200 | Rake $0
Seat 1: DeepStack (big blind) collected ($1200)
Seat 2: Bryan_Paris_@bparispoker (button) (small blind) folded before the Flop

PokerStars Hand #13000000058: Tournament #1, May4_2017-at-13_1_19 Hold'em No Limit ($300/$600 USD) - 2017/05/04 15:02:16 ET
Table 'ACPC Match' 2-max Seat #1 is the button
Seat 1: DeepStack ($28200 in chips)
Seat 2: Bryan_Paris_@bparispoker ($11800 in chips)
DeepStack: posts small blind $300
Bryan_Paris_@bparispoker: posts big blind $600
*** HOLE CARDS ***
Dealt to DeepStack [Ac Js]
Dealt to Bryan_Paris_@bparispoker [6h Kd]
DeepStack: calls $300
Bryan_Paris_@bparispoker: raises $11200 to $11800 and is all-in
DeepStack: calls $11200
*** FLOP **** [Kc 3h 7d]
*** TURN **** [4h]
*** RIVER **** [Qs]
*** SHOW DOWN ***
Bryan_Paris_@bparispoker: shows [6h Kd] (a pair of Kings)
DeepStack: shows [Ac Js] (Ace high)
Bryan_Paris_@bparispoker collected $23600 from pot
*** SUMMARY ***
Total pot $23600 | Rake $0
Board [Kc 3h 7d 4h Qs]
Seat 1: DeepStack (button) (small blind) showed [Ac Js] and lost with Ace high
Seat 2: Bryan_Paris_@bparispoker (big blind) showed [6h Kd] and won ($23600) with a pair of Kings

PokerStars Hand #13000000059: Tournament #1, May4_2017-at-13_1_19 Hold'em No Limit ($300/$600 USD) - 2017/05/04 15:02:17 ET
Table 'ACPC Match' 2-max Seat #2 is the button
Seat 1: DeepStack ($16400 in chips)
Seat 2: Bryan_Paris_@bparispoker ($23600 in chips)
Bryan_Paris_@bparispoker: posts small blind $300
DeepStack: posts big blind $600
*** HOLE CARDS ***
Dealt to DeepStack [6c Jd]
Dealt to Bryan_Paris_@bparispoker [3h 8h]
Bryan_Paris_@bparispoker: calls $300
DeepStack: checks
*** FLOP **** [Kc Qh Ad]
DeepStack: bets $600
Bryan_Paris_@bparispoker: folds
Uncalled bet ($600) returned to DeepStack
DeepStack collected $1200 from the pot
*** SUMMARY ***
Total pot $1200 | Rake $0
Board [Kc Qh Ad]
Seat 1: DeepStack (big blind) collected ($1200)
Seat 2: Bryan_Paris_@bparispoker (button) (small blind) folded on the Flop

PokerStars Hand #13000000060: Tournament #1, May4_2017-at-13_1_19 Hold'em No Limit ($300/$600 USD) - 2017/05/04 15:02:18 ET
Table 'ACPC Match' 2-max Seat #1 is the button
Seat 1: DeepStack ($17000 in chips)
Seat 2: Bryan_Paris_@bparispoker ($23000 in chips)
DeepStack: posts small blind $300
Bryan_Paris_@bparispoker: posts big blind $600
*** HOLE CARDS ***
Dealt to DeepStack [4s 2h]
Dealt to Bryan_Paris_@bparispoker [Ah 2c]
DeepStack: folds
Uncalled bet ($300) returned to Bryan_Paris_@bparispoker
Bryan_Paris_@bparispoker collected $600 from the pot
*** SUMMARY ***
Total pot $600 | Rake $0
Seat 1: DeepStack (button) (small blind) folded before the Flop
Seat 2: Bryan_Paris_@bparispoker (big blind) collected ($600)

PokerStars Hand #13000000061: Tournament #1, May4_2017-at-13_1_19 Hold'em No Limit ($400/$800 USD) - 2017/05/04 15:02:19 ET
Table 'ACPC Match' 2-max Seat #2 is the button
Seat 1: DeepStack ($16700 in chips)
Seat 2: Bryan_Paris_@bparispoker ($23300 in chips)
Bryan_Paris_@bparispoker: posts small blind $400
DeepStack: posts big blind $800
*** HOLE CARDS ***
Dealt to DeepStack [As Ts]
Dealt to Bryan_Paris_@bparispoker [Jc Ks]
Bryan_Paris_@bparispoker: raises $800 to $1600
DeepStack: raises $15100 to $16700 and is all-in
Bryan_Paris_@bparispoker: calls $15100
*** FLOP **** [7d Jh 2c]
*** TURN **** [7h]
*** RIVER **** [5d]
*** SHOW DOWN ***
DeepStack: shows [As Ts] (a pair of Sevens)
Bryan_Paris_@bparispoker: shows [Jc Ks] (two pair, Jacks and Sevens)
Bryan_Paris_@bparispoker collected $33400 from pot
*** SUMMARY ***
Total pot $33400 | Rake $0
Board [7d Jh 2c 7h 5d]
Seat 1: DeepStack (big blind) showed [As Ts] and lost with a pair of Sevens
Seat 2: Bryan_Paris_@bparispoker (button) (small blind) showed [Jc Ks] and won ($33400) with two pair, Jacks and Sevens
