PokerStars Hand #13000400001: Tournament #5, May4_2017-at-15_32_53 Hold'em No Limit ($50/$100 USD) - 2017/05/04 17:32:53 ET
Table 'ACPC Match' 2-max Seat #2 is the button
Seat 1: DeepStack ($20000 in chips)
Seat 2: Bryan_Paris_@bparispoker ($20000 in chips)
Bryan_Paris_@bparispoker: posts small blind $50
DeepStack: posts big blind $100
*** HOLE CARDS ***
Dealt to DeepStack [9c Jh]
Dealt to Bryan_Paris_@bparispoker [8c 5h]
Bryan_Paris_@bparispoker: folds
Uncalled bet ($50) returned to DeepStack
DeepStack collected $100 from the pot
*** SUMMARY ***
Total pot $100 | Rake $0
Seat 1: DeepStack (big blind) collected ($100)
Seat 2: Bryan_Paris_@bparispoker (button) (small blind) folded before the Flop

PokerStars Hand #13000400002: Tournament #5, May4_2017-at-15_32_53 Hold'em No Limit ($50/$100 USD) - 2017/05/04 17:32:54 ET
Table 'ACPC Match' 2-max Seat #1 is the button
Seat 1: DeepStack ($20050 in chips)
Seat 2: Bryan_Paris_@bparispoker ($19950 in chips)
DeepStack: posts small blind $50
Bryan_Paris_@bparispoker: posts big blind $100
*** HOLE CARDS ***
Dealt to DeepStack [8s 4h]
Dealt to Bryan_Paris_@bparispoker [Td Ah]
DeepStack: calls $50
Bryan_Paris_@bparispoker: raises $350 to $450
DeepStack: folds
Uncalled bet ($350) returned to Bryan_Paris_@bparispoker
Bryan_Paris_@bparispoker collected $200 from the pot
*** SUMMARY ***
Total pot $200 | Rake $0
Seat 1: DeepStack (button) (small blind) folded before the Flop
Seat 2: Bryan_Paris_@bparispoker (big blind) collected ($200)

PokerStars Hand #13000400003: Tournament #5, May4_2017-at-15_32_53 Hold'em No Limit ($50/$100 USD) - 2017/05/04 17:32:55 ET
Table 'ACPC Match' 2-max Seat #2 is the button
Seat 1: DeepStack ($19950 in chips)
Seat 2: Bryan_Paris_@bparispoker ($20050 in chips)
Bryan_Paris_@bparispoker: posts small blind $50
DeepStack: posts big blind $100
*** HOLE CARDS ***
Dealt to DeepStack [4c 9s]
Dealt to Bryan_Paris_@bparispoker [7c 7d]
Bryan_Paris_@bparispoker: raises $200 to $300
DeepStack: folds
Uncalled bet ($200) returned to Bryan_Paris_@bparispoker
Bryan_Paris_@bparispoker collected $200 from the pot
*** SUMMARY ***
Total pot $200 | Rake $0
Seat 1: DeepStack (big blind) folded before the Flop
Seat 2: Bryan_Paris_@bparispoker (button) (small blind) collected ($200)

PokerStars Hand #13000400004: Tournament #5, May4_2017-at-15_32_53 Hold'em No Limit ($50/$100 USD) - 2017/05/04 17:32:56 ET
Table 'ACPC Match' 2-max Seat #1 is the button
Seat 1: DeepStack ($19850 in chips)
Seat 2: Bryan_Paris_@bparispoker ($20150 in chips)
DeepStack: posts small blind $50
Bryan_Paris_@bparispoker: posts big blind $100
*** HOLE CARDS ***
Dealt to DeepStack [8c 8d]
Dealt to Bryan_Paris_@bparispoker [6d Th]
DeepStack: raises $200 to $300
Bryan_Paris_@bparispoker: folds
Uncalled bet ($200) returned to DeepStack
DeepStack collected $200 from the pot
*** SUMMARY ***
Total pot $200 | Rake $0
Seat 1: DeepStack (button) (small blind) collected ($200)
Seat 2: Bryan_Paris_@bparispoker (big blind) folded before the Flop

PokerStars Hand #13000400005: Tournament #5, May4_2017-at-15_32_53 Hold'em No Limit ($50/$100 USD) - 2017/05/04 17:32:57 ET
Table 'ACPC Match' 2-max Seat #2 is the button
Seat 1: DeepStack ($19950 in chips)
Seat 2: Bryan_Paris_@bparispoker ($20050 in chips)
Bryan_Paris_@bparispoker: posts small blind $50
DeepStack: posts big blind $100
*** HOLE CARDS ***
Dealt to DeepStack [Kd 9h]
Dealt to Bryan_Paris_@bparispoker [Jd 5h]
Bryan_Paris_@bparispoker: folds
Uncalled bet ($50) returned to DeepStack
DeepStack collected $100 from the pot
*** SUMMARY ***
Total pot $100 | Rake $0
Seat 1: DeepStack (big blind) collected ($100)
Seat 2: Bryan_Paris_@bparispoker (button) (small blind) folded before the Flop

PokerStars Hand #13000400006: Tournament #5, May4_2017-at-15_32_53 Hold'em No Limit ($50/$100 USD) - 2017/05/04 17:32:58 ET
Table 'ACPC Match' 2-max Seat #1 is the button
Seat 1: DeepStack ($20000 in chips)
Seat 2: Bryan_Paris_@bparispoker ($20000 in chips)
DeepStack: posts small blind $50
Bryan_Paris_@bparispoker: posts big blind $100
*** HOLE CARDS ***
Dealt to DeepStack [5c 6c]
Dealt to Bryan_Paris_@bparispoker [Td Ah]
DeepStack: calls $50
Bryan_Paris_@bparispoker: raises $350 to $450
DeepStack: raises $900 to $1350
Bryan_Paris_@bparispoker: folds
Uncalled bet ($900) returned to DeepStack
DeepStack collected $900 from the pot
*** SUMMARY ***
Total pot $900 | Rake $0
Seat 1: DeepStack (button) (small blind) collected ($900)
Seat 2: Bryan_Paris_@bparispoker (big blind) folded before the Flop

PokerStars Hand #13000400007: Tournament #5, May4_2017-at-15_32_53 Hold'em No Limit ($50/$100 USD) - 2017/05/04 17:32:59 ET
Table 'ACPC Match' 2-max Seat #2 is the button
Seat 1: DeepStack ($20450 in chips)
Seat 2: Bryan_Paris_@bparispoker ($19550 in chips)
Bryan_Paris_@bparispoker: posts small blind $50
DeepStack: posts big blind $100
*** HOLE CARDS ***
Dealt to DeepStack [Th Ad]
Dealt to Bryan_Paris_@bparispoker [5s Qs]
Bryan_Paris_@bparispoker: raises $200 to $300
DeepStack: raises $600 to $900
Bryan_Paris_@bparispoker: folds
Uncalled bet ($600) returned to DeepStack
DeepStack collected $600 from the pot
*** SUMMARY ***
Total pot $600 | Rake $0
Seat 1: DeepStack (big blind) collected ($600)
Seat 2: Bryan_Paris_@bparispoker (button) (small blind) folded before the Flop

PokerStars Hand #13000400008: Tournament #5, May4_2017-at-15_32_53 Hold'em No Limit ($50/$100 USD) - 2017/05/04 17:33:00 ET
Table 'ACPC Match' 2-max Seat #1 is the button
Seat 1: DeepStack ($20750 in chips)
Seat 2: Bryan_Paris_@bparispoker ($19250 in chips)
DeepStack: posts small blind $50
Bryan_Paris_@bparispoker: posts big blind $100
*** HOLE CARDS ***
Dealt to DeepStack [5d 7d]
Dealt to Bryan_Paris_@bparispoker [2d Qs]
DeepStack: calls $50
Bryan_Paris_@bparispoker: checks
*** FLOP **** [8s Jc Qh]
Bryan_Paris_@bparispoker: checks
DeepStack: raises $200 to $200
Bryan_Paris_@bparispoker: calls $200
*** TURN **** [6h]
Bryan_Paris_@bparispoker: checks
DeepStack: raises $600 to $600
Bryan_Paris_@bparispoker: calls $600
*** RIVER **** [Ks]
Bryan_Paris_@bparispoker: checks
DeepStack: checks
*** SHOW DOWN ***
Bryan_Paris_@bparispoker: shows [2d Qs] (a pair of Queens)
DeepStack: shows [5d 7d] (King high)
Bryan_Paris_@bparispoker collected $1800 from pot
*** SUMMARY ***
Total pot $1800 | Rake $0
Board [8s Jc Qh 6h Ks]
Seat 1: DeepStack (button) (small blind) showed [5d 7d] and lost with King high
Seat 2: Bryan_Paris_@bparispoker (big blind) showed [2d Qs] and won ($1800) with a pair of Queens

PokerStars Hand #13000400009: Tournament #5, May4_2017-at-15_32_53 Hold'em No Limit ($50/$100 USD) - 2017/05/04 17:33:01 ET
Table 'ACPC Match' 2-max Seat #2 is the button
Seat 1: DeepStack ($19850 in chips)
Seat 2: Bryan_Paris_@bparispoker ($20150 in chips)
Bryan_Paris_@bparispoker: posts small blind $50
DeepStack: posts big blind $100
*** HOLE CARDS ***
Dealt to DeepStack [3c 9d]
Dealt to Bryan_Paris_@bparispoker [Jd 5d]
Bryan_Paris_@bparispoker: raises $200 to $300
DeepStack: folds
Uncalled bet ($200) returned to Bryan_Paris_@bparispoker
Bryan_Paris_@bparispoker collected $200 from the pot
*** SUMMARY ***
Total pot $200 | Rake $0
Seat 1: DeepStack (big blind) folded before the Flop
Seat 2: Bryan_Paris_@bparispoker (button) (small blind) collected ($200)

PokerStars Hand #13000400010: Tournament #5, May4_2017-at-15_32_53 Hold'em No Limit ($50/$100 USD) - 2017/05/04 17:33:02 ET
Table 'ACPC Match' 2-max Seat #1 is the button
Seat 1: DeepStack ($19750 in chips)
Seat 2: Bryan_Paris_@bparispoker ($20250 in chips)
DeepStack: posts small blind $50
Bryan_Paris_@bparispoker: posts big blind $100
*** HOLE CARDS ***
Dealt to DeepStack [Ac 9c]
Dealt to Bryan_Paris_@bparispoker [8c 4d]
DeepStack: raises $200 to $300
Bryan_Paris_@bparispoker: folds
Uncalled bet ($200) returned to DeepStack
DeepStack collected $200 from the pot
*** SUMMARY ***
Total pot $200 | Rake $0
Seat 1: DeepStack (button) (small blind) collected ($200)
Seat 2: Bryan_Paris_@bparispoker (big blind) folded before the Flop

PokerStars Hand #13000400011: Tournament #5, May4_2017-at-15_32_53 Hold'em No Limit ($75/$150 USD) - 2017/05/04 17:33:03 ET
Table 'ACPC Match' 2-max Seat #2 is the button
Seat 1: DeepStack ($19850 in chips)
Seat 2: Bryan_Paris_@bparispoker ($20150 in chips)
Bryan_Paris_@bparispoker: posts small blind $75
DeepStack: posts big blind $150
*** HOLE CARDS ***
Dealt to DeepStack [6d 6h]
Dealt to Bryan_Paris_@bparispoker [3c 5d]
Bryan_Paris_@bparispoker: folds
Uncalled bet ($75) returned to DeepStack
DeepStack collected $150 from the pot
*** SUMMARY ***
Total pot $150 | Rake $0
Seat 1: DeepStack (big blind) collected ($150)
Seat 2: Bryan_Paris_@bparispoker (button) (small blind) folded before the Flop

PokerStars Hand #13000400012: Tournament #5, May4_2017-at-15_32_53 Hold'em No Limit ($75/$150 USD) - 2017/05/04 17:33:04 ET
Table 'ACPC Match' 2-max Seat #1 is the button
Seat 1: DeepStack ($19925 in chips)
Seat 2: Bryan_Paris_@bparispoker ($20075 in chips)
DeepStack: posts small blind $75
Bryan_Paris_@bparispoker: posts big blind $150
*** HOLE CARDS ***
Dealt to DeepStack [8s 5s]
Dealt to Bryan_Paris_@bparispoker [3d Qh]
DeepStack: calls $75
Bryan_Paris_@bparispoker: checks
*** FLOP **** [Js 9h Ts]
Bryan_Paris_@bparispoker: checks
DeepStack: raises $150 to $150
Bryan_Paris_@bparispoker: raises $575 to $725
DeepStack: calls $575
*** TURN **** [7h]
Bryan_Paris_@bparispoker: checks
DeepStack: raises $875 to $875
Bryan_Paris_@bparispoker: folds
Uncalled bet ($875) returned to DeepStack
DeepStack collected $1750 from the pot
*** SUMMARY ***
Total pot $1750 | Rake $0
Board [Js 9h Ts 7h]
Seat 1: DeepStack (button) (small blind) collected ($1750)
Seat 2: Bryan_Paris_@bparispoker (big blind) folded on the Turn

PokerStars Hand #13000400013: Tournament #5, May4_2017-at-15_32_53 Hold'em No Limit ($75/$150 USD) - 2017/05/04 17:33:05 ET
Table 'ACPC Match' 2-max Seat #2 is the button
Seat 1: DeepStack ($20800 in chips)
Seat 2: Bryan_Paris_@bparispoker ($19200 in chips)
Bryan_Paris_@bparispoker: posts small blind $75
DeepStack: posts big blind $150
*** HOLE CARDS ***
Dealt to DeepStack [6d Ac]
Dealt to Bryan_Paris_@bparispoker [Ks Ah]
Bryan_Paris_@bparispoker: raises $300 to $450
DeepStack: calls $300
*** FLOP **** [7c Qh 9s]
DeepStack: checks
Bryan_Paris_@bparispoker: raises $750 to $750
DeepStack: folds
Uncalled bet ($750) returned to Bryan_Paris_@bparispoker
Bryan_Paris_@bparispoker collected $900 from the pot
*** SUMMARY ***
Total pot $900 | Rake $0
Board [7c Qh 9s]
Seat 1: DeepStack (big blind) folded on the Flop
Seat 2: Bryan_Paris_@bparispoker (button) (small blind) collected ($900)

PokerStars Hand #13000400014: Tournament #5, May4_2017-at-15_32_53 Hold'em No Limit ($75/$150 USD) - 2017/05/04 17:33:06 ET
Table 'ACPC Match' 2-max Seat #1 is the button
Seat 1: DeepStack ($20350 in chips)
Seat 2: Bryan_Paris_@bparispoker ($19650 in chips)
DeepStack: posts small blind $75
Bryan_Paris_@bparispoker: posts big blind $150
*** HOLE CARDS ***
Dealt to DeepStack [3s Ts]
Dealt to Bryan_Paris_@bparispoker [5h 6d]
DeepStack: raises $300 to $450
Bryan_Paris_@bparispoker: folds
Uncalled bet ($300) returned to DeepStack
DeepStack collected $300 from the pot
*** SUMMARY ***
Total pot $300 | Rake $0
Seat 1: DeepStack (button) (small blind) collected ($300)
Seat 2: Bryan_Paris_@bparispoker (big blind) folded before the Flop

PokerStars Hand #13000400015: Tournament #5, May4_2017-at-15_32_53 Hold'em No Limit ($75/$150 USD) - 2017/05/04 17:33:07 ET
Table 'ACPC Match' 2-max Seat #2 is the button
Seat 1: DeepStack ($20500 in chips)
Seat 2: Bryan_Paris_@bparispoker ($19500 in chips)
Bryan_Paris_@bparispoker: posts small blind $75
DeepStack: posts big blind $150
*** HOLE CARDS ***
Dealt to DeepStack [Qs 7s]
Dealt to Bryan_Paris_@bparispoker [3s Ac]
Bryan_Paris_@bparispoker: raises $300 to $450
DeepStack: calls $300
*** FLOP **** [9h 5s 2d]
DeepStack: checks
Bryan_Paris_@bparispoker: raises $600 to $600
DeepStack: folds
Uncalled bet ($600) returned to Bryan_Paris_@bparispoker
Bryan_Paris_@bparispoker collected $900 from the pot
*** SUMMARY ***
Total pot $900 | Rake $0
Board [9h 5s 2d]
Seat 1: DeepStack (big blind) folded on the Flop
Seat 2: Bryan_Paris_@bparispoker (button) (small blind) collected ($900)

PokerStars Hand #13000400016: Tournament #5, May4_2017-at-15_32_53 Hold'em No Limit ($75/$150 USD) - 2017/05/04 17:33:08 ET
Table 'ACPC Match' 2-max Seat #1 is the button
Seat 1: DeepStack ($20050 in chips)
Seat 2: Bryan_Paris_@bparispoker ($19950 in chips)
DeepStack: posts small blind $75
Bryan_Paris_@bparispoker: posts big blind $150
*** HOLE CARDS ***
Dealt to DeepStack [8d Qd]
Dealt to Bryan_Paris_@bparispoker [Qs 8c]
DeepStack: calls $75
Bryan_Paris_@bparispoker: checks
*** FLOP **** [3h 6h 4d]
Bryan_Paris_@bparispoker: checks
DeepStack: checks
*** TURN **** [Qh]
Bryan_Paris_@bparispoker: bets $350
DeepStack: calls $350
*** RIVER **** [9h]
Bryan_Paris_@bparispoker: checks
DeepStack: checks
*** SHOW DOWN ***
Bryan_Paris_@bparispoker: shows [Qs 8c] (a pair of Queens)
DeepStack: shows [8d Qd] (a pair of Queens)
Bryan_Paris_@bparispoker collected $500 from pot
DeepStack collected $500 from pot
*** SUMMARY ***
Total pot $1000 | Rake $0
Board [3h 6h 4d Qh 9h]
Seat 1: DeepStack (button) (small blind) showed [8d Qd] and won ($500) with a pair of Queens
Seat 2: Bryan_Paris_@bparispoker (big blind) showed [Qs 8c] and won ($500) with a pair of Queens

PokerStars Hand #13000400017: Tournament #5, May4_2017-at-15_32_53 Hold'em No Limit ($75/$150 USD) - 2017/05/04 17:33:09 ET
Table 'ACPC Match' 2-max Seat #2 is the button
Seat 1: DeepStack ($20050 in chips)
Seat 2: Bryan_Paris_@bparispoker ($19950 in chips)
Bryan_Paris_@bparispoker: posts small blind $75
DeepStack: posts big blind $150
*** HOLE CARDS ***
Dealt to DeepStack [Kh 9h]
Dealt to Bryan_Paris_@bparispoker [3c Ks]
Bryan_Paris_@bparispoker: raises $300 to $450
DeepStack: raises $900 to $1350
Bryan_Paris_@bparispoker: folds
Uncalled bet ($900) returned to DeepStack
DeepStack collected $900 from the pot
*** SUMMARY ***
Total pot $900 | Rake $0
Seat 1: DeepStack (big blind) collected ($900)
Seat 2: Bryan_Paris_@bparispoker (button) (small blind) folded before the Flop

PokerStars Hand #13000400018: Tournament #5, May4_2017-at-15_32_53 Hold'em No Limit ($75/$150 USD) - 2017/05/04 17:33:10 ET
Table 'ACPC Match' 2-max Seat #1 is the button
Seat 1: DeepStack ($20500 in chips)
Seat 2: Bryan_Paris_@bparispoker ($19500 in chips)
DeepStack: posts small blind $75
Bryan_Paris_@bparispoker: posts big blind $150
*** HOLE CARDS ***
Dealt to DeepStack [Qd Qs]
Dealt to Bryan_Paris_@bparispoker [Td 7h]
DeepStack: raises $300 to $450
Bryan_Paris_@bparispoker: folds
Uncalled bet ($300) returned to DeepStack
DeepStack collected $300 from the pot
*** SUMMARY ***
Total pot $300 | Rake $0
Seat 1: DeepStack (button) (small blind) collected ($300)
Seat 2: Bryan_Paris_@bparispoker (big blind) folded before the Flop

PokerStars Hand #13000400019: Tournament #5, May4_2017-at-15_32_53 Hold'em No Limit ($75/$150 USD) - 2017/05/04 17:33:11 ET
Table 'ACPC Match' 2-max Seat #2 is the button
Seat 1: DeepStack ($20650 in chips)
Seat 2: Bryan_Paris_@bparispoker ($19350 in chips)
Bryan_Paris_@bparispoker: posts small blind $75
DeepStack: posts big blind $150
*** HOLE CARDS ***
Dealt to DeepStack [Kc 7c]
Dealt to Bryan_Paris_@bparispoker [3c 7d]
Bryan_Paris_@bparispoker: folds
Uncalled bet ($75) returned to DeepStack
DeepStack collected $150 from the pot
*** SUMMARY ***
Total pot $150 | Rake $0
Seat 1: DeepStack (big blind) collected ($150)
Seat 2: Bryan_Paris_@bparispoker (button) (small blind) folded before the Flop

PokerStars Hand #13000400020: Tournament #5, May4_2017-at-15_32_53 Hold'em No Limit ($75/$150 USD) - 2017/05/04 17:33:12 ET
Table 'ACPC Match' 2-max Seat #1 is the button
Seat 1: DeepStack ($20725 in chips)
Seat 2: Bryan_Paris_@bparispoker ($19275 in chips)
DeepStack: posts small blind $75
Bryan_Paris_@bparispoker: posts big blind $150
*** HOLE CARDS ***
Dealt to DeepStack [5s 8c]
Dealt to Bryan_Paris_@bparispoker [7d Jh]
DeepStack: raises $300 to $450
Bryan_Paris_@bparispoker: folds
Uncalled bet ($300) returned to DeepStack
DeepStack collected $300 from the pot
*** SUMMARY ***
Total pot $300 | Rake $0
Seat 1: DeepStack (button) (small blind) collected ($300)
Seat 2: Bryan_Paris_@bparispoker (big blind) folded before the Flop

PokerStars Hand #13000400021: Tournament #5, May4_2017-at-15_32_53 Hold'em No Limit ($100/$200 USD) - 2017/05/04 17:33:13 ET
Table 'ACPC Match' 2-max Seat #2 is the button
Seat 1: DeepStack ($20875 in chips)
Seat 2: Bryan_Paris_@bparispoker ($19125 in chips)
Bryan_Paris_@bparispoker: posts small blind $100
DeepStack: posts big blind $200
*** HOLE CARDS ***
Dealt to DeepStack [Ah 2d]
Dealt to Bryan_Paris_@bparispoker [3c 7h]
Bryan_Paris_@bparispoker: folds
Uncalled bet ($100) returned to DeepStack
DeepStack collected $200 from the pot
*** SUMMARY ***
Total pot $200 | Rake $0
Seat 1: DeepStack (big blind) collected ($200)
Seat 2: Bryan_Paris_@bparispoker (button) (small blind) folded before the Flop

PokerStars Hand #13000400022: Tournament #5, May4_2017-at-15_32_53 Hold'em No Limit ($100/$200 USD) - 2017/05/04 17:33:14 ET
Table 'ACPC Match' 2-max Seat #1 is the button
Seat 1: DeepStack ($20975 in chips)
Seat 2: Bryan_Paris_@bparispoker ($19025 in chips)
DeepStack: posts small blind $100
Bryan_Paris_@bparispoker: posts big blind $200
*** HOLE CARDS ***
Dealt to DeepStack [3h 2c]
Dealt to Bryan_Paris_@bparispoker [3d 4h]
DeepStack: folds
Uncalled bet ($100) returned to Bryan_Paris_@bparispoker
Bryan_Paris_@bparispoker collected $200 from the pot
*** SUMMARY ***
Total pot $200 | Rake $0
Seat 1: DeepStack (button) (small blind) folded before the Flop
Seat 2: Bryan_Paris_@bparispoker (big blind) collected ($200)

PokerStars Hand #13000400023: Tournament #5, May4_2017-at-15_32_53 Hold'em No Limit ($100/$200 USD) - 2017/05/04 17:33:15 ET
Table 'ACPC Match' 2-max Seat #2 is the button
Seat 1: DeepStack ($20875 in chips)
Seat 2: Bryan_Paris_@bparispoker ($19125 in chips)
Bryan_Paris_@bparispoker: posts small blind $100
DeepStack: posts big blind $200
*** HOLE CARDS ***
Dealt to DeepStack [Td Qc]
Dealt to Bryan_Paris_@bparispoker [7c 9c]
Bryan_Paris_@bparispoker: raises $400 to $600
DeepStack: calls $400
*** FLOP **** [2h 7h Jc]
DeepStack: checks
Bryan_Paris_@bparispoker: raises $775 to $775
DeepStack: folds
Uncalled bet ($775) returned to Bryan_Paris_@bparispoker
Bryan_Paris_@bparispoker collected $1200 from the pot
*** SUMMARY ***
Total pot $1200 | Rake $0
Board [2h 7h Jc]
Seat 1: DeepStack (big blind) folded on the Flop
Seat 2: Bryan_Paris_@bparispoker (button) (small blind) collected ($1200)

PokerStars Hand #13000400024: Tournament #5, May4_2017-at-15_32_53 Hold'em No Limit ($100/$200 USD) - 2017/05/04 17:33:16 ET
Table 'ACPC Match' 2-max Seat #1 is the button
Seat 1: DeepStack ($20275 in chips)
Seat 2: Bryan_Paris_@bparispoker ($19725 in chips)
DeepStack: posts small blind $100
Bryan_Paris_@bparispoker: posts big blind $200
*** HOLE CARDS ***
Dealt to DeepStack [2d Qs]
Dealt to Bryan_Paris_@bparispoker [6c 5d]
DeepStack: calls $100
Bryan_Paris_@bparispoker: checks
*** FLOP **** [3c As 7c]
Bryan_Paris_@bparispoker: checks
DeepStack: checks
*** TURN **** [9c]
Bryan_Paris_@bparispoker: bets $400
DeepStack: folds
Uncalled bet ($400) returned to Bryan_Paris_@bparispoker
Bryan_Paris_@bparispoker collected $400 from the pot
*** SUMMARY ***
Total pot $400 | Rake $0
Board [3c As 7c 9c]
Seat 1: DeepStack (button) (small blind) folded on the Turn
Seat 2: Bryan_Paris_@bparispoker (big blind) collected ($400)

PokerStars Hand #13000400025: Tournament #5, May4_2017-at-15_32_53 Hold'em No Limit ($100/$200 USD) - 2017/05/04 17:33:17 ET
Table 'ACPC Match' 2-max Seat #2 is the button
Seat 1: DeepStack ($20075 in chips)
Seat 2: Bryan_Paris_@bparispoker ($19925 in chips)
Bryan_Paris_@bparispoker: posts small blind $100
DeepStack: posts big blind $200
*** HOLE CARDS ***
Dealt to DeepStack [3d Kc]
Dealt to Bryan_Paris_@bparispoker [Jh 2h]
Bryan_Paris_@bparispoker: raises $400 to $600
DeepStack: folds
Uncalled bet ($400) returned to Bryan_Paris_@bparispoker
Bryan_Paris_@bparispoker collected $400 from the pot
*** SUMMARY ***
Total pot $400 | Rake $0
Seat 1: DeepStack (big blind) folded before the Flop
Seat 2: Bryan_Paris_@bparispoker (button) (small blind) collected ($400)

PokerStars Hand #13000400026: Tournament #5, May4_2017-at-15_32_53 Hold'em No Limit ($100/$200 USD) - 2017/05/04 17:33:18 ET
Table 'ACPC Match' 2-max Seat #1 is the button
Seat 1: DeepStack ($19875 in chips)
Seat 2: Bryan_Paris_@bparispoker ($20125 in chips)
DeepStack: posts small blind $100
Bryan_Paris_@bparispoker: posts big blind $200
*** HOLE CARDS ***
Dealt to DeepStack [3s Tc]
Dealt to Bryan_Paris_@bparispoker [Js Td]
DeepStack: calls $100
Bryan_Paris_@bparispoker: checks
*** FLOP **** [Qd 5s 8s]
Bryan_Paris_@bparispoker: checks
DeepStack: raises $200 to $200
Bryan_Paris_@bparispoker: raises $550 to $750
DeepStack: folds
Uncalled bet ($550) returned to Bryan_Paris_@bparispoker
Bryan_Paris_@bparispoker collected $800 from the pot
*** SUMMARY ***
Total pot $800 | Rake $0
Board [Qd 5s 8s]
Seat 1: DeepStack (button) (small blind) folded on the Flop
Seat 2: Bryan_Paris_@bparispoker (big blind) collected ($800)

PokerStars Hand #13000400027: Tournament #5, May4_2017-at-15_32_53 Hold'em No Limit ($100/$200 USD) - 2017/05/04 17:33:19 ET
Table 'ACPC Match' 2-max Seat #2 is the button
Seat 1: DeepStack ($19475 in chips)
Seat 2: Bryan_Paris_@bparispoker ($20525 in chips)
Bryan_Paris_@bparispoker: posts small blind $100
DeepStack: posts big blind $200
*** HOLE CARDS ***
Dealt to DeepStack [Qc As]
Dealt to Bryan_Paris_@bparispoker [8h 3c]
Bryan_Paris_@bparispoker: folds
Uncalled bet ($100) returned to DeepStack
DeepStack collected $200 from the pot
*** SUMMARY ***
Total pot $200 | Rake $0
Seat 1: DeepStack (big blind) collected ($200)
Seat 2: Bryan_Paris_@bparispoker (button) (small blind) folded before the Flop

PokerStars Hand #13000400028: Tournament #5, May4_2017-at-15_32_53 Hold'em No Limit ($100/$200 USD) - 2017/05/04 17:33:20 ET
Table 'ACPC Match' 2-max Seat #1 is the button
Seat 1: DeepStack ($19575 in chips)
Seat 2: Bryan_Paris_@bparispoker ($20425 in chips)
DeepStack: posts small blind $100
Bryan_Paris_@bparispoker: posts big blind $200
*** HOLE CARDS ***
Dealt to DeepStack [Ac 5d]
Dealt to Bryan_Paris_@bparispoker [7h 6c]
DeepStack: calls $100
Bryan_Paris_@bparispoker: checks
*** FLOP **** [Jd Qs 6d]
Bryan_Paris_@bparispoker: checks
DeepStack: checks
*** TURN **** [Th]
Bryan_Paris_@bparispoker: checks
DeepStack: raises $400 to $400
Bryan_Paris_@bparispoker: folds
Uncalled bet ($400) returned to DeepStack
DeepStack collected $400 from the pot
*** SUMMARY ***
Total pot $400 | Rake $0
Board [Jd Qs 6d Th]
Seat 1: DeepStack (button) (small blind) collected ($400)
Seat 2: Bryan_Paris_@bparispoker (big blind) folded on the Turn

PokerStars Hand #13000400029: Tournament #5, May4_2017-at-15_32_53 Hold'em No Limit ($100/$200 USD) - 2017/05/04 17:33:21 ET
Table 'ACPC Match' 2-max Seat #2 is the button
Seat 1: DeepStack ($19775 in chips)
Seat 2: Bryan_Paris_@bparispoker ($20225 in chips)
Bryan_Paris_@bparispoker: posts small blind $100
DeepStack: posts big blind $200
*** HOLE CARDS ***
Dealt to DeepStack [6s 4c]
Dealt to Bryan_Paris_@bparispoker [3d Jd]
Bryan_Paris_@bparispoker: raises $400 to $600
DeepStack: folds
Uncalled bet ($400) returned to Bryan_Paris_@bparispoker
Bryan_Paris_@bparispoker collected $400 from the pot
*** SUMMARY ***
Total pot $400 | Rake $0
Seat 1: DeepStack (big blind) folded before the Flop
Seat 2: Bryan_Paris_@bparispoker (button) (small blind) collected ($400)

PokerStars Hand #13000400030: Tournament #5, May4_2017-at-15_32_53 Hold'em No Limit ($100/$200 USD) - 2017/05/04 17:33:22 ET
Table 'ACPC Match' 2-max Seat #1 is the button
Seat 1: DeepStack ($19575 in chips)
Seat 2: Bryan_Paris_@bparispoker ($20425 in chips)
DeepStack: posts small blind $100
Bryan_Paris_@bparispoker: posts big blind $200
*** HOLE CARDS ***
Dealt to DeepStack [6h Qd]
Dealt to Bryan_Paris_@bparispoker [6s 6d]
DeepStack: raises $200 to $400
Bryan_Paris_@bparispoker: calls $200
*** FLOP **** [Js Ad Td]
Bryan_Paris_@bparispoker: checks
DeepStack: raises $800 to $800
Bryan_Paris_@bparispoker: folds
Uncalled bet ($800) returned to DeepStack
DeepStack collected $800 from the pot
*** SUMMARY ***
Total pot $800 | Rake $0
Board [Js Ad Td]
Seat 1: DeepStack (button) (small blind) collected ($800)
Seat 2: Bryan_Paris_@bparispoker (big blind) folded on the Flop

PokerStars Hand #13000400031: Tournament #5, May4_2017-at-15_32_53 Hold'em No Limit ($150/$300 USD) - 2017/05/04 17:33:23 ET
Table 'ACPC Match' 2-max Seat #2 is the button
Seat 1: DeepStack ($19975 in chips)
Seat 2: Bryan_Paris_@bparispoker ($20025 in chips)
Bryan_Paris_@bparispoker: posts small blind $150
DeepStack: posts big blind $300
*** HOLE CARDS ***
Dealt to DeepStack [9h Jd]
Dealt to Bryan_Paris_@bparispoker [Ts 7d]
Bryan_Paris_@bparispoker: raises $500 to $800
DeepStack: calls $500
*** FLOP **** [Qs Qc 2h]
DeepStack: checks
Bryan_Paris_@bparispoker: checks
*** TURN **** [5s]
DeepStack: checks
Bryan_Paris_@bparispoker: checks
*** RIVER **** [5h]
DeepStack: checks
Bryan_Paris_@bparispoker: checks
*** SHOW DOWN ***
DeepStack: shows [9h Jd] (two pair, Queens and Fives)
Bryan_Paris_@bparispoker: shows [Ts 7d] (two pair, Queens and Fives)
DeepStack collected $1600 from pot
*** SUMMARY ***
Total pot $1600 | Rake $0
Board [Qs Qc 2h 5s 5h]
Seat 1: DeepStack (big blind) showed [9h Jd] and won ($1600) with two pair, Queens and Fives
Seat 2: Bryan_Paris_@bparispoker (button) (small blind) showed [Ts 7d] and lost with two pair, Queens and Fives

PokerStars Hand #13000400032: Tournament #5, May4_2017-at-15_32_53 Hold'em No Limit ($150/$300 USD) - 2017/05/04 17:33:24 ET
Table 'ACPC Match' 2-max Seat #1 is the button
Seat 1: DeepStack ($20775 in chips)
Seat 2: Bryan_Paris_@bparispoker ($19225 in chips)
DeepStack: posts small blind $150
Bryan_Paris_@bparispoker: posts big blind $300
*** HOLE CARDS ***
Dealt to DeepStack [9h 8c]
Dealt to Bryan_Paris_@bparispoker [Qs 9s]
DeepStack: raises $300 to $600
Bryan_Paris_@bparispoker: calls $300
*** FLOP **** [Kh Kc Ks]
Bryan_Paris_@bparispoker: checks
DeepStack: raises $1200 to $1200
Bryan_Paris_@bparispoker: folds
Uncalled bet ($1200) returned to DeepStack
DeepStack collected $1200 from the pot
*** SUMMARY ***
Total pot $1200 | Rake $0
Board [Kh Kc Ks]
Seat 1: DeepStack (button) (small blind) collected ($1200)
Seat 2: Bryan_Paris_@bparispoker (big blind) folded on the Flop

PokerStars Hand #13000400033: Tournament #5, May4_2017-at-15_32_53 Hold'em No Limit ($150/$300 USD) - 2017/05/04 17:33:25 ET
Table 'ACPC Match' 2-max Seat #2 is the button
Seat 1: DeepStack ($21375 in chips)
Seat 2: Bryan_Paris_@bparispoker ($18625 in chips)
Bryan_Paris_@bparispoker: posts small blind $150
DeepStack: posts big blind $300
*** HOLE CARDS ***
Dealt to DeepStack [9s 5h]
Dealt to Bryan_Paris_@bparispoker [Jh 7c]
Bryan_Paris_@bparispoker: raises $500 to $800
DeepStack: folds
Uncalled bet ($500) returned to Bryan_Paris_@bparispoker
Bryan_Paris_@bparispoker collected $600 from the pot
*** SUMMARY ***
Total pot $600 | Rake $0
Seat 1: DeepStack (big blind) folded before the Flop
Seat 2: Bryan_Paris_@bparispoker (button) (small blind) collected ($600)

PokerStars Hand #13000400034: Tournament #5, May4_2017-at-15_32_53 Hold'em No Limit ($150/$300 USD) - 2017/05/04 17:33:26 ET
Table 'ACPC Match' 2-max Seat #1 is the button
Seat 1: DeepStack ($21075 in chips)
Seat 2: Bryan_Paris_@bparispoker ($18925 in chips)
DeepStack: posts small blind $150
Bryan_Paris_@bparispoker: posts big blind $300
*** HOLE CARDS ***
Dealt to DeepStack [8s 4c]
Dealt to Bryan_Paris_@bparispoker [6c 7s]
DeepStack: calls $150
Bryan_Paris_@bparispoker: checks
*** FLOP **** [Qs 4h 4d]
Bryan_Paris_@bparispoker: checks
DeepStack: raises $300 to $300
Bryan_Paris_@bparispoker: folds
Uncalled bet ($300) returned to DeepStack
DeepStack collected $600 from the pot
*** SUMMARY ***
Total pot $600 | Rake $0
Board [Qs 4h 4d]
Seat 1: DeepStack (button) (small blind) collected ($600)
Seat 2: Bryan_Paris_@bparispoker (big blind) folded on the Flop

PokerStars Hand #13000400035: Tournament #5, May4_2017-at-15_32_53 Hold'em No Limit ($150/$300 USD) - 2017/05/04 17:33:27 ET
Table 'ACPC Match' 2-max Seat #2 is the button
Seat 1: DeepStack ($21375 in chips)
Seat 2: Bryan_Paris_@bparispoker ($18625 in chips)
Bryan_Paris_@bparispoker: posts small blind $150
DeepStack: posts big blind $300
*** HOLE CARDS ***
Dealt to DeepStack [9s 5d]
Dealt to Bryan_Paris_@bparispoker [3s Jc]
Bryan_Paris_@bparispoker: folds
Uncalled bet ($150) returned to DeepStack
DeepStack collected $300 from the pot
*** SUMMARY ***
Total pot $300 | Rake $0
Seat 1: DeepStack (big blind) collected ($300)
Seat 2: Bryan_Paris_@bparispoker (button) (small blind) folded before the Flop

PokerStars Hand #13000400036: Tournament #5, May4_2017-at-15_32_53 Hold'em No Limit ($150/$300 USD) - 2017/05/04 17:33:28 ET
Table 'ACPC Match' 2-max Seat #1 is the button
Seat 1: DeepStack ($21525 in chips)
Seat 2: Bryan_Paris_@bparispoker ($18475 in chips)
DeepStack: posts small blind $150
Bryan_Paris_@bparispoker: posts big blind $300
*** HOLE CARDS ***
Dealt to DeepStack [6c 2h]
Dealt to Bryan_Paris_@bparispoker [Ks 8s]
DeepStack: folds
Uncalled bet ($150) returned to Bryan_Paris_@bparispoker
Bryan_Paris_@bparispoker collected $300 from the pot
*** SUMMARY ***
Total pot $300 | Rake $0
Seat 1: DeepStack (button) (small blind) folded before the Flop
Seat 2: Bryan_Paris_@bparispoker (big blind) collected ($300)

PokerStars Hand #13000400037: Tournament #5, May4_2017-at-15_32_53 Hold'em No Limit ($150/$300 USD) - 2017/05/04 17:33:29 ET
Table 'ACPC Match' 2-max Seat #2 is the button
Seat 1: DeepStack ($21375 in chips)
Seat 2: Bryan_Paris_@bparispoker ($18625 in chips)
Bryan_Paris_@bparispoker: posts small blind $150
DeepStack: posts big blind $300
*** HOLE CARDS ***
Dealt to DeepStack [2h 8d]
Dealt to Bryan_Paris_@bparispoker [5c Jc]
Bryan_Paris_@bparispoker: raises $500 to $800
DeepStack: folds
Uncalled bet ($500) returned to Bryan_Paris_@bparispoker
Bryan_Paris_@bparispoker collected $600 from the pot
*** SUMMARY ***
Total pot $600 | Rake $0
Seat 1: DeepStack (big blind) folded before the Flop
Seat 2: Bryan_Paris_@bparispoker (button) (small blind) collected ($600)

PokerStars Hand #13000400038: Tournament #5, May4_2017-at-15_32_53 Hold'em No Limit ($150/$300 USD) - 2017/05/04 17:33:30 ET
Table 'ACPC Match' 2-max Seat #1 is the button
Seat 1: DeepStack ($21075 in chips)
Seat 2: Bryan_Paris_@bparispoker ($18925 in chips)
DeepStack: posts small blind $150
Bryan_Paris_@bparispoker: posts big blind $300
*** HOLE CARDS ***
Dealt to DeepStack [2h 2d]
Dealt to Bryan_Paris_@bparispoker [3d 3h]
DeepStack: raises $300 to $600
Bryan_Paris_@bparispoker: calls $300
*** FLOP **** [Ad 8d 6d]
Bryan_Paris_@bparispoker: checks
DeepStack: raises $600 to $600
Bryan_Paris_@bparispoker: calls $600
*** TURN **** [Td]
Bryan_Paris_@bparispoker: checks
DeepStack: checks
*** RIVER **** [7c]
Bryan_Paris_@bparispoker: checks
DeepStack: checks
*** SHOW DOWN ***
Bryan_Paris_@bparispoker: shows [3d 3h] (flush, Ace high)
DeepStack: shows [2h 2d] (flush, Ace high)
Bryan_Paris_@bparispoker collected $2400 from pot
*** SUMMARY ***
Total pot $2400 | Rake $0
Board [Ad 8d 6d Td 7c]
Seat 1: DeepStack (button) (small blind) showed [2h 2d] and lost with flush, Ace high
Seat 2: Bryan_Paris_@bparispoker (big blind) showed [3d 3h] and won ($2400) with flush, Ace high

PokerStars Hand #13000400039: Tournament #5, May4_2017-at-15_32_53 Hold'em No Limit ($150/$300 USD) - 2017/05/04 17:33:31 ET
Table 'ACPC Match' 2-max Seat #2 is the button
Seat 1: DeepStack ($19875 in chips)
Seat 2: Bryan_Paris_@bparispoker ($20125 in chips)
Bryan_Paris_@bparispoker: posts small blind $150
DeepStack: posts big blind $300
*** HOLE CARDS ***
Dealt to DeepStack [Kd 7h]
Dealt to Bryan_Paris_@bparispoker [8s Kh]
Bryan_Paris_@bparispoker: raises $500 to $800
DeepStack: calls $500
*** FLOP **** [8c Jh 9s]
DeepStack: checks
Bryan_Paris_@bparispoker: checks
*** TURN **** [8h]
DeepStack: checks
Bryan_Paris_@bparispoker: raises $1025 to $1025
DeepStack: folds
Uncalled bet ($1025) returned to Bryan_Paris_@bparispoker
Bryan_Paris_@bparispoker collected $1600 from the pot
*** SUMMARY ***
Total pot $1600 | Rake $0
Board [8c Jh 9s 8h]
Seat 1: DeepStack (big blind) folded on the Turn
Seat 2: Bryan_Paris_@bparispoker (button) (small blind) collected ($1600)

PokerStars Hand #13000400040: Tournament #5, May4_2017-at-15_32_53 Hold'em No Limit ($150/$300 USD) - 2017/05/04 17:33:32 ET
Table 'ACPC Match' 2-max Seat #1 is the button
Seat 1: DeepStack ($19075 in chips)
Seat 2: Bryan_Paris_@bparispoker ($20925 in chips)
DeepStack: posts small blind $150
Bryan_Paris_@bparispoker: posts big blind $300
*** HOLE CARDS ***
Dealt to DeepStack [Ks 2h]
Dealt to Bryan_Paris_@bparispoker [2s 4c]
DeepStack: calls $150
Bryan_Paris_@bparispoker: checks
*** FLOP **** [5d 3h 6c]
Bryan_Paris_@bparispoker: checks
DeepStack: raises $600 to $600
Bryan_Paris_@bparispoker: raises $1425 to $2025
DeepStack: folds
Uncalled bet ($1425) returned to Bryan_Paris_@bparispoker
Bryan_Paris_@bparispoker collected $1800 from the pot
*** SUMMARY ***
Total pot $1800 | Rake $0
Board [5d 3h 6c]
Seat 1: DeepStack (button) (small blind) folded on the Flop
Seat 2: Bryan_Paris_@bparispoker (big blind) collected ($1800)

PokerStars Hand #13000400041: Tournament #5, May4_2017-at-15_32_53 Hold'em No Limit ($200/$400 USD) - 2017/05/04 17:33:33 ET
Table 'ACPC Match' 2-max Seat #2 is the button
Seat 1: DeepStack ($18175 in chips)
Seat 2: Bryan_Paris_@bparispoker ($21825 in chips)
Bryan_Paris_@bparispoker: posts small blind $200
DeepStack: posts big blind $400
*** HOLE CARDS ***
Dealt to DeepStack [7c 4d]
Dealt to Bryan_Paris_@bparispoker [Jh 5s]
Bryan_Paris_@bparispoker: raises $700 to $1100
DeepStack: folds
Uncalled bet ($700) returned to Bryan_Paris_@bparispoker
Bryan_Paris_@bparispoker collected $800 from the pot
*** SUMMARY ***
Total pot $800 | Rake $0
Seat 1: DeepStack (big blind) folded before the Flop
Seat 2: Bryan_Paris_@bparispoker (button) (small blind) collected ($800)

PokerStars Hand #13000400042: Tournament #5, May4_2017-at-15_32_53 Hold'em No Limit ($200/$400 USD) - 2017/05/04 17:33:34 ET
Table 'ACPC Match' 2-max Seat #1 is the button
Seat 1: DeepStack ($17775 in chips)
Seat 2: Bryan_Paris_@bparispoker ($22225 in chips)
DeepStack: posts small blind $200
Bryan_Paris_@bparispoker: posts big blind $400
*** HOLE CARDS ***
Dealt to DeepStack [6d Kh]
Dealt to Bryan_Paris_@bparispoker [Jc 9s]
DeepStack: calls $200
Bryan_Paris_@bparispoker: checks
*** FLOP **** [9d 7h Kc]
Bryan_Paris_@bparispoker: checks
DeepStack: checks
*** TURN **** [6h]
Bryan_Paris_@bparispoker: bets $800
DeepStack: calls $800
*** RIVER **** [5d]
Bryan_Paris_@bparispoker: checks
DeepStack: raises $1200 to $1200
Bryan_Paris_@bparispoker: folds
Uncalled bet ($1200) returned to DeepStack
DeepStack collected $2400 from the pot
*** SUMMARY ***
Total pot $2400 | Rake $0
Board [9d 7h Kc 6h 5d]
Seat 1: DeepStack (button) (small blind) collected ($2400)
Seat 2: Bryan_Paris_@bparispoker (big blind) folded on the River

PokerStars Hand #13000400043: Tournament #5, May4_2017-at-15_32_53 Hold'em No Limit ($200/$400 USD) - 2017/05/04 17:33:35 ET
Table 'ACPC Match' 2-max Seat #2 is the button
Seat 1: DeepStack ($18975 in chips)
Seat 2: Bryan_Paris_@bparispoker ($21025 in chips)
Bryan_Paris_@bparispoker: posts small blind $200
DeepStack: posts big blind $400
*** HOLE CARDS ***
Dealt to DeepStack [Jh 8c]
Dealt to Bryan_Paris_@bparispoker [3h Td]
Bryan_Paris_@bparispoker: folds
Uncalled bet ($200) returned to DeepStack
DeepStack collected $400 from the pot
*** SUMMARY ***
Total pot $400 | Rake $0
Seat 1: DeepStack (big blind) collected ($400)
Seat 2: Bryan_Paris_@bparispoker (button) (small blind) folded before the Flop

PokerStars Hand #13000400044: Tournament #5, May4_2017-at-15_32_53 Hold'em No Limit ($200/$400 USD) - 2017/05/04 17:33:36 ET
Table 'ACPC Match' 2-max Seat #1 is the button
Seat 1: DeepStack ($19175 in chips)
Seat 2: Bryan_Paris_@bparispoker ($20825 in chips)
DeepStack: posts small blind $200
Bryan_Paris_@bparispoker: posts big blind $400
*** HOLE CARDS ***
Dealt to DeepStack [Td Js]
Dealt to Bryan_Paris_@bparispoker [4d Kh]
DeepStack: calls $200
Bryan_Paris_@bparispoker: checks
*** FLOP **** [2c Jc 3s]
Bryan_Paris_@bparispoker: checks
DeepStack: checks
*** TURN **** [Ah]
Bryan_Paris_@bparispoker: checks
DeepStack: raises $800 to $800
Bryan_Paris_@bparispoker: calls $800
*** RIVER **** [Th]
Bryan_Paris_@bparispoker: checks
DeepStack: raises $2400 to $2400
Bryan_Paris_@bparispoker: folds
Uncalled bet ($2400) returned to DeepStack
DeepStack collected $2400 from the pot
*** SUMMARY ***
Total pot $2400 | Rake $0
Board [2c Jc 3s Ah Th]
Seat 1: DeepStack (button) (small blind) collected ($2400)
Seat 2: Bryan_Paris_@bparispoker (big blind) folded on the River

PokerStars Hand #13000400045: Tournament #5, May4_2017-at-15_32_53 Hold'em No Limit ($200/$400 USD) - 2017/05/04 17:33:37 ET
Table 'ACPC Match' 2-max Seat #2 is the button
Seat 1: DeepStack ($20375 in chips)
Seat 2: Bryan_Paris_@bparispoker ($19625 in chips)
Bryan_Paris_@bparispoker: posts small blind $200
DeepStack: posts big blind $400
*** HOLE CARDS ***
Dealt to DeepStack [7s Ad]
Dealt to Bryan_Paris_@bparispoker [Kd 8h]
Bryan_Paris_@bparispoker: raises $700 to $1100
DeepStack: raises $2200 to $3300
Bryan_Paris_@bparispoker: folds
Uncalled bet ($2200) returned to DeepStack
DeepStack collected $2200 from the pot
*** SUMMARY ***
Total pot $2200 | Rake $0
Seat 1: DeepStack (big blind) collected ($2200)
Seat 2: Bryan_Paris_@bparispoker (button) (small blind) folded before the Flop

PokerStars Hand #13000400046: Tournament #5, May4_2017-at-15_32_53 Hold'em No Limit ($200/$400 USD) - 2017/05/04 17:33:38 ET
Table 'ACPC Match' 2-max Seat #1 is the button
Seat 1: DeepStack ($21475 in chips)
Seat 2: Bryan_Paris_@bparispoker ($18525 in chips)
DeepStack: posts small blind $200
Bryan_Paris_@bparispoker: posts big blind $400
*** HOLE CARDS ***
Dealt to DeepStack [2h 3s]
Dealt to Bryan_Paris_@bparispoker [4h Jc]
DeepStack: folds
Uncalled bet ($200) returned to Bryan_Paris_@bparispoker
Bryan_Paris_@bparispoker collected $400 from the pot
*** SUMMARY ***
Total pot $400 | Rake $0
Seat 1: DeepStack (button) (small blind) folded before the Flop
Seat 2: Bryan_Paris_@bparispoker (big blind) collected ($400)

PokerStars Hand #13000400047: Tournament #5, May4_2017-at-15_32_53 Hold'em No Limit ($200/$400 USD) - 2017/05/04 17:33:39 ET
Table 'ACPC Match' 2-max Seat #2 is the button
Seat 1: DeepStack ($21275 in chips)
Seat 2: Bryan_Paris_@bparispoker ($18725 in chips)
Bryan_Paris_@bparispoker: posts small blind $200
DeepStack: posts big blind $400
*** HOLE CARDS ***
Dealt to DeepStack [9d Qd]
Dealt to Bryan_Paris_@bparispoker [As 3s]
Bryan_Paris_@bparispoker: raises $700 to $1100
DeepStack: raises $1100 to $2200
Bryan_Paris_@bparispoker: calls $1100
*** FLOP **** [6c 9c 6d]
DeepStack: checks
Bryan_Paris_@bparispoker: checks
*** TURN **** [4h]
DeepStack: checks
Bryan_Paris_@bparispoker: checks
*** RIVER **** [6h]
DeepStack: bets $4400
Bryan_Paris_@bparispoker: folds
Uncalled bet ($4400) returned to DeepStack
DeepStack collected $4400 from the pot
*** SUMMARY ***
Total pot $4400 | Rake $0
Board [6c 9c 6d 4h 6h]
Seat 1: DeepStack (big blind) collected ($4400)
Seat 2: Bryan_Paris_@bparispoker (button) (small blind) folded on the River

PokerStars Hand #13000400048: Tournament #5, May4_2017-at-15_32_53 Hold'em No Limit ($200/$400 USD) - 2017/05/04 17:33:40 ET
Table 'ACPC Match' 2-max Seat #1 is the button
Seat 1: DeepStack ($23475 in chips)
Seat 2: Bryan_Paris_@bparispoker ($16525 in chips)
DeepStack: posts small blind $200
Bryan_Paris_@bparispoker: posts big blind $400
*** HOLE CARDS ***
Dealt to DeepStack [Kh Jh]
Dealt to Bryan_Paris_@bparispoker [2c Ts]
DeepStack: raises $400 to $800
Bryan_Paris_@bparispoker: folds
Uncalled bet ($400) returned to DeepStack
DeepStack collected $800 from the pot
*** SUMMARY ***
Total pot $800 | Rake $0
Seat 1: DeepStack (button) (small blind) collected ($800)
Seat 2: Bryan_Paris_@bparispoker (big blind) folded before the Flop

PokerStars Hand #13000400049: Tournament #5, May4_2017-at-15_32_53 Hold'em No Limit ($200/$400 USD) - 2017/05/04 17:33:41 ET
Table 'ACPC Match' 2-max Seat #2 is the button
Seat 1: DeepStack ($23875 in chips)
Seat 2: Bryan_Paris_@bparispoker ($16125 in chips)
Bryan_Paris_@bparispoker: posts small blind $200
DeepStack: posts big blind $400
*** HOLE CARDS ***
Dealt to DeepStack [As 8h]
Dealt to Bryan_Paris_@bparispoker [6s 5c]
Bryan_Paris_@bparispoker: raises $525 to $925
DeepStack: raises $1850 to $2775
Bryan_Paris_@bparispoker: folds
Uncalled bet ($1850) returned to DeepStack
DeepStack collected $1850 from the pot
*** SUMMARY ***
Total pot $1850 | Rake $0
Seat 1: DeepStack (big blind) collected ($1850)
Seat 2: Bryan_Paris_@bparispoker (button) (small blind) folded before the Flop

PokerStars Hand #13000400050: Tournament #5, May4_2017-at-15_32_53 Hold'em No Limit ($200/$400 USD) - 2017/05/04 17:33:42 ET
Table 'ACPC Match' 2-max Seat #1 is the button
Seat 1: DeepStack ($24800 in chips)
Seat 2: Bryan_Paris_@bparispoker ($15200 in chips)
DeepStack: posts small blind $200
Bryan_Paris_@bparispoker: posts big blind $400
*** HOLE CARDS ***
Dealt to DeepStack [Ac 9d]
Dealt to Bryan_Paris_@bparispoker [Ad Tc]
DeepStack: raises $400 to $800
Bryan_Paris_@bparispoker: raises $1800 to $2600
DeepStack: calls $1800
*** FLOP **** [9s 6s Ts]
Bryan_Paris_@bparispoker: bets $12600 and is all-in
DeepStack: folds
Uncalled bet ($12600) returned to Bryan_Paris_@bparispoker
Bryan_Paris_@bparispoker collected $5200 from the pot
*** SUMMARY ***
Total pot $5200 | Rake $0
Board [9s 6s Ts]
Seat 1: DeepStack (button) (small blind) folded on the Flop
Seat 2: Bryan_Paris_@bparispoker (big blind) collected ($5200)

PokerStars Hand #13000400051: Tournament #5, May4_2017-at-15_32_53 Hold'em No Limit ($300/$600 USD) - 2017/05/04 17:33:43 ET
Table 'ACPC Match' 2-max Seat #2 is the button
Seat 1: DeepStack ($22200 in chips)
Seat 2: Bryan_Paris_@bparispoker ($17800 in chips)
Bryan_Paris_@bparispoker: posts small blind $300
DeepStack: posts big blind $600
*** HOLE CARDS ***
Dealt to DeepStack [Ac Jh]
Dealt to Bryan_Paris_@bparispoker [3s 2d]
Bryan_Paris_@bparispoker: folds
Uncalled bet ($300) returned to DeepStack
DeepStack collected $600 from the pot
*** SUMMARY ***
Total pot $600 | Rake $0
Seat 1: DeepStack (big blind) collected ($600)
Seat 2: Bryan_Paris_@bparispoker (button) (small blind) folded before the Flop

PokerStars Hand #13000400052: Tournament #5, May4_2017-at-15_32_53 Hold'em No Limit ($300/$600 USD) - 2017/05/04 17:33:44 ET
Table 'ACPC Match' 2-max Seat #1 is the button
Seat 1: DeepStack ($22500 in chips)
Seat 2: Bryan_Paris_@bparispoker ($17500 in chips)
DeepStack: posts small blind $300
Bryan_Paris_@bparispoker: posts big blind $600
*** HOLE CARDS ***
Dealt to DeepStack [Ks As]
Dealt to Bryan_Paris_@bparispoker [9c 3h]
DeepStack: raises $600 to $1200
Bryan_Paris_@bparispoker: folds
Uncalled bet ($600) returned to DeepStack
DeepStack collected $1200 from the pot
*** SUMMARY ***
Total pot $1200 | Rake $0
Seat 1: DeepStack (button) (small blind) collected ($1200)
Seat 2: Bryan_Paris_@bparispoker (big blind) folded before the Flop

PokerStars Hand #13000400053: Tournament #5, May4_2017-at-15_32_53 Hold'em No Limit ($300/$600 USD) - 2017/05/04 17:33:45 ET
Table 'ACPC Match' 2-max Seat #2 is the button
Seat 1: DeepStack ($23100 in chips)
Seat 2: Bryan_Paris_@bparispoker ($16900 in chips)
Bryan_Paris_@bparispoker: posts small blind $300
DeepStack: posts big blind $600
*** HOLE CARDS ***
Dealt to DeepStack [2h 3c]
Dealt to Bryan_Paris_@bparispoker [Qh 5h]
Bryan_Paris_@bparispoker: raises $700 to $1300
DeepStack: folds
Uncalled bet ($700) returned to Bryan_Paris_@bparispoker
Bryan_Paris_@bparispoker collected $1200 from the pot
*** SUMMARY ***
Total pot $1200 | Rake $0
Seat 1: DeepStack (big blind) folded before the Flop
Seat 2: Bryan_Paris_@bparispoker (button) (small blind) collected ($1200)

PokerStars Hand #13000400054: Tournament #5, May4_2017-at-15_32_53 Hold'em No Limit ($300/$600 USD) - 2017/05/04 17:33:46 ET
Table 'ACPC Match' 2-max Seat #1 is the button
Seat 1: DeepStack ($22500 in chips)
Seat 2: Bryan_Paris_@bparispoker ($17500 in chips)
DeepStack: posts small blind $300
Bryan_Paris_@bparispoker: posts big blind $600
*** HOLE CARDS ***
Dealt to DeepStack [Jd Qd]
Dealt to Bryan_Paris_@bparispoker [Kh Jh]
DeepStack: calls $300
Bryan_Paris_@bparispoker: raises $1350 to $1950
DeepStack: calls $1350
*** FLOP **** [Ac Js 7h]
Bryan_Paris_@bparispoker: checks
DeepStack: checks
*** TURN **** [5c]
Bryan_Paris_@bparispoker: bets $1800
DeepStack: calls $1800
*** RIVER **** [9c]
Bryan_Paris_@bparispoker: checks
DeepStack: checks
*** SHOW DOWN ***
Bryan_Paris_@bparispoker: shows [Kh Jh] (a pair of Jacks)
DeepStack: shows [Jd Qd] (a pair of Jacks)
Bryan_Paris_@bparispoker collected $7500 from pot
*** SUMMARY ***
Total pot $7500 | Rake $0
Board [Ac Js 7h 5c 9c]
Seat 1: DeepStack (button) (small blind) showed [Jd Qd] and lost with a pair of Jacks
Seat 2: Bryan_Paris_@bparispoker (big blind) showed [Kh Jh] and won ($7500) with a pair of Jacks

PokerStars Hand #13000400055: Tournament #5, May4_2017-at-15_32_53 Hold'em No Limit ($300/$600 USD) - 2017/05/04 17:33:47 ET
Table 'ACPC Match' 2-max Seat #2 is the button
Seat 1: DeepStack ($18750 in chips)
Seat 2: Bryan_Paris_@bparispoker ($21250 in chips)
Bryan_Paris_@bparispoker: posts small blind $300
DeepStack: posts big blind $600
*** HOLE CARDS ***
Dealt to DeepStack [5d Qs]
Dealt to Bryan_Paris_@bparispoker [3h 3d]
Bryan_Paris_@bparispoker: calls $300
DeepStack: checks
*** FLOP **** [6d Tc 9d]
DeepStack: checks
Bryan_Paris_@bparispoker: checks
*** TURN **** [6s]
DeepStack: checks
Bryan_Paris_@bparispoker: raises $750 to $750
DeepStack: folds
Uncalled bet ($750) returned to Bryan_Paris_@bparispoker
Bryan_Paris_@bparispoker collected $1200 from the pot
*** SUMMARY ***
Total pot $1200 | Rake $0
Board [6d Tc 9d 6s]
Seat 1: DeepStack (big blind) folded on the Turn
Seat 2: Bryan_Paris_@bparispoker (button) (small blind) collected ($1200)

PokerStars Hand #13000400056: Tournament #5, May4_2017-at-15_32_53 Hold'em No Limit ($300/$600 USD) - 2017/05/04 17:33:48 ET
Table 'ACPC Match' 2-max Seat #1 is the button
Seat 1: DeepStack ($18150 in chips)
Seat 2: Bryan_Paris_@bparispoker ($21850 in chips)
DeepStack: posts small blind $300
Bryan_Paris_@bparispoker: posts big blind $600
*** HOLE CARDS ***
Dealt to DeepStack [5h Ac]
Dealt to Bryan_Paris_@bparispoker [2h 2c]
DeepStack: calls $300
Bryan_Paris_@bparispoker: raises $21250 to $21850 and is all-in
DeepStack: folds
Uncalled bet ($21250) returned to Bryan_Paris_@bparispoker
Bryan_Paris_@bparispoker collected $1200 from the pot
*** SUMMARY ***
Total pot $1200 | Rake $0
Seat 1: DeepStack (button) (small blind) folded before the Flop
Seat 2: Bryan_Paris_@bparispoker (big blind) collected ($1200)

PokerStars Hand #13000400057: Tournament #5, May4_2017-at-15_32_53 Hold'em No Limit ($300/$600 USD) - 2017/05/04 17:33:49 ET
Table 'ACPC Match' 2-max Seat #2 is the button
Seat 1: DeepStack ($17550 in chips)
Seat 2: Bryan_Paris_@bparispoker ($22450 in chips)
Bryan_Paris_@bparispoker: posts small blind $300
DeepStack: posts big blind $600
*** HOLE CARDS ***
Dealt to DeepStack [Kd Qh]
Dealt to Bryan_Paris_@bparispoker [Ac Ah]
Bryan_Paris_@bparispoker: raises $700 to $1300
DeepStack: calls $700
*** FLOP **** [Js 2c Jd]
DeepStack: checks
Bryan_Paris_@bparispoker: checks
*** TURN **** [9h]
DeepStack: checks
Bryan_Paris_@bparispoker: raises $1300 to $1300
DeepStack: raises $2600 to $3900
Bryan_Paris_@bparispoker: calls $2600
*** RIVER **** [Qc]
DeepStack: bets $5200
Bryan_Paris_@bparispoker: calls $5200
*** SHOW DOWN ***
DeepStack: shows [Kd Qh] (two pair, Queens and Jacks)
Bryan_Paris_@bparispoker: shows [Ac Ah] (two pair, Aces and Jacks)
Bryan_Paris_@bparispoker collected $20800 from pot
*** SUMMARY ***
Total pot $20800 | Rake $0
Board [Js 2c Jd 9h Qc]
Seat 1: DeepStack (big blind) showed [Kd Qh] and lost with two pair, Queens and Jacks
Seat 2: Bryan_Paris_@bparispoker (button) (small blind) showed [Ac Ah] and won ($20800) with two pair, Aces and Jacks

PokerStars Hand #13000400058: Tournament #5, May4_2017-at-15_32_53 Hold'em No Limit ($300/$600 USD) - 2017/05/04 17:33:50 ET
Table 'ACPC Match' 2-max Seat #1 is the button
Seat 1: DeepStack ($7150 in chips)
Seat 2: Bryan_Paris_@bparispoker ($32850 in chips)
DeepStack: posts small blind $300
Bryan_Paris_@bparispoker: posts big blind $600
*** HOLE CARDS ***
Dealt to DeepStack [Ah 3h]
Dealt to Bryan_Paris_@bparispoker [4s 5s]
DeepStack: calls $300
Bryan_Paris_@bparispoker: checks
*** FLOP **** [4c Qc 9c]
Bryan_Paris_@bparispoker: checks
DeepStack: checks
*** TURN **** [Ac]
Bryan_Paris_@bparispoker: checks
DeepStack: raises $600 to $600
Bryan_Paris_@bparispoker: folds
Uncalled bet ($600) returned to DeepStack
DeepStack collected $1200 from the pot
*** SUMMARY ***
Total pot $1200 | Rake $0
Board [4c Qc 9c Ac]
Seat 1: DeepStack (button) (small blind) collected ($1200)
Seat 2: Bryan_Paris_@bparispoker (big blind) folded on the Turn

PokerStars Hand #13000400059: Tournament #5, May4_2017-at-15_32_53 Hold'em No Limit ($300/$600 USD) - 2017/05/04 17:33:51 ET
Table 'ACPC Match' 2-max Seat #2 is the button
Seat 1: DeepStack ($7750 in chips)
Seat 2: Bryan_Paris_@bparispoker ($32250 in chips)
Bryan_Paris_@bparispoker: posts small blind $300
DeepStack: posts big blind $600
*** HOLE CARDS ***
Dealt to DeepStack [8h Qh]
Dealt to Bryan_Paris_@bparispoker [Qc 8s]
Bryan_Paris_@bparispoker: calls $300
DeepStack: checks
*** FLOP **** [3s 6c 7d]
DeepStack: checks
Bryan_Paris_@bparispoker: raises $850 to $850
DeepStack: folds
Uncalled bet ($850) returned to Bryan_Paris_@bparispoker
Bryan_Paris_@bparispoker collected $1200 from the pot
*** SUMMARY ***
Total pot $1200 | Rake $0
Board [3s 6c 7d]
Seat 1: DeepStack (big blind) folded on the Flop
Seat 2: Bryan_Paris_@bparispoker (button) (small blind) collected ($1200)

PokerStars Hand #13000400060: Tournament #5, May4_2017-at-15_32_53 Hold'em No Limit ($300/$600 USD) - 2017/05/04 17:33:52 ET
Table 'ACPC Match' 2-max Seat #1 is the button
Seat 1: DeepStack ($7150 in chips)
Seat 2: Bryan_Paris_@bparispoker ($32850 in chips)
DeepStack: posts small blind $300
Bryan_Paris_@bparispoker: posts big blind $600
*** HOLE CARDS ***
Dealt to DeepStack [Th Jc]
Dealt to Bryan_Paris_@bparispoker [9d 7d]
DeepStack: calls $300
Bryan_Paris_@bparispoker: checks
*** FLOP **** [2c 6d 4s]
Bryan_Paris_@bparispoker: checks
DeepStack: checks
*** TURN **** [3h]
Bryan_Paris_@bparispoker: bets $750
DeepStack: folds
Uncalled bet ($750) returned to Bryan_Paris_@bparispoker
Bryan_Paris_@bparispoker collected $1200 from the pot
*** SUMMARY ***
Total pot $1200 | Rake $0
Board [2c 6d 4s 3h]
Seat 1: DeepStack (button) (small blind) folded on the Turn
Seat 2: Bryan_Paris_@bparispoker (big blind) collected ($1200)

PokerStars Hand #13000400061: Tournament #5, May4_2017-at-15_32_53 Hold'em No Limit ($400/$800 USD) - 2017/05/04 17:33:53 ET
Table 'ACPC Match' 2-max Seat #2 is the button
Seat 1: DeepStack ($6550 in chips)
Seat 2: Bryan_Paris_@bparispoker ($33450 in chips)
Bryan_Paris_@bparispoker: posts small blind $400
DeepStack: posts big blind $800
*** HOLE CARDS ***
Dealt to DeepStack [2s Ks]
Dealt to Bryan_Paris_@bparispoker [8h 4s]
Bryan_Paris_@bparispoker: folds
Uncalled bet ($400) returned to DeepStack
DeepStack collected $800 from the pot
*** SUMMARY ***
Total pot $800 | Rake $0
Seat 1: DeepStack (big blind) collected ($800)
Seat 2: Bryan_Paris_@bparispoker (button) (small blind) folded before the Flop

PokerStars Hand #13000400062: Tournament #5, May4_2017-at-15_32_53 Hold'em No Limit ($400/$800 USD) - 2017/05/04 17:33:54 ET
Table 'ACPC Match' 2-max Seat #1 is the button
Seat 1: DeepStack ($6950 in chips)
Seat 2: Bryan_Paris_@bparispoker ($33050 in chips)
DeepStack: posts small blind $400
Bryan_Paris_@bparispoker: posts big blind $800
*** HOLE CARDS ***
Dealt to DeepStack [4d 4h]
Dealt to Bryan_Paris_@bparispoker [2s 6h]
DeepStack: calls $400
Bryan_Paris_@bparispoker: checks
*** FLOP **** [6d Ts 8s]
Bryan_Paris_@bparispoker: checks
DeepStack: checks
*** TURN **** [5d]
Bryan_Paris_@bparispoker: checks
DeepStack: checks
*** RIVER **** [2h]
Bryan_Paris_@bparispoker: bets $1350
DeepStack: calls $1350
*** SHOW DOWN ***
Bryan_Paris_@bparispoker: shows [2s 6h] (two pair, Sixes and Deuces)
DeepStack: shows [4d 4h] (a pair of Fours)
Bryan_Paris_@bparispoker collected $4300 from pot
*** SUMMARY ***
Total pot $4300 | Rake $0
Board [6d Ts 8s 5d 2h]
Seat 1: DeepStack (button) (small blind) showed [4d 4h] and lost with a pair of Fours
Seat 2: Bryan_Paris_@bparispoker (big blind) showed [2s 6h] and won ($4300) with two pair, Sixes and Deuces

PokerStars Hand #13000400063: Tournament #5, May4_2017-at-15_32_53 Hold'em No Limit ($400/$800 USD) - 2017/05/04 17:33:55 ET
Table 'ACPC Match' 2-max Seat #2 is the button
Seat 1: DeepStack ($4800 in chips)
Seat 2: Bryan_Paris_@bparispoker ($35200 in chips)
Bryan_Paris_@bparispoker: posts small blind $400
DeepStack: posts big blind $800
*** HOLE CARDS ***
Dealt to DeepStack [4h Jc]
Dealt to Bryan_Paris_@bparispoker [Qc 7h]
Bryan_Paris_@bparispoker: raises $34400 to $35200 and is all-in
DeepStack: folds
Uncalled bet ($34400) returned to Bryan_Paris_@bparispoker
Bryan_Paris_@bparispoker collected $1600 from the pot
*** SUMMARY ***
Total pot $1600 | Rake $0
Seat 1: DeepStack (big blind) folded before the Flop
Seat 2: Bryan_Paris_@bparispoker (button) (small blind) collected ($1600)

PokerStars Hand #13000400064: Tournament #5, May4_2017-at-15_32_53 Hold'em No Limit ($400/$800 USD) - 2017/05/04 17:33:56 ET
Table 'ACPC Match' 2-max Seat #1 is the button
Seat 1: DeepStack ($4000 in chips)
Seat 2: Bryan_Paris_@bparispoker ($36000 in chips)
DeepStack: posts small blind $400
Bryan_Paris_@bparispoker: posts big blind $800
*** HOLE CARDS ***
Dealt to DeepStack [3c 2s]
Dealt to Bryan_Paris_@bparispoker [Kd Tc]
DeepStack: folds
Uncalled bet ($400) returned to Bryan_Paris_@bparispoker
Bryan_Paris_@bparispoker collected $800 from the pot
*** SUMMARY ***
Total pot $800 | Rake $0
Seat 1: DeepStack (button) (small blind) folded before the Flop
Seat 2: Bryan_Paris_@bparispoker (big blind) collected ($800)

PokerStars Hand #13000400065: Tournament #5, May4_2017-at-15_32_53 Hold'em No Limit ($400/$800 USD) - 2017/05/04 17:33:57 ET
Table 'ACPC Match' 2-max Seat #2 is the button
Seat 1: DeepStack ($3600 in chips)
Seat 2: Bryan_Paris_@bparispoker ($36400 in chips)
Bryan_Paris_@bparispoker: posts small blind $400
DeepStack: posts big blind $800
*** HOLE CARDS ***
Dealt to DeepStack [Ks 3d]
Dealt to Bryan_Paris_@bparispoker [Jd Kh]
Bryan_Paris_@bparispoker: raises $35600 to $36400 and is all-in
DeepStack: calls $2800 and is all-in
Uncalled bet ($32800) returned to Bryan_Paris_@bparispoker
*** FLOP **** [7d 7s Qs]
*** TURN **** [9c]
*** RIVER **** [3c]
*** SHOW DOWN ***
Bryan_Paris_@bparispoker: shows [Jd Kh] (a pair of Sevens)
DeepStack: shows [Ks 3d] (two pair, Sevens and Threes)
DeepStack collected $7200 from pot
*** SUMMARY ***
Total pot $7200 | Rake $0
Board [7d 7s Qs 9c 3c]
Seat 1: DeepStack (big blind) showed [Ks 3d] and won ($7200) with two pair, Sevens and Threes
Seat 2: Bryan_Paris_@bparispoker (button) (small blind) showed [Jd Kh] and lost with a pair of Sevens

PokerStars Hand #13000400066: Tournament #5, May4_2017-at-15_32_53 Hold'em No Limit ($400/$800 USD) - 2017/05/04 17:33:58 ET
Table 'ACPC Match' 2-max Seat #1 is the button
Seat 1: DeepStack ($7200 in chips)
Seat 2: Bryan_Paris_@bparispoker ($32800 in chips)
DeepStack: posts small blind $400
Bryan_Paris_@bparispoker: posts big blind $800
*** HOLE CARDS ***
Dealt to DeepStack [2s 8s]
Dealt to Bryan_Paris_@bparispoker [Qc 9c]
DeepStack: calls $400
Bryan_Paris_@bparispoker: raises $32000 to $32800 and is all-in
DeepStack: folds
Uncalled bet ($32000) returned to Bryan_Paris_@bparispoker
Bryan_Paris_@bparispoker collected $1600 from the pot
*** SUMMARY ***
Total pot $1600 | Rake $0
Seat 1: DeepStack (button) (small blind) folded before the Flop
Seat 2: Bryan_Paris_@bparispoker (big blind) collected ($1600)

PokerStars Hand #13000400067: Tournament #5, May4_2017-at-15_32_53 Hold'em No Limit ($400/$800 USD) - 2017/05/04 17:33:59 ET
Table 'ACPC Match' 2-max Seat #2 is the button
Seat 1: DeepStack ($6400 in chips)
Seat 2: Bryan_Paris_@bparispoker ($33600 in chips)
Bryan_Paris_@bparispoker: posts small blind $400
DeepStack: posts big blind $800
*** HOLE CARDS ***
Dealt to DeepStack [4s As]
Dealt to Bryan_Paris_@bparispoker [2d 5s]
Bryan_Paris_@bparispoker: folds
Uncalled bet ($400) returned to DeepStack
DeepStack collected $800 from the pot
*** SUMMARY ***
Total pot $800 | Rake $0
Seat 1: DeepStack (big blind) collected ($800)
Seat 2: Bryan_Paris_@bparispoker (button) (small blind) folded before the Flop

PokerStars Hand #13000400068: Tournament #5, May4_2017-at-15_32_53 Hold'em No Limit ($400/$800 USD) - 2017/05/04 17:34:00 ET
Table 'ACPC Match' 2-max Seat #1 is the button
Seat 1: DeepStack ($6800 in chips)
Seat 2: Bryan_Paris_@bparispoker ($33200 in chips)
DeepStack: posts small blind $400
Bryan_Paris_@bparispoker: posts big blind $800
*** HOLE CARDS ***
Dealt to DeepStack [8s 9c]
Dealt to Bryan_Paris_@bparispoker [6s Ac]
DeepStack: raises $6000 to $6800 and is all-in
Bryan_Paris_@bparispoker: calls $6000
*** FLOP **** [Qh 3c 7s]
*** TURN **** [2c]
*** RIVER **** [4c]
*** SHOW DOWN ***
DeepStack: shows [8s 9c] (Queen high)
Bryan_Paris_@bparispoker: shows [6s Ac] (Ace high)
Bryan_Paris_@bparispoker collected $13600 from pot
*** SUMMARY ***
Total pot $13600 | Rake $0
Board [Qh 3c 7s 2c 4c]
Seat 1: DeepStack (button) (small blind) showed [8s 9c] and lost with Queen high
Seat 2: Bryan_Paris_@bparispoker (big blind) showed [6s Ac] and won ($13600) with Ace high
