PokerStars Hand #9000200001: Tournament #3, Apr19_2017-at-17_49_47 Hold'em No Limit ($50/$100 USD) - 2017/04/19 19:49:47 ET
Table 'ACPC Match' 2-max Seat #2 is the button
Seat 1: DeepStack ($20000 in chips)
Seat 2: Taylor_@TaylorvonK ($20000 in chips)
Taylor_@TaylorvonK: posts small blind $50
DeepStack: posts big blind $100
*** HOLE CARDS ***
Dealt to DeepStack [Qs 2d]
Dealt to Taylor_@TaylorvonK [3h 5s]
Taylor_@TaylorvonK: folds
Uncalled bet ($50) returned to DeepStack
DeepStack collected $100 from the pot
*** SUMMARY ***
Total pot $100 | Rake $0
Seat 1: DeepStack (big blind) collected ($100)
Seat 2: Taylor_@TaylorvonK (button) (small blind) folded before the Flop

PokerStars Hand #9000200002: Tournament #3, Apr19_2017-at-17_49_47 Hold'em No Limit ($50/$100 USD) - 2017/04/19 19:49:48 ET
Table 'ACPC Match' 2-max Seat #1 is the button
Seat 1: DeepStack ($20050 in chips)
Seat 2: Taylor_@TaylorvonK ($19950 in chips)
DeepStack: posts small blind $50
Taylor_@TaylorvonK: posts big blind $100
*** HOLE CARDS ***
Dealt to DeepStack [8s Ks]
Dealt to Taylor_@TaylorvonK [6s 4c]
DeepStack: raises $100 to $200
Taylor_@TaylorvonK: calls $100
*** FLOP **** [Tc 5s 9c]
Taylor_@TaylorvonK: checks
DeepStack: checks
*** TURN **** [9d]
Taylor_@TaylorvonK: bets $999
DeepStack: folds
Uncalled bet ($999) returned to Taylor_@TaylorvonK
Taylor_@TaylorvonK collected $400 from the pot
*** SUMMARY ***
Total pot $400 | Rake $0
Board [Tc 5s 9c 9d]
Seat 1: DeepStack (button) (small blind) folded on the Turn
Seat 2: Taylor_@TaylorvonK (big blind) collected ($400)

PokerStars Hand #9000200003: Tournament #3, Apr19_2017-at-17_49_47 Hold'em No Limit ($50/$100 USD) - 2017/04/19 19:49:49 ET
Table 'ACPC Match' 2-max Seat #2 is the button
Seat 1: DeepStack ($19850 in chips)
Seat 2: Taylor_@TaylorvonK ($20150 in chips)
Taylor_@TaylorvonK: posts small blind $50
DeepStack: posts big blind $100
*** HOLE CARDS ***
Dealt to DeepStack [Td 2s]
Dealt to Taylor_@TaylorvonK [7s 6h]
Taylor_@TaylorvonK: raises $677 to $777
DeepStack: folds
Uncalled bet ($677) returned to Taylor_@TaylorvonK
Taylor_@TaylorvonK collected $200 from the pot
*** SUMMARY ***
Total pot $200 | Rake $0
Seat 1: DeepStack (big blind) folded before the Flop
Seat 2: Taylor_@TaylorvonK (button) (small blind) collected ($200)

PokerStars Hand #9000200004: Tournament #3, Apr19_2017-at-17_49_47 Hold'em No Limit ($50/$100 USD) - 2017/04/19 19:49:50 ET
Table 'ACPC Match' 2-max Seat #1 is the button
Seat 1: DeepStack ($19750 in chips)
Seat 2: Taylor_@TaylorvonK ($20250 in chips)
DeepStack: posts small blind $50
Taylor_@TaylorvonK: posts big blind $100
*** HOLE CARDS ***
Dealt to DeepStack [6h Ts]
Dealt to Taylor_@TaylorvonK [2d 9h]
DeepStack: calls $50
Taylor_@TaylorvonK: checks
*** FLOP **** [3c Kh Kc]
Taylor_@TaylorvonK: checks
DeepStack: raises $100 to $100
Taylor_@TaylorvonK: raises $788 to $888
DeepStack: folds
Uncalled bet ($788) returned to Taylor_@TaylorvonK
Taylor_@TaylorvonK collected $400 from the pot
*** SUMMARY ***
Total pot $400 | Rake $0
Board [3c Kh Kc]
Seat 1: DeepStack (button) (small blind) folded on the Flop
Seat 2: Taylor_@TaylorvonK (big blind) collected ($400)

PokerStars Hand #9000200005: Tournament #3, Apr19_2017-at-17_49_47 Hold'em No Limit ($50/$100 USD) - 2017/04/19 19:49:51 ET
Table 'ACPC Match' 2-max Seat #2 is the button
Seat 1: DeepStack ($19550 in chips)
Seat 2: Taylor_@TaylorvonK ($20450 in chips)
Taylor_@TaylorvonK: posts small blind $50
DeepStack: posts big blind $100
*** HOLE CARDS ***
Dealt to DeepStack [8d 6s]
Dealt to Taylor_@TaylorvonK [Jh Ts]
Taylor_@TaylorvonK: raises $566 to $666
DeepStack: folds
Uncalled bet ($566) returned to Taylor_@TaylorvonK
Taylor_@TaylorvonK collected $200 from the pot
*** SUMMARY ***
Total pot $200 | Rake $0
Seat 1: DeepStack (big blind) folded before the Flop
Seat 2: Taylor_@TaylorvonK (button) (small blind) collected ($200)

PokerStars Hand #9000200006: Tournament #3, Apr19_2017-at-17_49_47 Hold'em No Limit ($50/$100 USD) - 2017/04/19 19:49:52 ET
Table 'ACPC Match' 2-max Seat #1 is the button
Seat 1: DeepStack ($19450 in chips)
Seat 2: Taylor_@TaylorvonK ($20550 in chips)
DeepStack: posts small blind $50
Taylor_@TaylorvonK: posts big blind $100
*** HOLE CARDS ***
Dealt to DeepStack [Js 7h]
Dealt to Taylor_@TaylorvonK [6s Kc]
DeepStack: raises $200 to $300
Taylor_@TaylorvonK: raises $1699 to $1999
DeepStack: folds
Uncalled bet ($1699) returned to Taylor_@TaylorvonK
Taylor_@TaylorvonK collected $600 from the pot
*** SUMMARY ***
Total pot $600 | Rake $0
Seat 1: DeepStack (button) (small blind) folded before the Flop
Seat 2: Taylor_@TaylorvonK (big blind) collected ($600)

PokerStars Hand #9000200007: Tournament #3, Apr19_2017-at-17_49_47 Hold'em No Limit ($50/$100 USD) - 2017/04/19 19:49:53 ET
Table 'ACPC Match' 2-max Seat #2 is the button
Seat 1: DeepStack ($19150 in chips)
Seat 2: Taylor_@TaylorvonK ($20850 in chips)
Taylor_@TaylorvonK: posts small blind $50
DeepStack: posts big blind $100
*** HOLE CARDS ***
Dealt to DeepStack [3h 4c]
Dealt to Taylor_@TaylorvonK [Ac 4d]
Taylor_@TaylorvonK: raises $677 to $777
DeepStack: folds
Uncalled bet ($677) returned to Taylor_@TaylorvonK
Taylor_@TaylorvonK collected $200 from the pot
*** SUMMARY ***
Total pot $200 | Rake $0
Seat 1: DeepStack (big blind) folded before the Flop
Seat 2: Taylor_@TaylorvonK (button) (small blind) collected ($200)

PokerStars Hand #9000200008: Tournament #3, Apr19_2017-at-17_49_47 Hold'em No Limit ($50/$100 USD) - 2017/04/19 19:49:54 ET
Table 'ACPC Match' 2-max Seat #1 is the button
Seat 1: DeepStack ($19050 in chips)
Seat 2: Taylor_@TaylorvonK ($20950 in chips)
DeepStack: posts small blind $50
Taylor_@TaylorvonK: posts big blind $100
*** HOLE CARDS ***
Dealt to DeepStack [6s Qs]
Dealt to Taylor_@TaylorvonK [9d 9h]
DeepStack: calls $50
Taylor_@TaylorvonK: raises $566 to $666
DeepStack: calls $566
*** FLOP **** [8c Jd 6d]
Taylor_@TaylorvonK: checks
DeepStack: raises $666 to $666
Taylor_@TaylorvonK: calls $666
*** TURN **** [5h]
Taylor_@TaylorvonK: checks
DeepStack: checks
*** RIVER **** [4s]
Taylor_@TaylorvonK: bets $1888
DeepStack: raises $6440 to $8328
Taylor_@TaylorvonK: calls $6440
*** SHOW DOWN ***
DeepStack: shows [6s Qs] (a pair of Sixes)
Taylor_@TaylorvonK: shows [9d 9h] (a pair of Nines)
Taylor_@TaylorvonK collected $19320 from pot
*** SUMMARY ***
Total pot $19320 | Rake $0
Board [8c Jd 6d 5h 4s]
Seat 1: DeepStack (button) (small blind) showed [6s Qs] and lost with a pair of Sixes
Seat 2: Taylor_@TaylorvonK (big blind) showed [9d 9h] and won ($19320) with a pair of Nines

PokerStars Hand #9000200009: Tournament #3, Apr19_2017-at-17_49_47 Hold'em No Limit ($50/$100 USD) - 2017/04/19 19:49:55 ET
Table 'ACPC Match' 2-max Seat #2 is the button
Seat 1: DeepStack ($9390 in chips)
Seat 2: Taylor_@TaylorvonK ($30610 in chips)
Taylor_@TaylorvonK: posts small blind $50
DeepStack: posts big blind $100
*** HOLE CARDS ***
Dealt to DeepStack [3h Tc]
Dealt to Taylor_@TaylorvonK [8s Kd]
Taylor_@TaylorvonK: raises $677 to $777
DeepStack: folds
Uncalled bet ($677) returned to Taylor_@TaylorvonK
Taylor_@TaylorvonK collected $200 from the pot
*** SUMMARY ***
Total pot $200 | Rake $0
Seat 1: DeepStack (big blind) folded before the Flop
Seat 2: Taylor_@TaylorvonK (button) (small blind) collected ($200)

PokerStars Hand #9000200010: Tournament #3, Apr19_2017-at-17_49_47 Hold'em No Limit ($50/$100 USD) - 2017/04/19 19:49:56 ET
Table 'ACPC Match' 2-max Seat #1 is the button
Seat 1: DeepStack ($9290 in chips)
Seat 2: Taylor_@TaylorvonK ($30710 in chips)
DeepStack: posts small blind $50
Taylor_@TaylorvonK: posts big blind $100
*** HOLE CARDS ***
Dealt to DeepStack [Qs 9d]
Dealt to Taylor_@TaylorvonK [Kc 2h]
DeepStack: raises $100 to $200
Taylor_@TaylorvonK: raises $1244 to $1444
DeepStack: folds
Uncalled bet ($1244) returned to Taylor_@TaylorvonK
Taylor_@TaylorvonK collected $400 from the pot
*** SUMMARY ***
Total pot $400 | Rake $0
Seat 1: DeepStack (button) (small blind) folded before the Flop
Seat 2: Taylor_@TaylorvonK (big blind) collected ($400)

PokerStars Hand #9000200011: Tournament #3, Apr19_2017-at-17_49_47 Hold'em No Limit ($75/$150 USD) - 2017/04/19 19:49:57 ET
Table 'ACPC Match' 2-max Seat #2 is the button
Seat 1: DeepStack ($9090 in chips)
Seat 2: Taylor_@TaylorvonK ($30910 in chips)
Taylor_@TaylorvonK: posts small blind $75
DeepStack: posts big blind $150
*** HOLE CARDS ***
Dealt to DeepStack [Td 6c]
Dealt to Taylor_@TaylorvonK [Qd As]
Taylor_@TaylorvonK: raises $516 to $666
DeepStack: folds
Uncalled bet ($516) returned to Taylor_@TaylorvonK
Taylor_@TaylorvonK collected $300 from the pot
*** SUMMARY ***
Total pot $300 | Rake $0
Seat 1: DeepStack (big blind) folded before the Flop
Seat 2: Taylor_@TaylorvonK (button) (small blind) collected ($300)

PokerStars Hand #9000200012: Tournament #3, Apr19_2017-at-17_49_47 Hold'em No Limit ($75/$150 USD) - 2017/04/19 19:49:58 ET
Table 'ACPC Match' 2-max Seat #1 is the button
Seat 1: DeepStack ($8940 in chips)
Seat 2: Taylor_@TaylorvonK ($31060 in chips)
DeepStack: posts small blind $75
Taylor_@TaylorvonK: posts big blind $150
*** HOLE CARDS ***
Dealt to DeepStack [8d 6d]
Dealt to Taylor_@TaylorvonK [9s 6c]
DeepStack: raises $150 to $300
Taylor_@TaylorvonK: folds
Uncalled bet ($150) returned to DeepStack
DeepStack collected $300 from the pot
*** SUMMARY ***
Total pot $300 | Rake $0
Seat 1: DeepStack (button) (small blind) collected ($300)
Seat 2: Taylor_@TaylorvonK (big blind) folded before the Flop

PokerStars Hand #9000200013: Tournament #3, Apr19_2017-at-17_49_47 Hold'em No Limit ($75/$150 USD) - 2017/04/19 19:49:59 ET
Table 'ACPC Match' 2-max Seat #2 is the button
Seat 1: DeepStack ($9090 in chips)
Seat 2: Taylor_@TaylorvonK ($30910 in chips)
Taylor_@TaylorvonK: posts small blind $75
DeepStack: posts big blind $150
*** HOLE CARDS ***
Dealt to DeepStack [8s 4d]
Dealt to Taylor_@TaylorvonK [4s Qc]
Taylor_@TaylorvonK: raises $627 to $777
DeepStack: folds
Uncalled bet ($627) returned to Taylor_@TaylorvonK
Taylor_@TaylorvonK collected $300 from the pot
*** SUMMARY ***
Total pot $300 | Rake $0
Seat 1: DeepStack (big blind) folded before the Flop
Seat 2: Taylor_@TaylorvonK (button) (small blind) collected ($300)

PokerStars Hand #9000200014: Tournament #3, Apr19_2017-at-17_49_47 Hold'em No Limit ($75/$150 USD) - 2017/04/19 19:50:00 ET
Table 'ACPC Match' 2-max Seat #1 is the button
Seat 1: DeepStack ($8940 in chips)
Seat 2: Taylor_@TaylorvonK ($31060 in chips)
DeepStack: posts small blind $75
Taylor_@TaylorvonK: posts big blind $150
*** HOLE CARDS ***
Dealt to DeepStack [9c 6c]
Dealt to Taylor_@TaylorvonK [4h 8h]
DeepStack: calls $75
Taylor_@TaylorvonK: checks
*** FLOP **** [9h Kc 6d]
Taylor_@TaylorvonK: checks
DeepStack: raises $150 to $150
Taylor_@TaylorvonK: folds
Uncalled bet ($150) returned to DeepStack
DeepStack collected $300 from the pot
*** SUMMARY ***
Total pot $300 | Rake $0
Board [9h Kc 6d]
Seat 1: DeepStack (button) (small blind) collected ($300)
Seat 2: Taylor_@TaylorvonK (big blind) folded on the Flop

PokerStars Hand #9000200015: Tournament #3, Apr19_2017-at-17_49_47 Hold'em No Limit ($75/$150 USD) - 2017/04/19 19:50:01 ET
Table 'ACPC Match' 2-max Seat #2 is the button
Seat 1: DeepStack ($9090 in chips)
Seat 2: Taylor_@TaylorvonK ($30910 in chips)
Taylor_@TaylorvonK: posts small blind $75
DeepStack: posts big blind $150
*** HOLE CARDS ***
Dealt to DeepStack [8d 3d]
Dealt to Taylor_@TaylorvonK [9d Kd]
Taylor_@TaylorvonK: raises $150 to $300
DeepStack: calls $150
*** FLOP **** [4h 2h Jd]
DeepStack: checks
Taylor_@TaylorvonK: raises $1234 to $1234
DeepStack: folds
Uncalled bet ($1234) returned to Taylor_@TaylorvonK
Taylor_@TaylorvonK collected $600 from the pot
*** SUMMARY ***
Total pot $600 | Rake $0
Board [4h 2h Jd]
Seat 1: DeepStack (big blind) folded on the Flop
Seat 2: Taylor_@TaylorvonK (button) (small blind) collected ($600)

PokerStars Hand #9000200016: Tournament #3, Apr19_2017-at-17_49_47 Hold'em No Limit ($75/$150 USD) - 2017/04/19 19:50:02 ET
Table 'ACPC Match' 2-max Seat #1 is the button
Seat 1: DeepStack ($8790 in chips)
Seat 2: Taylor_@TaylorvonK ($31210 in chips)
DeepStack: posts small blind $75
Taylor_@TaylorvonK: posts big blind $150
*** HOLE CARDS ***
Dealt to DeepStack [Kc Jd]
Dealt to Taylor_@TaylorvonK [Td Kh]
DeepStack: raises $150 to $300
Taylor_@TaylorvonK: calls $150
*** FLOP **** [Js Ac Kd]
Taylor_@TaylorvonK: checks
DeepStack: raises $600 to $600
Taylor_@TaylorvonK: calls $600
*** TURN **** [6c]
Taylor_@TaylorvonK: checks
DeepStack: raises $1799 to $1799
Taylor_@TaylorvonK: folds
Uncalled bet ($1799) returned to DeepStack
DeepStack collected $1800 from the pot
*** SUMMARY ***
Total pot $1800 | Rake $0
Board [Js Ac Kd 6c]
Seat 1: DeepStack (button) (small blind) collected ($1800)
Seat 2: Taylor_@TaylorvonK (big blind) folded on the Turn

PokerStars Hand #9000200017: Tournament #3, Apr19_2017-at-17_49_47 Hold'em No Limit ($75/$150 USD) - 2017/04/19 19:50:03 ET
Table 'ACPC Match' 2-max Seat #2 is the button
Seat 1: DeepStack ($9690 in chips)
Seat 2: Taylor_@TaylorvonK ($30310 in chips)
Taylor_@TaylorvonK: posts small blind $75
DeepStack: posts big blind $150
*** HOLE CARDS ***
Dealt to DeepStack [6h Kd]
Dealt to Taylor_@TaylorvonK [Ac 9d]
Taylor_@TaylorvonK: raises $150 to $300
DeepStack: calls $150
*** FLOP **** [6c 7c As]
DeepStack: checks
Taylor_@TaylorvonK: raises $300 to $300
DeepStack: calls $300
*** TURN **** [Td]
DeepStack: checks
Taylor_@TaylorvonK: checks
*** RIVER **** [Ah]
DeepStack: checks
Taylor_@TaylorvonK: raises $150 to $150
DeepStack: calls $150
*** SHOW DOWN ***
Taylor_@TaylorvonK: shows [Ac 9d] (three of a kind, Aces)
DeepStack: shows [6h Kd] (two pair, Aces and Sixes)
Taylor_@TaylorvonK collected $1500 from pot
*** SUMMARY ***
Total pot $1500 | Rake $0
Board [6c 7c As Td Ah]
Seat 1: DeepStack (big blind) showed [6h Kd] and lost with two pair, Aces and Sixes
Seat 2: Taylor_@TaylorvonK (button) (small blind) showed [Ac 9d] and won ($1500) with three of a kind, Aces

PokerStars Hand #9000200018: Tournament #3, Apr19_2017-at-17_49_47 Hold'em No Limit ($75/$150 USD) - 2017/04/19 19:50:04 ET
Table 'ACPC Match' 2-max Seat #1 is the button
Seat 1: DeepStack ($8940 in chips)
Seat 2: Taylor_@TaylorvonK ($31060 in chips)
DeepStack: posts small blind $75
Taylor_@TaylorvonK: posts big blind $150
*** HOLE CARDS ***
Dealt to DeepStack [5d Ad]
Dealt to Taylor_@TaylorvonK [3s 8h]
DeepStack: raises $150 to $300
Taylor_@TaylorvonK: folds
Uncalled bet ($150) returned to DeepStack
DeepStack collected $300 from the pot
*** SUMMARY ***
Total pot $300 | Rake $0
Seat 1: DeepStack (button) (small blind) collected ($300)
Seat 2: Taylor_@TaylorvonK (big blind) folded before the Flop

PokerStars Hand #9000200019: Tournament #3, Apr19_2017-at-17_49_47 Hold'em No Limit ($75/$150 USD) - 2017/04/19 19:50:05 ET
Table 'ACPC Match' 2-max Seat #2 is the button
Seat 1: DeepStack ($9090 in chips)
Seat 2: Taylor_@TaylorvonK ($30910 in chips)
Taylor_@TaylorvonK: posts small blind $75
DeepStack: posts big blind $150
*** HOLE CARDS ***
Dealt to DeepStack [5d 7h]
Dealt to Taylor_@TaylorvonK [9c Qd]
Taylor_@TaylorvonK: raises $150 to $300
DeepStack: calls $150
*** FLOP **** [9s As 6d]
DeepStack: checks
Taylor_@TaylorvonK: raises $345 to $345
DeepStack: calls $345
*** TURN **** [2d]
DeepStack: checks
Taylor_@TaylorvonK: checks
*** RIVER **** [2h]
DeepStack: bets $645
Taylor_@TaylorvonK: calls $645
*** SHOW DOWN ***
DeepStack: shows [5d 7h] (a pair of Deuces)
Taylor_@TaylorvonK: shows [9c Qd] (two pair, Nines and Deuces)
Taylor_@TaylorvonK collected $2580 from pot
*** SUMMARY ***
Total pot $2580 | Rake $0
Board [9s As 6d 2d 2h]
Seat 1: DeepStack (big blind) showed [5d 7h] and lost with a pair of Deuces
Seat 2: Taylor_@TaylorvonK (button) (small blind) showed [9c Qd] and won ($2580) with two pair, Nines and Deuces

PokerStars Hand #9000200020: Tournament #3, Apr19_2017-at-17_49_47 Hold'em No Limit ($75/$150 USD) - 2017/04/19 19:50:06 ET
Table 'ACPC Match' 2-max Seat #1 is the button
Seat 1: DeepStack ($7800 in chips)
Seat 2: Taylor_@TaylorvonK ($32200 in chips)
DeepStack: posts small blind $75
Taylor_@TaylorvonK: posts big blind $150
*** HOLE CARDS ***
Dealt to DeepStack [Qs Ks]
Dealt to Taylor_@TaylorvonK [8s 5d]
DeepStack: calls $75
Taylor_@TaylorvonK: checks
*** FLOP **** [8h 7d 2s]
Taylor_@TaylorvonK: checks
DeepStack: checks
*** TURN **** [Tc]
Taylor_@TaylorvonK: bets $234
DeepStack: folds
Uncalled bet ($234) returned to Taylor_@TaylorvonK
Taylor_@TaylorvonK collected $300 from the pot
*** SUMMARY ***
Total pot $300 | Rake $0
Board [8h 7d 2s Tc]
Seat 1: DeepStack (button) (small blind) folded on the Turn
Seat 2: Taylor_@TaylorvonK (big blind) collected ($300)

PokerStars Hand #9000200021: Tournament #3, Apr19_2017-at-17_49_47 Hold'em No Limit ($100/$200 USD) - 2017/04/19 19:50:07 ET
Table 'ACPC Match' 2-max Seat #2 is the button
Seat 1: DeepStack ($7650 in chips)
Seat 2: Taylor_@TaylorvonK ($32350 in chips)
Taylor_@TaylorvonK: posts small blind $100
DeepStack: posts big blind $200
*** HOLE CARDS ***
Dealt to DeepStack [Js Kd]
Dealt to Taylor_@TaylorvonK [2d Kc]
Taylor_@TaylorvonK: raises $577 to $777
DeepStack: raises $777 to $1554
Taylor_@TaylorvonK: folds
Uncalled bet ($777) returned to DeepStack
DeepStack collected $1554 from the pot
*** SUMMARY ***
Total pot $1554 | Rake $0
Seat 1: DeepStack (big blind) collected ($1554)
Seat 2: Taylor_@TaylorvonK (button) (small blind) folded before the Flop

PokerStars Hand #9000200022: Tournament #3, Apr19_2017-at-17_49_47 Hold'em No Limit ($100/$200 USD) - 2017/04/19 19:50:08 ET
Table 'ACPC Match' 2-max Seat #1 is the button
Seat 1: DeepStack ($8427 in chips)
Seat 2: Taylor_@TaylorvonK ($31573 in chips)
DeepStack: posts small blind $100
Taylor_@TaylorvonK: posts big blind $200
*** HOLE CARDS ***
Dealt to DeepStack [Kc Js]
Dealt to Taylor_@TaylorvonK [Qd 9c]
DeepStack: raises $200 to $400
Taylor_@TaylorvonK: calls $200
*** FLOP **** [Ts 5h 7h]
Taylor_@TaylorvonK: checks
DeepStack: checks
*** TURN **** [7s]
Taylor_@TaylorvonK: bets $1999
DeepStack: folds
Uncalled bet ($1999) returned to Taylor_@TaylorvonK
Taylor_@TaylorvonK collected $800 from the pot
*** SUMMARY ***
Total pot $800 | Rake $0
Board [Ts 5h 7h 7s]
Seat 1: DeepStack (button) (small blind) folded on the Turn
Seat 2: Taylor_@TaylorvonK (big blind) collected ($800)

PokerStars Hand #9000200023: Tournament #3, Apr19_2017-at-17_49_47 Hold'em No Limit ($100/$200 USD) - 2017/04/19 19:50:09 ET
Table 'ACPC Match' 2-max Seat #2 is the button
Seat 1: DeepStack ($8027 in chips)
Seat 2: Taylor_@TaylorvonK ($31973 in chips)
Taylor_@TaylorvonK: posts small blind $100
DeepStack: posts big blind $200
*** HOLE CARDS ***
Dealt to DeepStack [9c 3d]
Dealt to Taylor_@TaylorvonK [5h 9d]
Taylor_@TaylorvonK: folds
Uncalled bet ($100) returned to DeepStack
DeepStack collected $200 from the pot
*** SUMMARY ***
Total pot $200 | Rake $0
Seat 1: DeepStack (big blind) collected ($200)
Seat 2: Taylor_@TaylorvonK (button) (small blind) folded before the Flop

PokerStars Hand #9000200024: Tournament #3, Apr19_2017-at-17_49_47 Hold'em No Limit ($100/$200 USD) - 2017/04/19 19:50:10 ET
Table 'ACPC Match' 2-max Seat #1 is the button
Seat 1: DeepStack ($8127 in chips)
Seat 2: Taylor_@TaylorvonK ($31873 in chips)
DeepStack: posts small blind $100
Taylor_@TaylorvonK: posts big blind $200
*** HOLE CARDS ***
Dealt to DeepStack [4h 7c]
Dealt to Taylor_@TaylorvonK [7d 7s]
DeepStack: calls $100
Taylor_@TaylorvonK: checks
*** FLOP **** [5d 5h Js]
Taylor_@TaylorvonK: checks
DeepStack: checks
*** TURN **** [Kh]
Taylor_@TaylorvonK: checks
DeepStack: raises $200 to $200
Taylor_@TaylorvonK: calls $200
*** RIVER **** [4d]
Taylor_@TaylorvonK: checks
DeepStack: checks
*** SHOW DOWN ***
Taylor_@TaylorvonK: shows [7d 7s] (two pair, Sevens and Fives)
DeepStack: shows [4h 7c] (two pair, Fives and Fours)
Taylor_@TaylorvonK collected $800 from pot
*** SUMMARY ***
Total pot $800 | Rake $0
Board [5d 5h Js Kh 4d]
Seat 1: DeepStack (button) (small blind) showed [4h 7c] and lost with two pair, Fives and Fours
Seat 2: Taylor_@TaylorvonK (big blind) showed [7d 7s] and won ($800) with two pair, Sevens and Fives

PokerStars Hand #9000200025: Tournament #3, Apr19_2017-at-17_49_47 Hold'em No Limit ($100/$200 USD) - 2017/04/19 19:50:11 ET
Table 'ACPC Match' 2-max Seat #2 is the button
Seat 1: DeepStack ($7727 in chips)
Seat 2: Taylor_@TaylorvonK ($32273 in chips)
Taylor_@TaylorvonK: posts small blind $100
DeepStack: posts big blind $200
*** HOLE CARDS ***
Dealt to DeepStack [8h 2c]
Dealt to Taylor_@TaylorvonK [Td 9h]
Taylor_@TaylorvonK: raises $466 to $666
DeepStack: folds
Uncalled bet ($466) returned to Taylor_@TaylorvonK
Taylor_@TaylorvonK collected $400 from the pot
*** SUMMARY ***
Total pot $400 | Rake $0
Seat 1: DeepStack (big blind) folded before the Flop
Seat 2: Taylor_@TaylorvonK (button) (small blind) collected ($400)

PokerStars Hand #9000200026: Tournament #3, Apr19_2017-at-17_49_47 Hold'em No Limit ($100/$200 USD) - 2017/04/19 19:50:12 ET
Table 'ACPC Match' 2-max Seat #1 is the button
Seat 1: DeepStack ($7527 in chips)
Seat 2: Taylor_@TaylorvonK ($32473 in chips)
DeepStack: posts small blind $100
Taylor_@TaylorvonK: posts big blind $200
*** HOLE CARDS ***
Dealt to DeepStack [3s 7d]
Dealt to Taylor_@TaylorvonK [Jh Ah]
DeepStack: folds
Uncalled bet ($100) returned to Taylor_@TaylorvonK
Taylor_@TaylorvonK collected $200 from the pot
*** SUMMARY ***
Total pot $200 | Rake $0
Seat 1: DeepStack (button) (small blind) folded before the Flop
Seat 2: Taylor_@TaylorvonK (big blind) collected ($200)

PokerStars Hand #9000200027: Tournament #3, Apr19_2017-at-17_49_47 Hold'em No Limit ($100/$200 USD) - 2017/04/19 19:50:13 ET
Table 'ACPC Match' 2-max Seat #2 is the button
Seat 1: DeepStack ($7427 in chips)
Seat 2: Taylor_@TaylorvonK ($32573 in chips)
Taylor_@TaylorvonK: posts small blind $100
DeepStack: posts big blind $200
*** HOLE CARDS ***
Dealt to DeepStack [5s Ac]
Dealt to Taylor_@TaylorvonK [2d 2c]
Taylor_@TaylorvonK: raises $200 to $400
DeepStack: calls $200
*** FLOP **** [8h 9c Kc]
DeepStack: checks
Taylor_@TaylorvonK: raises $999 to $999
DeepStack: folds
Uncalled bet ($999) returned to Taylor_@TaylorvonK
Taylor_@TaylorvonK collected $800 from the pot
*** SUMMARY ***
Total pot $800 | Rake $0
Board [8h 9c Kc]
Seat 1: DeepStack (big blind) folded on the Flop
Seat 2: Taylor_@TaylorvonK (button) (small blind) collected ($800)

PokerStars Hand #9000200028: Tournament #3, Apr19_2017-at-17_49_47 Hold'em No Limit ($100/$200 USD) - 2017/04/19 19:50:14 ET
Table 'ACPC Match' 2-max Seat #1 is the button
Seat 1: DeepStack ($7027 in chips)
Seat 2: Taylor_@TaylorvonK ($32973 in chips)
DeepStack: posts small blind $100
Taylor_@TaylorvonK: posts big blind $200
*** HOLE CARDS ***
Dealt to DeepStack [7h 5d]
Dealt to Taylor_@TaylorvonK [5c Ah]
DeepStack: raises $200 to $400
Taylor_@TaylorvonK: raises $1599 to $1999
DeepStack: folds
Uncalled bet ($1599) returned to Taylor_@TaylorvonK
Taylor_@TaylorvonK collected $800 from the pot
*** SUMMARY ***
Total pot $800 | Rake $0
Seat 1: DeepStack (button) (small blind) folded before the Flop
Seat 2: Taylor_@TaylorvonK (big blind) collected ($800)

PokerStars Hand #9000200029: Tournament #3, Apr19_2017-at-17_49_47 Hold'em No Limit ($100/$200 USD) - 2017/04/19 19:50:15 ET
Table 'ACPC Match' 2-max Seat #2 is the button
Seat 1: DeepStack ($6627 in chips)
Seat 2: Taylor_@TaylorvonK ($33373 in chips)
Taylor_@TaylorvonK: posts small blind $100
DeepStack: posts big blind $200
*** HOLE CARDS ***
Dealt to DeepStack [Ah Qc]
Dealt to Taylor_@TaylorvonK [Kd 5s]
Taylor_@TaylorvonK: raises $200 to $400
DeepStack: raises $6227 to $6627 and is all-in
Taylor_@TaylorvonK: folds
Uncalled bet ($6227) returned to DeepStack
DeepStack collected $800 from the pot
*** SUMMARY ***
Total pot $800 | Rake $0
Seat 1: DeepStack (big blind) collected ($800)
Seat 2: Taylor_@TaylorvonK (button) (small blind) folded before the Flop

PokerStars Hand #9000200030: Tournament #3, Apr19_2017-at-17_49_47 Hold'em No Limit ($100/$200 USD) - 2017/04/19 19:50:16 ET
Table 'ACPC Match' 2-max Seat #1 is the button
Seat 1: DeepStack ($7027 in chips)
Seat 2: Taylor_@TaylorvonK ($32973 in chips)
DeepStack: posts small blind $100
Taylor_@TaylorvonK: posts big blind $200
*** HOLE CARDS ***
Dealt to DeepStack [6h 9s]
Dealt to Taylor_@TaylorvonK [3h Jc]
DeepStack: raises $200 to $400
Taylor_@TaylorvonK: folds
Uncalled bet ($200) returned to DeepStack
DeepStack collected $400 from the pot
*** SUMMARY ***
Total pot $400 | Rake $0
Seat 1: DeepStack (button) (small blind) collected ($400)
Seat 2: Taylor_@TaylorvonK (big blind) folded before the Flop

PokerStars Hand #9000200031: Tournament #3, Apr19_2017-at-17_49_47 Hold'em No Limit ($150/$300 USD) - 2017/04/19 19:50:17 ET
Table 'ACPC Match' 2-max Seat #2 is the button
Seat 1: DeepStack ($7227 in chips)
Seat 2: Taylor_@TaylorvonK ($32773 in chips)
Taylor_@TaylorvonK: posts small blind $150
DeepStack: posts big blind $300
*** HOLE CARDS ***
Dealt to DeepStack [Ac 9h]
Dealt to Taylor_@TaylorvonK [7h Qs]
Taylor_@TaylorvonK: raises $300 to $600
DeepStack: raises $6627 to $7227 and is all-in
Taylor_@TaylorvonK: folds
Uncalled bet ($6627) returned to DeepStack
DeepStack collected $1200 from the pot
*** SUMMARY ***
Total pot $1200 | Rake $0
Seat 1: DeepStack (big blind) collected ($1200)
Seat 2: Taylor_@TaylorvonK (button) (small blind) folded before the Flop

PokerStars Hand #9000200032: Tournament #3, Apr19_2017-at-17_49_47 Hold'em No Limit ($150/$300 USD) - 2017/04/19 19:50:18 ET
Table 'ACPC Match' 2-max Seat #1 is the button
Seat 1: DeepStack ($7827 in chips)
Seat 2: Taylor_@TaylorvonK ($32173 in chips)
DeepStack: posts small blind $150
Taylor_@TaylorvonK: posts big blind $300
*** HOLE CARDS ***
Dealt to DeepStack [7d Jh]
Dealt to Taylor_@TaylorvonK [6d 9s]
DeepStack: raises $300 to $600
Taylor_@TaylorvonK: folds
Uncalled bet ($300) returned to DeepStack
DeepStack collected $600 from the pot
*** SUMMARY ***
Total pot $600 | Rake $0
Seat 1: DeepStack (button) (small blind) collected ($600)
Seat 2: Taylor_@TaylorvonK (big blind) folded before the Flop

PokerStars Hand #9000200033: Tournament #3, Apr19_2017-at-17_49_47 Hold'em No Limit ($150/$300 USD) - 2017/04/19 19:50:19 ET
Table 'ACPC Match' 2-max Seat #2 is the button
Seat 1: DeepStack ($8127 in chips)
Seat 2: Taylor_@TaylorvonK ($31873 in chips)
Taylor_@TaylorvonK: posts small blind $150
DeepStack: posts big blind $300
*** HOLE CARDS ***
Dealt to DeepStack [9h 7s]
Dealt to Taylor_@TaylorvonK [Th 7h]
Taylor_@TaylorvonK: raises $300 to $600
DeepStack: calls $300
*** FLOP **** [Jc 8s 3c]
DeepStack: checks
Taylor_@TaylorvonK: raises $1444 to $1444
DeepStack: folds
Uncalled bet ($1444) returned to Taylor_@TaylorvonK
Taylor_@TaylorvonK collected $1200 from the pot
*** SUMMARY ***
Total pot $1200 | Rake $0
Board [Jc 8s 3c]
Seat 1: DeepStack (big blind) folded on the Flop
Seat 2: Taylor_@TaylorvonK (button) (small blind) collected ($1200)

PokerStars Hand #9000200034: Tournament #3, Apr19_2017-at-17_49_47 Hold'em No Limit ($150/$300 USD) - 2017/04/19 19:50:20 ET
Table 'ACPC Match' 2-max Seat #1 is the button
Seat 1: DeepStack ($7527 in chips)
Seat 2: Taylor_@TaylorvonK ($32473 in chips)
DeepStack: posts small blind $150
Taylor_@TaylorvonK: posts big blind $300
*** HOLE CARDS ***
Dealt to DeepStack [4s Js]
Dealt to Taylor_@TaylorvonK [6d 2h]
DeepStack: raises $300 to $600
Taylor_@TaylorvonK: folds
Uncalled bet ($300) returned to DeepStack
DeepStack collected $600 from the pot
*** SUMMARY ***
Total pot $600 | Rake $0
Seat 1: DeepStack (button) (small blind) collected ($600)
Seat 2: Taylor_@TaylorvonK (big blind) folded before the Flop

PokerStars Hand #9000200035: Tournament #3, Apr19_2017-at-17_49_47 Hold'em No Limit ($150/$300 USD) - 2017/04/19 19:50:21 ET
Table 'ACPC Match' 2-max Seat #2 is the button
Seat 1: DeepStack ($7827 in chips)
Seat 2: Taylor_@TaylorvonK ($32173 in chips)
Taylor_@TaylorvonK: posts small blind $150
DeepStack: posts big blind $300
*** HOLE CARDS ***
Dealt to DeepStack [9s 7s]
Dealt to Taylor_@TaylorvonK [7d 2h]
Taylor_@TaylorvonK: folds
Uncalled bet ($150) returned to DeepStack
DeepStack collected $300 from the pot
*** SUMMARY ***
Total pot $300 | Rake $0
Seat 1: DeepStack (big blind) collected ($300)
Seat 2: Taylor_@TaylorvonK (button) (small blind) folded before the Flop

PokerStars Hand #9000200036: Tournament #3, Apr19_2017-at-17_49_47 Hold'em No Limit ($150/$300 USD) - 2017/04/19 19:50:22 ET
Table 'ACPC Match' 2-max Seat #1 is the button
Seat 1: DeepStack ($7977 in chips)
Seat 2: Taylor_@TaylorvonK ($32023 in chips)
DeepStack: posts small blind $150
Taylor_@TaylorvonK: posts big blind $300
*** HOLE CARDS ***
Dealt to DeepStack [2s 6d]
Dealt to Taylor_@TaylorvonK [Jh 5h]
DeepStack: folds
Uncalled bet ($150) returned to Taylor_@TaylorvonK
Taylor_@TaylorvonK collected $300 from the pot
*** SUMMARY ***
Total pot $300 | Rake $0
Seat 1: DeepStack (button) (small blind) folded before the Flop
Seat 2: Taylor_@TaylorvonK (big blind) collected ($300)

PokerStars Hand #9000200037: Tournament #3, Apr19_2017-at-17_49_47 Hold'em No Limit ($150/$300 USD) - 2017/04/19 19:50:23 ET
Table 'ACPC Match' 2-max Seat #2 is the button
Seat 1: DeepStack ($7827 in chips)
Seat 2: Taylor_@TaylorvonK ($32173 in chips)
Taylor_@TaylorvonK: posts small blind $150
DeepStack: posts big blind $300
*** HOLE CARDS ***
Dealt to DeepStack [Kh 8h]
Dealt to Taylor_@TaylorvonK [5d 2s]
Taylor_@TaylorvonK: folds
Uncalled bet ($150) returned to DeepStack
DeepStack collected $300 from the pot
*** SUMMARY ***
Total pot $300 | Rake $0
Seat 1: DeepStack (big blind) collected ($300)
Seat 2: Taylor_@TaylorvonK (button) (small blind) folded before the Flop

PokerStars Hand #9000200038: Tournament #3, Apr19_2017-at-17_49_47 Hold'em No Limit ($150/$300 USD) - 2017/04/19 19:50:24 ET
Table 'ACPC Match' 2-max Seat #1 is the button
Seat 1: DeepStack ($7977 in chips)
Seat 2: Taylor_@TaylorvonK ($32023 in chips)
DeepStack: posts small blind $150
Taylor_@TaylorvonK: posts big blind $300
*** HOLE CARDS ***
Dealt to DeepStack [9s Ah]
Dealt to Taylor_@TaylorvonK [8s Tc]
DeepStack: calls $150
Taylor_@TaylorvonK: checks
*** FLOP **** [7s Qh 2s]
Taylor_@TaylorvonK: checks
DeepStack: checks
*** TURN **** [Jd]
Taylor_@TaylorvonK: bets $1444
DeepStack: folds
Uncalled bet ($1444) returned to Taylor_@TaylorvonK
Taylor_@TaylorvonK collected $600 from the pot
*** SUMMARY ***
Total pot $600 | Rake $0
Board [7s Qh 2s Jd]
Seat 1: DeepStack (button) (small blind) folded on the Turn
Seat 2: Taylor_@TaylorvonK (big blind) collected ($600)

PokerStars Hand #9000200039: Tournament #3, Apr19_2017-at-17_49_47 Hold'em No Limit ($150/$300 USD) - 2017/04/19 19:50:25 ET
Table 'ACPC Match' 2-max Seat #2 is the button
Seat 1: DeepStack ($7677 in chips)
Seat 2: Taylor_@TaylorvonK ($32323 in chips)
Taylor_@TaylorvonK: posts small blind $150
DeepStack: posts big blind $300
*** HOLE CARDS ***
Dealt to DeepStack [Qs 4d]
Dealt to Taylor_@TaylorvonK [3d 4c]
Taylor_@TaylorvonK: folds
Uncalled bet ($150) returned to DeepStack
DeepStack collected $300 from the pot
*** SUMMARY ***
Total pot $300 | Rake $0
Seat 1: DeepStack (big blind) collected ($300)
Seat 2: Taylor_@TaylorvonK (button) (small blind) folded before the Flop

PokerStars Hand #9000200040: Tournament #3, Apr19_2017-at-17_49_47 Hold'em No Limit ($150/$300 USD) - 2017/04/19 19:50:26 ET
Table 'ACPC Match' 2-max Seat #1 is the button
Seat 1: DeepStack ($7827 in chips)
Seat 2: Taylor_@TaylorvonK ($32173 in chips)
DeepStack: posts small blind $150
Taylor_@TaylorvonK: posts big blind $300
*** HOLE CARDS ***
Dealt to DeepStack [4d 9h]
Dealt to Taylor_@TaylorvonK [4h Qs]
DeepStack: calls $150
Taylor_@TaylorvonK: checks
*** FLOP **** [Jh 5c Ac]
Taylor_@TaylorvonK: checks
DeepStack: checks
*** TURN **** [4s]
Taylor_@TaylorvonK: bets $300
DeepStack: calls $300
*** RIVER **** [7c]
Taylor_@TaylorvonK: checks
DeepStack: checks
*** SHOW DOWN ***
Taylor_@TaylorvonK: shows [4h Qs] (a pair of Fours)
DeepStack: shows [4d 9h] (a pair of Fours)
Taylor_@TaylorvonK collected $1200 from pot
*** SUMMARY ***
Total pot $1200 | Rake $0
Board [Jh 5c Ac 4s 7c]
Seat 1: DeepStack (button) (small blind) showed [4d 9h] and lost with a pair of Fours
Seat 2: Taylor_@TaylorvonK (big blind) showed [4h Qs] and won ($1200) with a pair of Fours

PokerStars Hand #9000200041: Tournament #3, Apr19_2017-at-17_49_47 Hold'em No Limit ($200/$400 USD) - 2017/04/19 19:50:27 ET
Table 'ACPC Match' 2-max Seat #2 is the button
Seat 1: DeepStack ($7227 in chips)
Seat 2: Taylor_@TaylorvonK ($32773 in chips)
Taylor_@TaylorvonK: posts small blind $200
DeepStack: posts big blind $400
*** HOLE CARDS ***
Dealt to DeepStack [3c Ad]
Dealt to Taylor_@TaylorvonK [4h 2d]
Taylor_@TaylorvonK: folds
Uncalled bet ($200) returned to DeepStack
DeepStack collected $400 from the pot
*** SUMMARY ***
Total pot $400 | Rake $0
Seat 1: DeepStack (big blind) collected ($400)
Seat 2: Taylor_@TaylorvonK (button) (small blind) folded before the Flop

PokerStars Hand #9000200042: Tournament #3, Apr19_2017-at-17_49_47 Hold'em No Limit ($200/$400 USD) - 2017/04/19 19:50:28 ET
Table 'ACPC Match' 2-max Seat #1 is the button
Seat 1: DeepStack ($7427 in chips)
Seat 2: Taylor_@TaylorvonK ($32573 in chips)
DeepStack: posts small blind $200
Taylor_@TaylorvonK: posts big blind $400
*** HOLE CARDS ***
Dealt to DeepStack [Qs 9s]
Dealt to Taylor_@TaylorvonK [Jd 9d]
DeepStack: calls $200
Taylor_@TaylorvonK: checks
*** FLOP **** [4d 8s 3d]
Taylor_@TaylorvonK: checks
DeepStack: checks
*** TURN **** [2d]
Taylor_@TaylorvonK: bets $666
DeepStack: folds
Uncalled bet ($666) returned to Taylor_@TaylorvonK
Taylor_@TaylorvonK collected $800 from the pot
*** SUMMARY ***
Total pot $800 | Rake $0
Board [4d 8s 3d 2d]
Seat 1: DeepStack (button) (small blind) folded on the Turn
Seat 2: Taylor_@TaylorvonK (big blind) collected ($800)

PokerStars Hand #9000200043: Tournament #3, Apr19_2017-at-17_49_47 Hold'em No Limit ($200/$400 USD) - 2017/04/19 19:50:29 ET
Table 'ACPC Match' 2-max Seat #2 is the button
Seat 1: DeepStack ($7027 in chips)
Seat 2: Taylor_@TaylorvonK ($32973 in chips)
Taylor_@TaylorvonK: posts small blind $200
DeepStack: posts big blind $400
*** HOLE CARDS ***
Dealt to DeepStack [Ks Js]
Dealt to Taylor_@TaylorvonK [3d 8c]
Taylor_@TaylorvonK: folds
Uncalled bet ($200) returned to DeepStack
DeepStack collected $400 from the pot
*** SUMMARY ***
Total pot $400 | Rake $0
Seat 1: DeepStack (big blind) collected ($400)
Seat 2: Taylor_@TaylorvonK (button) (small blind) folded before the Flop

PokerStars Hand #9000200044: Tournament #3, Apr19_2017-at-17_49_47 Hold'em No Limit ($200/$400 USD) - 2017/04/19 19:50:30 ET
Table 'ACPC Match' 2-max Seat #1 is the button
Seat 1: DeepStack ($7227 in chips)
Seat 2: Taylor_@TaylorvonK ($32773 in chips)
DeepStack: posts small blind $200
Taylor_@TaylorvonK: posts big blind $400
*** HOLE CARDS ***
Dealt to DeepStack [8h 3s]
Dealt to Taylor_@TaylorvonK [7d 2h]
DeepStack: calls $200
Taylor_@TaylorvonK: checks
*** FLOP **** [4s 8c 9c]
Taylor_@TaylorvonK: checks
DeepStack: raises $400 to $400
Taylor_@TaylorvonK: folds
Uncalled bet ($400) returned to DeepStack
DeepStack collected $800 from the pot
*** SUMMARY ***
Total pot $800 | Rake $0
Board [4s 8c 9c]
Seat 1: DeepStack (button) (small blind) collected ($800)
Seat 2: Taylor_@TaylorvonK (big blind) folded on the Flop

PokerStars Hand #9000200045: Tournament #3, Apr19_2017-at-17_49_47 Hold'em No Limit ($200/$400 USD) - 2017/04/19 19:50:31 ET
Table 'ACPC Match' 2-max Seat #2 is the button
Seat 1: DeepStack ($7627 in chips)
Seat 2: Taylor_@TaylorvonK ($32373 in chips)
Taylor_@TaylorvonK: posts small blind $200
DeepStack: posts big blind $400
*** HOLE CARDS ***
Dealt to DeepStack [5h 2d]
Dealt to Taylor_@TaylorvonK [Kd 7h]
Taylor_@TaylorvonK: raises $400 to $800
DeepStack: folds
Uncalled bet ($400) returned to Taylor_@TaylorvonK
Taylor_@TaylorvonK collected $800 from the pot
*** SUMMARY ***
Total pot $800 | Rake $0
Seat 1: DeepStack (big blind) folded before the Flop
Seat 2: Taylor_@TaylorvonK (button) (small blind) collected ($800)

PokerStars Hand #9000200046: Tournament #3, Apr19_2017-at-17_49_47 Hold'em No Limit ($200/$400 USD) - 2017/04/19 19:50:32 ET
Table 'ACPC Match' 2-max Seat #1 is the button
Seat 1: DeepStack ($7227 in chips)
Seat 2: Taylor_@TaylorvonK ($32773 in chips)
DeepStack: posts small blind $200
Taylor_@TaylorvonK: posts big blind $400
*** HOLE CARDS ***
Dealt to DeepStack [Qh 2d]
Dealt to Taylor_@TaylorvonK [4d 8h]
DeepStack: calls $200
Taylor_@TaylorvonK: raises $1599 to $1999
DeepStack: folds
Uncalled bet ($1599) returned to Taylor_@TaylorvonK
Taylor_@TaylorvonK collected $800 from the pot
*** SUMMARY ***
Total pot $800 | Rake $0
Seat 1: DeepStack (button) (small blind) folded before the Flop
Seat 2: Taylor_@TaylorvonK (big blind) collected ($800)

PokerStars Hand #9000200047: Tournament #3, Apr19_2017-at-17_49_47 Hold'em No Limit ($200/$400 USD) - 2017/04/19 19:50:33 ET
Table 'ACPC Match' 2-max Seat #2 is the button
Seat 1: DeepStack ($6827 in chips)
Seat 2: Taylor_@TaylorvonK ($33173 in chips)
Taylor_@TaylorvonK: posts small blind $200
DeepStack: posts big blind $400
*** HOLE CARDS ***
Dealt to DeepStack [Ts Th]
Dealt to Taylor_@TaylorvonK [3c 5c]
Taylor_@TaylorvonK: raises $400 to $800
DeepStack: raises $800 to $1600
Taylor_@TaylorvonK: folds
Uncalled bet ($800) returned to DeepStack
DeepStack collected $1600 from the pot
*** SUMMARY ***
Total pot $1600 | Rake $0
Seat 1: DeepStack (big blind) collected ($1600)
Seat 2: Taylor_@TaylorvonK (button) (small blind) folded before the Flop

PokerStars Hand #9000200048: Tournament #3, Apr19_2017-at-17_49_47 Hold'em No Limit ($200/$400 USD) - 2017/04/19 19:50:34 ET
Table 'ACPC Match' 2-max Seat #1 is the button
Seat 1: DeepStack ($7627 in chips)
Seat 2: Taylor_@TaylorvonK ($32373 in chips)
DeepStack: posts small blind $200
Taylor_@TaylorvonK: posts big blind $400
*** HOLE CARDS ***
Dealt to DeepStack [3h 2c]
Dealt to Taylor_@TaylorvonK [9c 9s]
DeepStack: folds
Uncalled bet ($200) returned to Taylor_@TaylorvonK
Taylor_@TaylorvonK collected $400 from the pot
*** SUMMARY ***
Total pot $400 | Rake $0
Seat 1: DeepStack (button) (small blind) folded before the Flop
Seat 2: Taylor_@TaylorvonK (big blind) collected ($400)

PokerStars Hand #9000200049: Tournament #3, Apr19_2017-at-17_49_47 Hold'em No Limit ($200/$400 USD) - 2017/04/19 19:50:35 ET
Table 'ACPC Match' 2-max Seat #2 is the button
Seat 1: DeepStack ($7427 in chips)
Seat 2: Taylor_@TaylorvonK ($32573 in chips)
Taylor_@TaylorvonK: posts small blind $200
DeepStack: posts big blind $400
*** HOLE CARDS ***
Dealt to DeepStack [5c 3c]
Dealt to Taylor_@TaylorvonK [Ah As]
Taylor_@TaylorvonK: calls $200
DeepStack: checks
*** FLOP **** [Kc 2s 2d]
DeepStack: bets $400
Taylor_@TaylorvonK: raises $834 to $1234
DeepStack: raises $1634 to $2868
Taylor_@TaylorvonK: calls $1634
*** TURN **** [2c]
DeepStack: checks
Taylor_@TaylorvonK: checks
*** RIVER **** [6h]
DeepStack: checks
Taylor_@TaylorvonK: raises $666 to $666
DeepStack: folds
Uncalled bet ($666) returned to Taylor_@TaylorvonK
Taylor_@TaylorvonK collected $6536 from the pot
*** SUMMARY ***
Total pot $6536 | Rake $0
Board [Kc 2s 2d 2c 6h]
Seat 1: DeepStack (big blind) folded on the River
Seat 2: Taylor_@TaylorvonK (button) (small blind) collected ($6536)

PokerStars Hand #9000200050: Tournament #3, Apr19_2017-at-17_49_47 Hold'em No Limit ($200/$400 USD) - 2017/04/19 19:50:36 ET
Table 'ACPC Match' 2-max Seat #1 is the button
Seat 1: DeepStack ($4159 in chips)
Seat 2: Taylor_@TaylorvonK ($35841 in chips)
DeepStack: posts small blind $200
Taylor_@TaylorvonK: posts big blind $400
*** HOLE CARDS ***
Dealt to DeepStack [9d 6c]
Dealt to Taylor_@TaylorvonK [As 8d]
DeepStack: calls $200
Taylor_@TaylorvonK: raises $35441 to $35841 and is all-in
DeepStack: folds
Uncalled bet ($35441) returned to Taylor_@TaylorvonK
Taylor_@TaylorvonK collected $800 from the pot
*** SUMMARY ***
Total pot $800 | Rake $0
Seat 1: DeepStack (button) (small blind) folded before the Flop
Seat 2: Taylor_@TaylorvonK (big blind) collected ($800)

PokerStars Hand #9000200051: Tournament #3, Apr19_2017-at-17_49_47 Hold'em No Limit ($300/$600 USD) - 2017/04/19 19:50:37 ET
Table 'ACPC Match' 2-max Seat #2 is the button
Seat 1: DeepStack ($3759 in chips)
Seat 2: Taylor_@TaylorvonK ($36241 in chips)
Taylor_@TaylorvonK: posts small blind $300
DeepStack: posts big blind $600
*** HOLE CARDS ***
Dealt to DeepStack [9s Kh]
Dealt to Taylor_@TaylorvonK [Ah Jc]
Taylor_@TaylorvonK: raises $35641 to $36241 and is all-in
DeepStack: calls $3159 and is all-in
Uncalled bet ($32482) returned to Taylor_@TaylorvonK
*** FLOP **** [3d Jh 3s]
*** TURN **** [3h]
*** RIVER **** [Qh]
*** SHOW DOWN ***
Taylor_@TaylorvonK: shows [Ah Jc] (full house, Threes and Jacks)
DeepStack: shows [9s Kh] (three of a kind, Threes)
Taylor_@TaylorvonK collected $7518 from pot
*** SUMMARY ***
Total pot $7518 | Rake $0
Board [3d Jh 3s 3h Qh]
Seat 1: DeepStack (big blind) showed [9s Kh] and lost with three of a kind, Threes
Seat 2: Taylor_@TaylorvonK (button) (small blind) showed [Ah Jc] and won ($7518) with full house, Threes and Jacks
