PokerStars Hand #9000000001: Tournament #1, Apr19_2017-at-16_5_30 Hold'em No Limit ($50/$100 USD) - 2017/04/19 18:05:30 ET
Table 'ACPC Match' 2-max Seat #2 is the button
Seat 1: DeepStack ($20000 in chips)
Seat 2: Taylor_@TaylorvonK ($20000 in chips)
Taylor_@TaylorvonK: posts small blind $50
DeepStack: posts big blind $100
*** HOLE CARDS ***
Dealt to DeepStack [Kh 6s]
Dealt to Taylor_@TaylorvonK [Jd 2d]
Taylor_@TaylorvonK: raises $677 to $777
DeepStack: folds
Uncalled bet ($677) returned to Taylor_@TaylorvonK
Taylor_@TaylorvonK collected $200 from the pot
*** SUMMARY ***
Total pot $200 | Rake $0
Seat 1: DeepStack (big blind) folded before the Flop
Seat 2: Taylor_@TaylorvonK (button) (small blind) collected ($200)

PokerStars Hand #9000000002: Tournament #1, Apr19_2017-at-16_5_30 Hold'em No Limit ($50/$100 USD) - 2017/04/19 18:05:31 ET
Table 'ACPC Match' 2-max Seat #1 is the button
Seat 1: DeepStack ($19900 in chips)
Seat 2: Taylor_@TaylorvonK ($20100 in chips)
DeepStack: posts small blind $50
Taylor_@TaylorvonK: posts big blind $100
*** HOLE CARDS ***
Dealt to DeepStack [Ad Qd]
Dealt to Taylor_@TaylorvonK [Th 9s]
DeepStack: raises $100 to $200
Taylor_@TaylorvonK: calls $100
*** FLOP **** [Kd As 2s]
Taylor_@TaylorvonK: checks
DeepStack: raises $400 to $400
Taylor_@TaylorvonK: folds
Uncalled bet ($400) returned to DeepStack
DeepStack collected $400 from the pot
*** SUMMARY ***
Total pot $400 | Rake $0
Board [Kd As 2s]
Seat 1: DeepStack (button) (small blind) collected ($400)
Seat 2: Taylor_@TaylorvonK (big blind) folded on the Flop

PokerStars Hand #9000000003: Tournament #1, Apr19_2017-at-16_5_30 Hold'em No Limit ($50/$100 USD) - 2017/04/19 18:05:32 ET
Table 'ACPC Match' 2-max Seat #2 is the button
Seat 1: DeepStack ($20100 in chips)
Seat 2: Taylor_@TaylorvonK ($19900 in chips)
Taylor_@TaylorvonK: posts small blind $50
DeepStack: posts big blind $100
*** HOLE CARDS ***
Dealt to DeepStack [8c Jd]
Dealt to Taylor_@TaylorvonK [4s Qd]
Taylor_@TaylorvonK: raises $344 to $444
DeepStack: folds
Uncalled bet ($344) returned to Taylor_@TaylorvonK
Taylor_@TaylorvonK collected $200 from the pot
*** SUMMARY ***
Total pot $200 | Rake $0
Seat 1: DeepStack (big blind) folded before the Flop
Seat 2: Taylor_@TaylorvonK (button) (small blind) collected ($200)

PokerStars Hand #9000000004: Tournament #1, Apr19_2017-at-16_5_30 Hold'em No Limit ($50/$100 USD) - 2017/04/19 18:05:33 ET
Table 'ACPC Match' 2-max Seat #1 is the button
Seat 1: DeepStack ($20000 in chips)
Seat 2: Taylor_@TaylorvonK ($20000 in chips)
DeepStack: posts small blind $50
Taylor_@TaylorvonK: posts big blind $100
*** HOLE CARDS ***
Dealt to DeepStack [Qc Ts]
Dealt to Taylor_@TaylorvonK [3c Ks]
DeepStack: raises $100 to $200
Taylor_@TaylorvonK: raises $1244 to $1444
DeepStack: folds
Uncalled bet ($1244) returned to Taylor_@TaylorvonK
Taylor_@TaylorvonK collected $400 from the pot
*** SUMMARY ***
Total pot $400 | Rake $0
Seat 1: DeepStack (button) (small blind) folded before the Flop
Seat 2: Taylor_@TaylorvonK (big blind) collected ($400)

PokerStars Hand #9000000005: Tournament #1, Apr19_2017-at-16_5_30 Hold'em No Limit ($50/$100 USD) - 2017/04/19 18:05:34 ET
Table 'ACPC Match' 2-max Seat #2 is the button
Seat 1: DeepStack ($19800 in chips)
Seat 2: Taylor_@TaylorvonK ($20200 in chips)
Taylor_@TaylorvonK: posts small blind $50
DeepStack: posts big blind $100
*** HOLE CARDS ***
Dealt to DeepStack [Qh 6d]
Dealt to Taylor_@TaylorvonK [9c Js]
Taylor_@TaylorvonK: raises $100 to $200
DeepStack: calls $100
*** FLOP **** [9s 7d Td]
DeepStack: checks
Taylor_@TaylorvonK: checks
*** TURN **** [4d]
DeepStack: bets $200
Taylor_@TaylorvonK: raises $688 to $888
DeepStack: folds
Uncalled bet ($688) returned to Taylor_@TaylorvonK
Taylor_@TaylorvonK collected $800 from the pot
*** SUMMARY ***
Total pot $800 | Rake $0
Board [9s 7d Td 4d]
Seat 1: DeepStack (big blind) folded on the Turn
Seat 2: Taylor_@TaylorvonK (button) (small blind) collected ($800)

PokerStars Hand #9000000006: Tournament #1, Apr19_2017-at-16_5_30 Hold'em No Limit ($50/$100 USD) - 2017/04/19 18:05:35 ET
Table 'ACPC Match' 2-max Seat #1 is the button
Seat 1: DeepStack ($19400 in chips)
Seat 2: Taylor_@TaylorvonK ($20600 in chips)
DeepStack: posts small blind $50
Taylor_@TaylorvonK: posts big blind $100
*** HOLE CARDS ***
Dealt to DeepStack [Qs Qc]
Dealt to Taylor_@TaylorvonK [5c 6h]
DeepStack: raises $200 to $300
Taylor_@TaylorvonK: calls $200
*** FLOP **** [3c 7h 2d]
Taylor_@TaylorvonK: checks
DeepStack: checks
*** TURN **** [9h]
Taylor_@TaylorvonK: bets $1444
DeepStack: raises $3488 to $4932
Taylor_@TaylorvonK: folds
Uncalled bet ($3488) returned to DeepStack
DeepStack collected $3488 from the pot
*** SUMMARY ***
Total pot $3488 | Rake $0
Board [3c 7h 2d 9h]
Seat 1: DeepStack (button) (small blind) collected ($3488)
Seat 2: Taylor_@TaylorvonK (big blind) folded on the Turn

PokerStars Hand #9000000007: Tournament #1, Apr19_2017-at-16_5_30 Hold'em No Limit ($50/$100 USD) - 2017/04/19 18:05:36 ET
Table 'ACPC Match' 2-max Seat #2 is the button
Seat 1: DeepStack ($21144 in chips)
Seat 2: Taylor_@TaylorvonK ($18856 in chips)
Taylor_@TaylorvonK: posts small blind $50
DeepStack: posts big blind $100
*** HOLE CARDS ***
Dealt to DeepStack [8s 4h]
Dealt to Taylor_@TaylorvonK [Kc 5s]
Taylor_@TaylorvonK: raises $344 to $444
DeepStack: folds
Uncalled bet ($344) returned to Taylor_@TaylorvonK
Taylor_@TaylorvonK collected $200 from the pot
*** SUMMARY ***
Total pot $200 | Rake $0
Seat 1: DeepStack (big blind) folded before the Flop
Seat 2: Taylor_@TaylorvonK (button) (small blind) collected ($200)

PokerStars Hand #9000000008: Tournament #1, Apr19_2017-at-16_5_30 Hold'em No Limit ($50/$100 USD) - 2017/04/19 18:05:37 ET
Table 'ACPC Match' 2-max Seat #1 is the button
Seat 1: DeepStack ($21044 in chips)
Seat 2: Taylor_@TaylorvonK ($18956 in chips)
DeepStack: posts small blind $50
Taylor_@TaylorvonK: posts big blind $100
*** HOLE CARDS ***
Dealt to DeepStack [2d 8h]
Dealt to Taylor_@TaylorvonK [4d Jd]
DeepStack: folds
Uncalled bet ($50) returned to Taylor_@TaylorvonK
Taylor_@TaylorvonK collected $100 from the pot
*** SUMMARY ***
Total pot $100 | Rake $0
Seat 1: DeepStack (button) (small blind) folded before the Flop
Seat 2: Taylor_@TaylorvonK (big blind) collected ($100)

PokerStars Hand #9000000009: Tournament #1, Apr19_2017-at-16_5_30 Hold'em No Limit ($50/$100 USD) - 2017/04/19 18:05:38 ET
Table 'ACPC Match' 2-max Seat #2 is the button
Seat 1: DeepStack ($20994 in chips)
Seat 2: Taylor_@TaylorvonK ($19006 in chips)
Taylor_@TaylorvonK: posts small blind $50
DeepStack: posts big blind $100
*** HOLE CARDS ***
Dealt to DeepStack [3c 5s]
Dealt to Taylor_@TaylorvonK [Js 7s]
Taylor_@TaylorvonK: raises $100 to $200
DeepStack: calls $100
*** FLOP **** [2c Jh Th]
DeepStack: checks
Taylor_@TaylorvonK: checks
*** TURN **** [Ah]
DeepStack: checks
Taylor_@TaylorvonK: raises $188 to $188
DeepStack: folds
Uncalled bet ($188) returned to Taylor_@TaylorvonK
Taylor_@TaylorvonK collected $400 from the pot
*** SUMMARY ***
Total pot $400 | Rake $0
Board [2c Jh Th Ah]
Seat 1: DeepStack (big blind) folded on the Turn
Seat 2: Taylor_@TaylorvonK (button) (small blind) collected ($400)

PokerStars Hand #9000000010: Tournament #1, Apr19_2017-at-16_5_30 Hold'em No Limit ($50/$100 USD) - 2017/04/19 18:05:39 ET
Table 'ACPC Match' 2-max Seat #1 is the button
Seat 1: DeepStack ($20794 in chips)
Seat 2: Taylor_@TaylorvonK ($19206 in chips)
DeepStack: posts small blind $50
Taylor_@TaylorvonK: posts big blind $100
*** HOLE CARDS ***
Dealt to DeepStack [Jd Ts]
Dealt to Taylor_@TaylorvonK [2d 6d]
DeepStack: raises $100 to $200
Taylor_@TaylorvonK: calls $100
*** FLOP **** [4h 3s Qd]
Taylor_@TaylorvonK: checks
DeepStack: checks
*** TURN **** [7d]
Taylor_@TaylorvonK: bets $1666
DeepStack: folds
Uncalled bet ($1666) returned to Taylor_@TaylorvonK
Taylor_@TaylorvonK collected $400 from the pot
*** SUMMARY ***
Total pot $400 | Rake $0
Board [4h 3s Qd 7d]
Seat 1: DeepStack (button) (small blind) folded on the Turn
Seat 2: Taylor_@TaylorvonK (big blind) collected ($400)

PokerStars Hand #9000000011: Tournament #1, Apr19_2017-at-16_5_30 Hold'em No Limit ($75/$150 USD) - 2017/04/19 18:05:40 ET
Table 'ACPC Match' 2-max Seat #2 is the button
Seat 1: DeepStack ($20594 in chips)
Seat 2: Taylor_@TaylorvonK ($19406 in chips)
Taylor_@TaylorvonK: posts small blind $75
DeepStack: posts big blind $150
*** HOLE CARDS ***
Dealt to DeepStack [Jc 5c]
Dealt to Taylor_@TaylorvonK [Td 7d]
Taylor_@TaylorvonK: raises $150 to $300
DeepStack: calls $150
*** FLOP **** [Ks Ad 5d]
DeepStack: checks
Taylor_@TaylorvonK: raises $333 to $333
DeepStack: calls $333
*** TURN **** [Kc]
DeepStack: checks
Taylor_@TaylorvonK: raises $888 to $888
DeepStack: folds
Uncalled bet ($888) returned to Taylor_@TaylorvonK
Taylor_@TaylorvonK collected $1266 from the pot
*** SUMMARY ***
Total pot $1266 | Rake $0
Board [Ks Ad 5d Kc]
Seat 1: DeepStack (big blind) folded on the Turn
Seat 2: Taylor_@TaylorvonK (button) (small blind) collected ($1266)

PokerStars Hand #9000000012: Tournament #1, Apr19_2017-at-16_5_30 Hold'em No Limit ($75/$150 USD) - 2017/04/19 18:05:41 ET
Table 'ACPC Match' 2-max Seat #1 is the button
Seat 1: DeepStack ($19961 in chips)
Seat 2: Taylor_@TaylorvonK ($20039 in chips)
DeepStack: posts small blind $75
Taylor_@TaylorvonK: posts big blind $150
*** HOLE CARDS ***
Dealt to DeepStack [Ks 3h]
Dealt to Taylor_@TaylorvonK [4d Kc]
DeepStack: raises $300 to $450
Taylor_@TaylorvonK: raises $1772 to $2222
DeepStack: folds
Uncalled bet ($1772) returned to Taylor_@TaylorvonK
Taylor_@TaylorvonK collected $900 from the pot
*** SUMMARY ***
Total pot $900 | Rake $0
Seat 1: DeepStack (button) (small blind) folded before the Flop
Seat 2: Taylor_@TaylorvonK (big blind) collected ($900)

PokerStars Hand #9000000013: Tournament #1, Apr19_2017-at-16_5_30 Hold'em No Limit ($75/$150 USD) - 2017/04/19 18:05:42 ET
Table 'ACPC Match' 2-max Seat #2 is the button
Seat 1: DeepStack ($19511 in chips)
Seat 2: Taylor_@TaylorvonK ($20489 in chips)
Taylor_@TaylorvonK: posts small blind $75
DeepStack: posts big blind $150
*** HOLE CARDS ***
Dealt to DeepStack [Th Js]
Dealt to Taylor_@TaylorvonK [Kd Qc]
Taylor_@TaylorvonK: raises $306 to $456
DeepStack: calls $306
*** FLOP **** [4h Jd 9s]
DeepStack: checks
Taylor_@TaylorvonK: raises $2222 to $2222
DeepStack: calls $2222
*** TURN **** [4d]
DeepStack: checks
Taylor_@TaylorvonK: raises $6666 to $6666
DeepStack: calls $6666
*** RIVER **** [Kh]
DeepStack: checks
Taylor_@TaylorvonK: checks
*** SHOW DOWN ***
DeepStack: shows [Th Js] (two pair, Jacks and Fours)
Taylor_@TaylorvonK: shows [Kd Qc] (two pair, Kings and Fours)
Taylor_@TaylorvonK collected $18688 from pot
*** SUMMARY ***
Total pot $18688 | Rake $0
Board [4h Jd 9s 4d Kh]
Seat 1: DeepStack (big blind) showed [Th Js] and lost with two pair, Jacks and Fours
Seat 2: Taylor_@TaylorvonK (button) (small blind) showed [Kd Qc] and won ($18688) with two pair, Kings and Fours

PokerStars Hand #9000000014: Tournament #1, Apr19_2017-at-16_5_30 Hold'em No Limit ($75/$150 USD) - 2017/04/19 18:05:43 ET
Table 'ACPC Match' 2-max Seat #1 is the button
Seat 1: DeepStack ($10167 in chips)
Seat 2: Taylor_@TaylorvonK ($29833 in chips)
DeepStack: posts small blind $75
Taylor_@TaylorvonK: posts big blind $150
*** HOLE CARDS ***
Dealt to DeepStack [3c Kc]
Dealt to Taylor_@TaylorvonK [5s 4s]
DeepStack: calls $75
Taylor_@TaylorvonK: checks
*** FLOP **** [2d Qd 2c]
Taylor_@TaylorvonK: checks
DeepStack: checks
*** TURN **** [Ts]
Taylor_@TaylorvonK: checks
DeepStack: checks
*** RIVER **** [Ks]
Taylor_@TaylorvonK: bets $1234
DeepStack: calls $1234
*** SHOW DOWN ***
Taylor_@TaylorvonK: shows [5s 4s] (a pair of Deuces)
DeepStack: shows [3c Kc] (two pair, Kings and Deuces)
DeepStack collected $2768 from pot
*** SUMMARY ***
Total pot $2768 | Rake $0
Board [2d Qd 2c Ts Ks]
Seat 1: DeepStack (button) (small blind) showed [3c Kc] and won ($2768) with two pair, Kings and Deuces
Seat 2: Taylor_@TaylorvonK (big blind) showed [5s 4s] and lost with a pair of Deuces

PokerStars Hand #9000000015: Tournament #1, Apr19_2017-at-16_5_30 Hold'em No Limit ($75/$150 USD) - 2017/04/19 18:05:44 ET
Table 'ACPC Match' 2-max Seat #2 is the button
Seat 1: DeepStack ($11551 in chips)
Seat 2: Taylor_@TaylorvonK ($28449 in chips)
Taylor_@TaylorvonK: posts small blind $75
DeepStack: posts big blind $150
*** HOLE CARDS ***
Dealt to DeepStack [8h Ad]
Dealt to Taylor_@TaylorvonK [7h 9d]
Taylor_@TaylorvonK: raises $294 to $444
DeepStack: calls $294
*** FLOP **** [2s 5c As]
DeepStack: bets $444
Taylor_@TaylorvonK: raises $1778 to $2222
DeepStack: calls $1778
*** TURN **** [4d]
DeepStack: checks
Taylor_@TaylorvonK: checks
*** RIVER **** [Kc]
DeepStack: checks
Taylor_@TaylorvonK: checks
*** SHOW DOWN ***
DeepStack: shows [8h Ad] (a pair of Aces)
Taylor_@TaylorvonK: shows [7h 9d] (Ace high)
DeepStack collected $5332 from pot
*** SUMMARY ***
Total pot $5332 | Rake $0
Board [2s 5c As 4d Kc]
Seat 1: DeepStack (big blind) showed [8h Ad] and won ($5332) with a pair of Aces
Seat 2: Taylor_@TaylorvonK (button) (small blind) showed [7h 9d] and lost with Ace high

PokerStars Hand #9000000016: Tournament #1, Apr19_2017-at-16_5_30 Hold'em No Limit ($75/$150 USD) - 2017/04/19 18:05:45 ET
Table 'ACPC Match' 2-max Seat #1 is the button
Seat 1: DeepStack ($14217 in chips)
Seat 2: Taylor_@TaylorvonK ($25783 in chips)
DeepStack: posts small blind $75
Taylor_@TaylorvonK: posts big blind $150
*** HOLE CARDS ***
Dealt to DeepStack [8s Jh]
Dealt to Taylor_@TaylorvonK [2d 5h]
DeepStack: raises $150 to $300
Taylor_@TaylorvonK: folds
Uncalled bet ($150) returned to DeepStack
DeepStack collected $300 from the pot
*** SUMMARY ***
Total pot $300 | Rake $0
Seat 1: DeepStack (button) (small blind) collected ($300)
Seat 2: Taylor_@TaylorvonK (big blind) folded before the Flop

PokerStars Hand #9000000017: Tournament #1, Apr19_2017-at-16_5_30 Hold'em No Limit ($75/$150 USD) - 2017/04/19 18:05:46 ET
Table 'ACPC Match' 2-max Seat #2 is the button
Seat 1: DeepStack ($14367 in chips)
Seat 2: Taylor_@TaylorvonK ($25633 in chips)
Taylor_@TaylorvonK: posts small blind $75
DeepStack: posts big blind $150
*** HOLE CARDS ***
Dealt to DeepStack [Tc 7h]
Dealt to Taylor_@TaylorvonK [5d 5s]
Taylor_@TaylorvonK: raises $150 to $300
DeepStack: calls $150
*** FLOP **** [3h Td 8c]
DeepStack: checks
Taylor_@TaylorvonK: raises $300 to $300
DeepStack: calls $300
*** TURN **** [Kd]
DeepStack: checks
Taylor_@TaylorvonK: checks
*** RIVER **** [Jh]
DeepStack: bets $600
Taylor_@TaylorvonK: folds
Uncalled bet ($600) returned to DeepStack
DeepStack collected $1200 from the pot
*** SUMMARY ***
Total pot $1200 | Rake $0
Board [3h Td 8c Kd Jh]
Seat 1: DeepStack (big blind) collected ($1200)
Seat 2: Taylor_@TaylorvonK (button) (small blind) folded on the River

PokerStars Hand #9000000018: Tournament #1, Apr19_2017-at-16_5_30 Hold'em No Limit ($75/$150 USD) - 2017/04/19 18:05:47 ET
Table 'ACPC Match' 2-max Seat #1 is the button
Seat 1: DeepStack ($14967 in chips)
Seat 2: Taylor_@TaylorvonK ($25033 in chips)
DeepStack: posts small blind $75
Taylor_@TaylorvonK: posts big blind $150
*** HOLE CARDS ***
Dealt to DeepStack [6h 8c]
Dealt to Taylor_@TaylorvonK [8d 2d]
DeepStack: raises $300 to $450
Taylor_@TaylorvonK: calls $300
*** FLOP **** [7d 2h Kh]
Taylor_@TaylorvonK: checks
DeepStack: raises $450 to $450
Taylor_@TaylorvonK: raises $1327 to $1777
DeepStack: folds
Uncalled bet ($1327) returned to Taylor_@TaylorvonK
Taylor_@TaylorvonK collected $1800 from the pot
*** SUMMARY ***
Total pot $1800 | Rake $0
Board [7d 2h Kh]
Seat 1: DeepStack (button) (small blind) folded on the Flop
Seat 2: Taylor_@TaylorvonK (big blind) collected ($1800)

PokerStars Hand #9000000019: Tournament #1, Apr19_2017-at-16_5_30 Hold'em No Limit ($75/$150 USD) - 2017/04/19 18:05:48 ET
Table 'ACPC Match' 2-max Seat #2 is the button
Seat 1: DeepStack ($14067 in chips)
Seat 2: Taylor_@TaylorvonK ($25933 in chips)
Taylor_@TaylorvonK: posts small blind $75
DeepStack: posts big blind $150
*** HOLE CARDS ***
Dealt to DeepStack [Td 2c]
Dealt to Taylor_@TaylorvonK [3d 8s]
Taylor_@TaylorvonK: raises $150 to $300
DeepStack: folds
Uncalled bet ($150) returned to Taylor_@TaylorvonK
Taylor_@TaylorvonK collected $300 from the pot
*** SUMMARY ***
Total pot $300 | Rake $0
Seat 1: DeepStack (big blind) folded before the Flop
Seat 2: Taylor_@TaylorvonK (button) (small blind) collected ($300)

PokerStars Hand #9000000020: Tournament #1, Apr19_2017-at-16_5_30 Hold'em No Limit ($75/$150 USD) - 2017/04/19 18:05:49 ET
Table 'ACPC Match' 2-max Seat #1 is the button
Seat 1: DeepStack ($13917 in chips)
Seat 2: Taylor_@TaylorvonK ($26083 in chips)
DeepStack: posts small blind $75
Taylor_@TaylorvonK: posts big blind $150
*** HOLE CARDS ***
Dealt to DeepStack [3s 9c]
Dealt to Taylor_@TaylorvonK [3c 3h]
DeepStack: folds
Uncalled bet ($75) returned to Taylor_@TaylorvonK
Taylor_@TaylorvonK collected $150 from the pot
*** SUMMARY ***
Total pot $150 | Rake $0
Seat 1: DeepStack (button) (small blind) folded before the Flop
Seat 2: Taylor_@TaylorvonK (big blind) collected ($150)

PokerStars Hand #9000000021: Tournament #1, Apr19_2017-at-16_5_30 Hold'em No Limit ($100/$200 USD) - 2017/04/19 18:05:50 ET
Table 'ACPC Match' 2-max Seat #2 is the button
Seat 1: DeepStack ($13842 in chips)
Seat 2: Taylor_@TaylorvonK ($26158 in chips)
Taylor_@TaylorvonK: posts small blind $100
DeepStack: posts big blind $200
*** HOLE CARDS ***
Dealt to DeepStack [Kc 5d]
Dealt to Taylor_@TaylorvonK [8s Ks]
Taylor_@TaylorvonK: raises $355 to $555
DeepStack: calls $355
*** FLOP **** [4s 2c Qh]
DeepStack: checks
Taylor_@TaylorvonK: raises $345 to $345
DeepStack: calls $345
*** TURN **** [9c]
DeepStack: checks
Taylor_@TaylorvonK: checks
*** RIVER **** [7s]
DeepStack: bets $900
Taylor_@TaylorvonK: folds
Uncalled bet ($900) returned to DeepStack
DeepStack collected $1800 from the pot
*** SUMMARY ***
Total pot $1800 | Rake $0
Board [4s 2c Qh 9c 7s]
Seat 1: DeepStack (big blind) collected ($1800)
Seat 2: Taylor_@TaylorvonK (button) (small blind) folded on the River

PokerStars Hand #9000000022: Tournament #1, Apr19_2017-at-16_5_30 Hold'em No Limit ($100/$200 USD) - 2017/04/19 18:05:51 ET
Table 'ACPC Match' 2-max Seat #1 is the button
Seat 1: DeepStack ($14742 in chips)
Seat 2: Taylor_@TaylorvonK ($25258 in chips)
DeepStack: posts small blind $100
Taylor_@TaylorvonK: posts big blind $200
*** HOLE CARDS ***
Dealt to DeepStack [8c 3s]
Dealt to Taylor_@TaylorvonK [Tc 2s]
DeepStack: folds
Uncalled bet ($100) returned to Taylor_@TaylorvonK
Taylor_@TaylorvonK collected $200 from the pot
*** SUMMARY ***
Total pot $200 | Rake $0
Seat 1: DeepStack (button) (small blind) folded before the Flop
Seat 2: Taylor_@TaylorvonK (big blind) collected ($200)

PokerStars Hand #9000000023: Tournament #1, Apr19_2017-at-16_5_30 Hold'em No Limit ($100/$200 USD) - 2017/04/19 18:05:52 ET
Table 'ACPC Match' 2-max Seat #2 is the button
Seat 1: DeepStack ($14642 in chips)
Seat 2: Taylor_@TaylorvonK ($25358 in chips)
Taylor_@TaylorvonK: posts small blind $100
DeepStack: posts big blind $200
*** HOLE CARDS ***
Dealt to DeepStack [8d Qc]
Dealt to Taylor_@TaylorvonK [Jh 3h]
Taylor_@TaylorvonK: raises $200 to $400
DeepStack: calls $200
*** FLOP **** [Jd Qs 4c]
DeepStack: bets $800
Taylor_@TaylorvonK: folds
Uncalled bet ($800) returned to DeepStack
DeepStack collected $800 from the pot
*** SUMMARY ***
Total pot $800 | Rake $0
Board [Jd Qs 4c]
Seat 1: DeepStack (big blind) collected ($800)
Seat 2: Taylor_@TaylorvonK (button) (small blind) folded on the Flop

PokerStars Hand #9000000024: Tournament #1, Apr19_2017-at-16_5_30 Hold'em No Limit ($100/$200 USD) - 2017/04/19 18:05:53 ET
Table 'ACPC Match' 2-max Seat #1 is the button
Seat 1: DeepStack ($15042 in chips)
Seat 2: Taylor_@TaylorvonK ($24958 in chips)
DeepStack: posts small blind $100
Taylor_@TaylorvonK: posts big blind $200
*** HOLE CARDS ***
Dealt to DeepStack [Kd 8h]
Dealt to Taylor_@TaylorvonK [4d 5d]
DeepStack: raises $400 to $600
Taylor_@TaylorvonK: calls $400
*** FLOP **** [7d Kh 9h]
Taylor_@TaylorvonK: checks
DeepStack: raises $600 to $600
Taylor_@TaylorvonK: folds
Uncalled bet ($600) returned to DeepStack
DeepStack collected $1200 from the pot
*** SUMMARY ***
Total pot $1200 | Rake $0
Board [7d Kh 9h]
Seat 1: DeepStack (button) (small blind) collected ($1200)
Seat 2: Taylor_@TaylorvonK (big blind) folded on the Flop

PokerStars Hand #9000000025: Tournament #1, Apr19_2017-at-16_5_30 Hold'em No Limit ($100/$200 USD) - 2017/04/19 18:05:54 ET
Table 'ACPC Match' 2-max Seat #2 is the button
Seat 1: DeepStack ($15642 in chips)
Seat 2: Taylor_@TaylorvonK ($24358 in chips)
Taylor_@TaylorvonK: posts small blind $100
DeepStack: posts big blind $200
*** HOLE CARDS ***
Dealt to DeepStack [3d Kd]
Dealt to Taylor_@TaylorvonK [4c Ac]
Taylor_@TaylorvonK: raises $200 to $400
DeepStack: calls $200
*** FLOP **** [7d 5h Qs]
DeepStack: checks
Taylor_@TaylorvonK: checks
*** TURN **** [Ks]
DeepStack: bets $400
Taylor_@TaylorvonK: folds
Uncalled bet ($400) returned to DeepStack
DeepStack collected $800 from the pot
*** SUMMARY ***
Total pot $800 | Rake $0
Board [7d 5h Qs Ks]
Seat 1: DeepStack (big blind) collected ($800)
Seat 2: Taylor_@TaylorvonK (button) (small blind) folded on the Turn

PokerStars Hand #9000000026: Tournament #1, Apr19_2017-at-16_5_30 Hold'em No Limit ($100/$200 USD) - 2017/04/19 18:05:55 ET
Table 'ACPC Match' 2-max Seat #1 is the button
Seat 1: DeepStack ($16042 in chips)
Seat 2: Taylor_@TaylorvonK ($23958 in chips)
DeepStack: posts small blind $100
Taylor_@TaylorvonK: posts big blind $200
*** HOLE CARDS ***
Dealt to DeepStack [7s 9d]
Dealt to Taylor_@TaylorvonK [4d Kd]
DeepStack: raises $200 to $400
Taylor_@TaylorvonK: raises $1822 to $2222
DeepStack: folds
Uncalled bet ($1822) returned to Taylor_@TaylorvonK
Taylor_@TaylorvonK collected $800 from the pot
*** SUMMARY ***
Total pot $800 | Rake $0
Seat 1: DeepStack (button) (small blind) folded before the Flop
Seat 2: Taylor_@TaylorvonK (big blind) collected ($800)

PokerStars Hand #9000000027: Tournament #1, Apr19_2017-at-16_5_30 Hold'em No Limit ($100/$200 USD) - 2017/04/19 18:05:56 ET
Table 'ACPC Match' 2-max Seat #2 is the button
Seat 1: DeepStack ($15642 in chips)
Seat 2: Taylor_@TaylorvonK ($24358 in chips)
Taylor_@TaylorvonK: posts small blind $100
DeepStack: posts big blind $200
*** HOLE CARDS ***
Dealt to DeepStack [Ks Qs]
Dealt to Taylor_@TaylorvonK [Js 6h]
Taylor_@TaylorvonK: raises $688 to $888
DeepStack: raises $1776 to $2664
Taylor_@TaylorvonK: folds
Uncalled bet ($1776) returned to DeepStack
DeepStack collected $1776 from the pot
*** SUMMARY ***
Total pot $1776 | Rake $0
Seat 1: DeepStack (big blind) collected ($1776)
Seat 2: Taylor_@TaylorvonK (button) (small blind) folded before the Flop

PokerStars Hand #9000000028: Tournament #1, Apr19_2017-at-16_5_30 Hold'em No Limit ($100/$200 USD) - 2017/04/19 18:05:57 ET
Table 'ACPC Match' 2-max Seat #1 is the button
Seat 1: DeepStack ($16530 in chips)
Seat 2: Taylor_@TaylorvonK ($23470 in chips)
DeepStack: posts small blind $100
Taylor_@TaylorvonK: posts big blind $200
*** HOLE CARDS ***
Dealt to DeepStack [6d 6s]
Dealt to Taylor_@TaylorvonK [Td 4s]
DeepStack: raises $200 to $400
Taylor_@TaylorvonK: folds
Uncalled bet ($200) returned to DeepStack
DeepStack collected $400 from the pot
*** SUMMARY ***
Total pot $400 | Rake $0
Seat 1: DeepStack (button) (small blind) collected ($400)
Seat 2: Taylor_@TaylorvonK (big blind) folded before the Flop

PokerStars Hand #9000000029: Tournament #1, Apr19_2017-at-16_5_30 Hold'em No Limit ($100/$200 USD) - 2017/04/19 18:05:58 ET
Table 'ACPC Match' 2-max Seat #2 is the button
Seat 1: DeepStack ($16730 in chips)
Seat 2: Taylor_@TaylorvonK ($23270 in chips)
Taylor_@TaylorvonK: posts small blind $100
DeepStack: posts big blind $200
*** HOLE CARDS ***
Dealt to DeepStack [2d Ks]
Dealt to Taylor_@TaylorvonK [Kc Ad]
Taylor_@TaylorvonK: raises $688 to $888
DeepStack: folds
Uncalled bet ($688) returned to Taylor_@TaylorvonK
Taylor_@TaylorvonK collected $400 from the pot
*** SUMMARY ***
Total pot $400 | Rake $0
Seat 1: DeepStack (big blind) folded before the Flop
Seat 2: Taylor_@TaylorvonK (button) (small blind) collected ($400)

PokerStars Hand #9000000030: Tournament #1, Apr19_2017-at-16_5_30 Hold'em No Limit ($100/$200 USD) - 2017/04/19 18:05:59 ET
Table 'ACPC Match' 2-max Seat #1 is the button
Seat 1: DeepStack ($16530 in chips)
Seat 2: Taylor_@TaylorvonK ($23470 in chips)
DeepStack: posts small blind $100
Taylor_@TaylorvonK: posts big blind $200
*** HOLE CARDS ***
Dealt to DeepStack [5s Jh]
Dealt to Taylor_@TaylorvonK [Ah 2s]
DeepStack: calls $100
Taylor_@TaylorvonK: checks
*** FLOP **** [6c Ac Tc]
Taylor_@TaylorvonK: checks
DeepStack: checks
*** TURN **** [9c]
Taylor_@TaylorvonK: bets $200
DeepStack: folds
Uncalled bet ($200) returned to Taylor_@TaylorvonK
Taylor_@TaylorvonK collected $400 from the pot
*** SUMMARY ***
Total pot $400 | Rake $0
Board [6c Ac Tc 9c]
Seat 1: DeepStack (button) (small blind) folded on the Turn
Seat 2: Taylor_@TaylorvonK (big blind) collected ($400)

PokerStars Hand #9000000031: Tournament #1, Apr19_2017-at-16_5_30 Hold'em No Limit ($150/$300 USD) - 2017/04/19 18:06:00 ET
Table 'ACPC Match' 2-max Seat #2 is the button
Seat 1: DeepStack ($16330 in chips)
Seat 2: Taylor_@TaylorvonK ($23670 in chips)
Taylor_@TaylorvonK: posts small blind $150
DeepStack: posts big blind $300
*** HOLE CARDS ***
Dealt to DeepStack [5d 5s]
Dealt to Taylor_@TaylorvonK [6h 3s]
Taylor_@TaylorvonK: raises $300 to $600
DeepStack: raises $600 to $1200
Taylor_@TaylorvonK: folds
Uncalled bet ($600) returned to DeepStack
DeepStack collected $1200 from the pot
*** SUMMARY ***
Total pot $1200 | Rake $0
Seat 1: DeepStack (big blind) collected ($1200)
Seat 2: Taylor_@TaylorvonK (button) (small blind) folded before the Flop

PokerStars Hand #9000000032: Tournament #1, Apr19_2017-at-16_5_30 Hold'em No Limit ($150/$300 USD) - 2017/04/19 18:06:01 ET
Table 'ACPC Match' 2-max Seat #1 is the button
Seat 1: DeepStack ($16930 in chips)
Seat 2: Taylor_@TaylorvonK ($23070 in chips)
DeepStack: posts small blind $150
Taylor_@TaylorvonK: posts big blind $300
*** HOLE CARDS ***
Dealt to DeepStack [Jh 9h]
Dealt to Taylor_@TaylorvonK [4c 4d]
DeepStack: raises $600 to $900
Taylor_@TaylorvonK: calls $600
*** FLOP **** [8d 4s 3d]
Taylor_@TaylorvonK: checks
DeepStack: checks
*** TURN **** [Qs]
Taylor_@TaylorvonK: bets $3333
DeepStack: folds
Uncalled bet ($3333) returned to Taylor_@TaylorvonK
Taylor_@TaylorvonK collected $1800 from the pot
*** SUMMARY ***
Total pot $1800 | Rake $0
Board [8d 4s 3d Qs]
Seat 1: DeepStack (button) (small blind) folded on the Turn
Seat 2: Taylor_@TaylorvonK (big blind) collected ($1800)

PokerStars Hand #9000000033: Tournament #1, Apr19_2017-at-16_5_30 Hold'em No Limit ($150/$300 USD) - 2017/04/19 18:06:02 ET
Table 'ACPC Match' 2-max Seat #2 is the button
Seat 1: DeepStack ($16030 in chips)
Seat 2: Taylor_@TaylorvonK ($23970 in chips)
Taylor_@TaylorvonK: posts small blind $150
DeepStack: posts big blind $300
*** HOLE CARDS ***
Dealt to DeepStack [4h 9c]
Dealt to Taylor_@TaylorvonK [3h 4s]
Taylor_@TaylorvonK: folds
Uncalled bet ($150) returned to DeepStack
DeepStack collected $300 from the pot
*** SUMMARY ***
Total pot $300 | Rake $0
Seat 1: DeepStack (big blind) collected ($300)
Seat 2: Taylor_@TaylorvonK (button) (small blind) folded before the Flop

PokerStars Hand #9000000034: Tournament #1, Apr19_2017-at-16_5_30 Hold'em No Limit ($150/$300 USD) - 2017/04/19 18:06:03 ET
Table 'ACPC Match' 2-max Seat #1 is the button
Seat 1: DeepStack ($16180 in chips)
Seat 2: Taylor_@TaylorvonK ($23820 in chips)
DeepStack: posts small blind $150
Taylor_@TaylorvonK: posts big blind $300
*** HOLE CARDS ***
Dealt to DeepStack [Qd 9s]
Dealt to Taylor_@TaylorvonK [4d Ac]
DeepStack: calls $150
Taylor_@TaylorvonK: checks
*** FLOP **** [4c 9h 2d]
Taylor_@TaylorvonK: checks
DeepStack: raises $600 to $600
Taylor_@TaylorvonK: calls $600
*** TURN **** [Js]
Taylor_@TaylorvonK: checks
DeepStack: raises $900 to $900
Taylor_@TaylorvonK: folds
Uncalled bet ($900) returned to DeepStack
DeepStack collected $1800 from the pot
*** SUMMARY ***
Total pot $1800 | Rake $0
Board [4c 9h 2d Js]
Seat 1: DeepStack (button) (small blind) collected ($1800)
Seat 2: Taylor_@TaylorvonK (big blind) folded on the Turn

PokerStars Hand #9000000035: Tournament #1, Apr19_2017-at-16_5_30 Hold'em No Limit ($150/$300 USD) - 2017/04/19 18:06:04 ET
Table 'ACPC Match' 2-max Seat #2 is the button
Seat 1: DeepStack ($17080 in chips)
Seat 2: Taylor_@TaylorvonK ($22920 in chips)
Taylor_@TaylorvonK: posts small blind $150
DeepStack: posts big blind $300
*** HOLE CARDS ***
Dealt to DeepStack [Kh 5c]
Dealt to Taylor_@TaylorvonK [8h Js]
Taylor_@TaylorvonK: raises $1144 to $1444
DeepStack: folds
Uncalled bet ($1144) returned to Taylor_@TaylorvonK
Taylor_@TaylorvonK collected $600 from the pot
*** SUMMARY ***
Total pot $600 | Rake $0
Seat 1: DeepStack (big blind) folded before the Flop
Seat 2: Taylor_@TaylorvonK (button) (small blind) collected ($600)

PokerStars Hand #9000000036: Tournament #1, Apr19_2017-at-16_5_30 Hold'em No Limit ($150/$300 USD) - 2017/04/19 18:06:05 ET
Table 'ACPC Match' 2-max Seat #1 is the button
Seat 1: DeepStack ($16780 in chips)
Seat 2: Taylor_@TaylorvonK ($23220 in chips)
DeepStack: posts small blind $150
Taylor_@TaylorvonK: posts big blind $300
*** HOLE CARDS ***
Dealt to DeepStack [Qd 2h]
Dealt to Taylor_@TaylorvonK [9c 8h]
DeepStack: raises $600 to $900
Taylor_@TaylorvonK: calls $600
*** FLOP **** [9d 9h Ac]
Taylor_@TaylorvonK: checks
DeepStack: checks
*** TURN **** [2s]
Taylor_@TaylorvonK: bets $1234
DeepStack: calls $1234
*** RIVER **** [5d]
Taylor_@TaylorvonK: bets $2346
DeepStack: calls $2346
*** SHOW DOWN ***
Taylor_@TaylorvonK: shows [9c 8h] (three of a kind, Nines)
DeepStack: shows [Qd 2h] (two pair, Nines and Deuces)
Taylor_@TaylorvonK collected $8960 from pot
*** SUMMARY ***
Total pot $8960 | Rake $0
Board [9d 9h Ac 2s 5d]
Seat 1: DeepStack (button) (small blind) showed [Qd 2h] and lost with two pair, Nines and Deuces
Seat 2: Taylor_@TaylorvonK (big blind) showed [9c 8h] and won ($8960) with three of a kind, Nines

PokerStars Hand #9000000037: Tournament #1, Apr19_2017-at-16_5_30 Hold'em No Limit ($150/$300 USD) - 2017/04/19 18:06:06 ET
Table 'ACPC Match' 2-max Seat #2 is the button
Seat 1: DeepStack ($12300 in chips)
Seat 2: Taylor_@TaylorvonK ($27700 in chips)
Taylor_@TaylorvonK: posts small blind $150
DeepStack: posts big blind $300
*** HOLE CARDS ***
Dealt to DeepStack [As 8d]
Dealt to Taylor_@TaylorvonK [2h 2c]
Taylor_@TaylorvonK: raises $588 to $888
DeepStack: raises $1776 to $2664
Taylor_@TaylorvonK: raises $25036 to $27700 and is all-in
DeepStack: folds
Uncalled bet ($25036) returned to Taylor_@TaylorvonK
Taylor_@TaylorvonK collected $5328 from the pot
*** SUMMARY ***
Total pot $5328 | Rake $0
Seat 1: DeepStack (big blind) folded before the Flop
Seat 2: Taylor_@TaylorvonK (button) (small blind) collected ($5328)

PokerStars Hand #9000000038: Tournament #1, Apr19_2017-at-16_5_30 Hold'em No Limit ($150/$300 USD) - 2017/04/19 18:06:07 ET
Table 'ACPC Match' 2-max Seat #1 is the button
Seat 1: DeepStack ($9636 in chips)
Seat 2: Taylor_@TaylorvonK ($30364 in chips)
DeepStack: posts small blind $150
Taylor_@TaylorvonK: posts big blind $300
*** HOLE CARDS ***
Dealt to DeepStack [Qd 4s]
Dealt to Taylor_@TaylorvonK [4d 5c]
DeepStack: raises $300 to $600
Taylor_@TaylorvonK: calls $300
*** FLOP **** [Ah 2c Kc]
Taylor_@TaylorvonK: checks
DeepStack: checks
*** TURN **** [8d]
Taylor_@TaylorvonK: bets $3339
DeepStack: folds
Uncalled bet ($3339) returned to Taylor_@TaylorvonK
Taylor_@TaylorvonK collected $1200 from the pot
*** SUMMARY ***
Total pot $1200 | Rake $0
Board [Ah 2c Kc 8d]
Seat 1: DeepStack (button) (small blind) folded on the Turn
Seat 2: Taylor_@TaylorvonK (big blind) collected ($1200)

PokerStars Hand #9000000039: Tournament #1, Apr19_2017-at-16_5_30 Hold'em No Limit ($150/$300 USD) - 2017/04/19 18:06:08 ET
Table 'ACPC Match' 2-max Seat #2 is the button
Seat 1: DeepStack ($9036 in chips)
Seat 2: Taylor_@TaylorvonK ($30964 in chips)
Taylor_@TaylorvonK: posts small blind $150
DeepStack: posts big blind $300
*** HOLE CARDS ***
Dealt to DeepStack [7s 4d]
Dealt to Taylor_@TaylorvonK [Ks 6h]
Taylor_@TaylorvonK: raises $699 to $999
DeepStack: folds
Uncalled bet ($699) returned to Taylor_@TaylorvonK
Taylor_@TaylorvonK collected $600 from the pot
*** SUMMARY ***
Total pot $600 | Rake $0
Seat 1: DeepStack (big blind) folded before the Flop
Seat 2: Taylor_@TaylorvonK (button) (small blind) collected ($600)

PokerStars Hand #9000000040: Tournament #1, Apr19_2017-at-16_5_30 Hold'em No Limit ($150/$300 USD) - 2017/04/19 18:06:09 ET
Table 'ACPC Match' 2-max Seat #1 is the button
Seat 1: DeepStack ($8736 in chips)
Seat 2: Taylor_@TaylorvonK ($31264 in chips)
DeepStack: posts small blind $150
Taylor_@TaylorvonK: posts big blind $300
*** HOLE CARDS ***
Dealt to DeepStack [3h 2d]
Dealt to Taylor_@TaylorvonK [Js 3c]
DeepStack: folds
Uncalled bet ($150) returned to Taylor_@TaylorvonK
Taylor_@TaylorvonK collected $300 from the pot
*** SUMMARY ***
Total pot $300 | Rake $0
Seat 1: DeepStack (button) (small blind) folded before the Flop
Seat 2: Taylor_@TaylorvonK (big blind) collected ($300)

PokerStars Hand #9000000041: Tournament #1, Apr19_2017-at-16_5_30 Hold'em No Limit ($200/$400 USD) - 2017/04/19 18:06:10 ET
Table 'ACPC Match' 2-max Seat #2 is the button
Seat 1: DeepStack ($8586 in chips)
Seat 2: Taylor_@TaylorvonK ($31414 in chips)
Taylor_@TaylorvonK: posts small blind $200
DeepStack: posts big blind $400
*** HOLE CARDS ***
Dealt to DeepStack [Jh 3c]
Dealt to Taylor_@TaylorvonK [Jd Jc]
Taylor_@TaylorvonK: raises $599 to $999
DeepStack: folds
Uncalled bet ($599) returned to Taylor_@TaylorvonK
Taylor_@TaylorvonK collected $800 from the pot
*** SUMMARY ***
Total pot $800 | Rake $0
Seat 1: DeepStack (big blind) folded before the Flop
Seat 2: Taylor_@TaylorvonK (button) (small blind) collected ($800)

PokerStars Hand #9000000042: Tournament #1, Apr19_2017-at-16_5_30 Hold'em No Limit ($200/$400 USD) - 2017/04/19 18:06:11 ET
Table 'ACPC Match' 2-max Seat #1 is the button
Seat 1: DeepStack ($8186 in chips)
Seat 2: Taylor_@TaylorvonK ($31814 in chips)
DeepStack: posts small blind $200
Taylor_@TaylorvonK: posts big blind $400
*** HOLE CARDS ***
Dealt to DeepStack [Jd Qc]
Dealt to Taylor_@TaylorvonK [8d 9h]
DeepStack: calls $200
Taylor_@TaylorvonK: raises $1945 to $2345
DeepStack: calls $1945
*** FLOP **** [6s 5c 3s]
Taylor_@TaylorvonK: checks
DeepStack: checks
*** TURN **** [8c]
Taylor_@TaylorvonK: checks
DeepStack: checks
*** RIVER **** [As]
Taylor_@TaylorvonK: checks
DeepStack: checks
*** SHOW DOWN ***
Taylor_@TaylorvonK: shows [8d 9h] (a pair of Eights)
DeepStack: shows [Jd Qc] (Ace high)
Taylor_@TaylorvonK collected $4690 from pot
*** SUMMARY ***
Total pot $4690 | Rake $0
Board [6s 5c 3s 8c As]
Seat 1: DeepStack (button) (small blind) showed [Jd Qc] and lost with Ace high
Seat 2: Taylor_@TaylorvonK (big blind) showed [8d 9h] and won ($4690) with a pair of Eights

PokerStars Hand #9000000043: Tournament #1, Apr19_2017-at-16_5_30 Hold'em No Limit ($200/$400 USD) - 2017/04/19 18:06:12 ET
Table 'ACPC Match' 2-max Seat #2 is the button
Seat 1: DeepStack ($5841 in chips)
Seat 2: Taylor_@TaylorvonK ($34159 in chips)
Taylor_@TaylorvonK: posts small blind $200
DeepStack: posts big blind $400
*** HOLE CARDS ***
Dealt to DeepStack [3d Js]
Dealt to Taylor_@TaylorvonK [Ks 3c]
Taylor_@TaylorvonK: raises $599 to $999
DeepStack: folds
Uncalled bet ($599) returned to Taylor_@TaylorvonK
Taylor_@TaylorvonK collected $800 from the pot
*** SUMMARY ***
Total pot $800 | Rake $0
Seat 1: DeepStack (big blind) folded before the Flop
Seat 2: Taylor_@TaylorvonK (button) (small blind) collected ($800)

PokerStars Hand #9000000044: Tournament #1, Apr19_2017-at-16_5_30 Hold'em No Limit ($200/$400 USD) - 2017/04/19 18:06:13 ET
Table 'ACPC Match' 2-max Seat #1 is the button
Seat 1: DeepStack ($5441 in chips)
Seat 2: Taylor_@TaylorvonK ($34559 in chips)
DeepStack: posts small blind $200
Taylor_@TaylorvonK: posts big blind $400
*** HOLE CARDS ***
Dealt to DeepStack [Ac 7d]
Dealt to Taylor_@TaylorvonK [Qd 8h]
DeepStack: raises $5041 to $5441 and is all-in
Taylor_@TaylorvonK: folds
Uncalled bet ($5041) returned to DeepStack
DeepStack collected $800 from the pot
*** SUMMARY ***
Total pot $800 | Rake $0
Seat 1: DeepStack (button) (small blind) collected ($800)
Seat 2: Taylor_@TaylorvonK (big blind) folded before the Flop

PokerStars Hand #9000000045: Tournament #1, Apr19_2017-at-16_5_30 Hold'em No Limit ($200/$400 USD) - 2017/04/19 18:06:14 ET
Table 'ACPC Match' 2-max Seat #2 is the button
Seat 1: DeepStack ($5841 in chips)
Seat 2: Taylor_@TaylorvonK ($34159 in chips)
Taylor_@TaylorvonK: posts small blind $200
DeepStack: posts big blind $400
*** HOLE CARDS ***
Dealt to DeepStack [3d 2h]
Dealt to Taylor_@TaylorvonK [6s 4h]
Taylor_@TaylorvonK: folds
Uncalled bet ($200) returned to DeepStack
DeepStack collected $400 from the pot
*** SUMMARY ***
Total pot $400 | Rake $0
Seat 1: DeepStack (big blind) collected ($400)
Seat 2: Taylor_@TaylorvonK (button) (small blind) folded before the Flop

PokerStars Hand #9000000046: Tournament #1, Apr19_2017-at-16_5_30 Hold'em No Limit ($200/$400 USD) - 2017/04/19 18:06:15 ET
Table 'ACPC Match' 2-max Seat #1 is the button
Seat 1: DeepStack ($6041 in chips)
Seat 2: Taylor_@TaylorvonK ($33959 in chips)
DeepStack: posts small blind $200
Taylor_@TaylorvonK: posts big blind $400
*** HOLE CARDS ***
Dealt to DeepStack [Qd 3s]
Dealt to Taylor_@TaylorvonK [Ac 3h]
DeepStack: calls $200
Taylor_@TaylorvonK: raises $33559 to $33959 and is all-in
DeepStack: folds
Uncalled bet ($33559) returned to Taylor_@TaylorvonK
Taylor_@TaylorvonK collected $800 from the pot
*** SUMMARY ***
Total pot $800 | Rake $0
Seat 1: DeepStack (button) (small blind) folded before the Flop
Seat 2: Taylor_@TaylorvonK (big blind) collected ($800)

PokerStars Hand #9000000047: Tournament #1, Apr19_2017-at-16_5_30 Hold'em No Limit ($200/$400 USD) - 2017/04/19 18:06:16 ET
Table 'ACPC Match' 2-max Seat #2 is the button
Seat 1: DeepStack ($5641 in chips)
Seat 2: Taylor_@TaylorvonK ($34359 in chips)
Taylor_@TaylorvonK: posts small blind $200
DeepStack: posts big blind $400
*** HOLE CARDS ***
Dealt to DeepStack [2c 4d]
Dealt to Taylor_@TaylorvonK [Tc Qh]
Taylor_@TaylorvonK: calls $200
DeepStack: checks
*** FLOP **** [Qd 5c 7s]
DeepStack: checks
Taylor_@TaylorvonK: raises $1234 to $1234
DeepStack: folds
Uncalled bet ($1234) returned to Taylor_@TaylorvonK
Taylor_@TaylorvonK collected $800 from the pot
*** SUMMARY ***
Total pot $800 | Rake $0
Board [Qd 5c 7s]
Seat 1: DeepStack (big blind) folded on the Flop
Seat 2: Taylor_@TaylorvonK (button) (small blind) collected ($800)

PokerStars Hand #9000000048: Tournament #1, Apr19_2017-at-16_5_30 Hold'em No Limit ($200/$400 USD) - 2017/04/19 18:06:17 ET
Table 'ACPC Match' 2-max Seat #1 is the button
Seat 1: DeepStack ($5241 in chips)
Seat 2: Taylor_@TaylorvonK ($34759 in chips)
DeepStack: posts small blind $200
Taylor_@TaylorvonK: posts big blind $400
*** HOLE CARDS ***
Dealt to DeepStack [9c Qc]
Dealt to Taylor_@TaylorvonK [Jh 3c]
DeepStack: calls $200
Taylor_@TaylorvonK: checks
*** FLOP **** [5s 8c 4h]
Taylor_@TaylorvonK: checks
DeepStack: checks
*** TURN **** [Kh]
Taylor_@TaylorvonK: checks
DeepStack: checks
*** RIVER **** [9s]
Taylor_@TaylorvonK: checks
DeepStack: raises $1600 to $1600
Taylor_@TaylorvonK: folds
Uncalled bet ($1600) returned to DeepStack
DeepStack collected $800 from the pot
*** SUMMARY ***
Total pot $800 | Rake $0
Board [5s 8c 4h Kh 9s]
Seat 1: DeepStack (button) (small blind) collected ($800)
Seat 2: Taylor_@TaylorvonK (big blind) folded on the River

PokerStars Hand #9000000049: Tournament #1, Apr19_2017-at-16_5_30 Hold'em No Limit ($200/$400 USD) - 2017/04/19 18:06:18 ET
Table 'ACPC Match' 2-max Seat #2 is the button
Seat 1: DeepStack ($5641 in chips)
Seat 2: Taylor_@TaylorvonK ($34359 in chips)
Taylor_@TaylorvonK: posts small blind $200
DeepStack: posts big blind $400
*** HOLE CARDS ***
Dealt to DeepStack [3h 8s]
Dealt to Taylor_@TaylorvonK [Kd 7d]
Taylor_@TaylorvonK: raises $400 to $800
DeepStack: folds
Uncalled bet ($400) returned to Taylor_@TaylorvonK
Taylor_@TaylorvonK collected $800 from the pot
*** SUMMARY ***
Total pot $800 | Rake $0
Seat 1: DeepStack (big blind) folded before the Flop
Seat 2: Taylor_@TaylorvonK (button) (small blind) collected ($800)

PokerStars Hand #9000000050: Tournament #1, Apr19_2017-at-16_5_30 Hold'em No Limit ($200/$400 USD) - 2017/04/19 18:06:19 ET
Table 'ACPC Match' 2-max Seat #1 is the button
Seat 1: DeepStack ($5241 in chips)
Seat 2: Taylor_@TaylorvonK ($34759 in chips)
DeepStack: posts small blind $200
Taylor_@TaylorvonK: posts big blind $400
*** HOLE CARDS ***
Dealt to DeepStack [8d Th]
Dealt to Taylor_@TaylorvonK [4c 9c]
DeepStack: calls $200
Taylor_@TaylorvonK: checks
*** FLOP **** [3h 8c Tc]
Taylor_@TaylorvonK: checks
DeepStack: raises $800 to $800
Taylor_@TaylorvonK: raises $33559 to $34359 and is all-in
DeepStack: calls $4041 and is all-in
Uncalled bet ($29518) returned to Taylor_@TaylorvonK
*** TURN **** [3c]
*** RIVER **** [7s]
*** SHOW DOWN ***
Taylor_@TaylorvonK: shows [4c 9c] (flush, Ten high)
DeepStack: shows [8d Th] (two pair, Tens and Eights)
Taylor_@TaylorvonK collected $10482 from pot
*** SUMMARY ***
Total pot $10482 | Rake $0
Board [3h 8c Tc 3c 7s]
Seat 1: DeepStack (button) (small blind) showed [8d Th] and lost with two pair, Tens and Eights
Seat 2: Taylor_@TaylorvonK (big blind) showed [4c 9c] and won ($10482) with flush, Ten high
