PokerStars Hand #9000300001: Tournament #4, Apr19_2017-at-18_16_29 Hold'em No Limit ($50/$100 USD) - 2017/04/19 20:16:29 ET
Table 'ACPC Match' 2-max Seat #2 is the button
Seat 1: DeepStack ($20000 in chips)
Seat 2: Taylor_@TaylorvonK ($20000 in chips)
Taylor_@TaylorvonK: posts small blind $50
DeepStack: posts big blind $100
*** HOLE CARDS ***
Dealt to DeepStack [Ah As]
Dealt to Taylor_@TaylorvonK [4s Qs]
Taylor_@TaylorvonK: raises $788 to $888
DeepStack: raises $1776 to $2664
Taylor_@TaylorvonK: raises $4447 to $7111
DeepStack: raises $12889 to $20000 and is all-in
Taylor_@TaylorvonK: folds
Uncalled bet ($12889) returned to DeepStack
DeepStack collected $14222 from the pot
*** SUMMARY ***
Total pot $14222 | Rake $0
Seat 1: DeepStack (big blind) collected ($14222)
Seat 2: Taylor_@TaylorvonK (button) (small blind) folded before the Flop

PokerStars Hand #9000300002: Tournament #4, Apr19_2017-at-18_16_29 Hold'em No Limit ($50/$100 USD) - 2017/04/19 20:16:30 ET
Table 'ACPC Match' 2-max Seat #1 is the button
Seat 1: DeepStack ($27111 in chips)
Seat 2: Taylor_@TaylorvonK ($12889 in chips)
DeepStack: posts small blind $50
Taylor_@TaylorvonK: posts big blind $100
*** HOLE CARDS ***
Dealt to DeepStack [Ts Qd]
Dealt to Taylor_@TaylorvonK [Qc 7h]
DeepStack: calls $50
Taylor_@TaylorvonK: checks
*** FLOP **** [Tc 9d 3h]
Taylor_@TaylorvonK: checks
DeepStack: raises $100 to $100
Taylor_@TaylorvonK: folds
Uncalled bet ($100) returned to DeepStack
DeepStack collected $200 from the pot
*** SUMMARY ***
Total pot $200 | Rake $0
Board [Tc 9d 3h]
Seat 1: DeepStack (button) (small blind) collected ($200)
Seat 2: Taylor_@TaylorvonK (big blind) folded on the Flop

PokerStars Hand #9000300003: Tournament #4, Apr19_2017-at-18_16_29 Hold'em No Limit ($50/$100 USD) - 2017/04/19 20:16:31 ET
Table 'ACPC Match' 2-max Seat #2 is the button
Seat 1: DeepStack ($27211 in chips)
Seat 2: Taylor_@TaylorvonK ($12789 in chips)
Taylor_@TaylorvonK: posts small blind $50
DeepStack: posts big blind $100
*** HOLE CARDS ***
Dealt to DeepStack [5d Td]
Dealt to Taylor_@TaylorvonK [Kc Ac]
Taylor_@TaylorvonK: raises $134 to $234
DeepStack: calls $134
*** FLOP **** [Th As 5s]
DeepStack: bets $468
Taylor_@TaylorvonK: calls $468
*** TURN **** [Qh]
DeepStack: checks
Taylor_@TaylorvonK: checks
*** RIVER **** [7s]
DeepStack: checks
Taylor_@TaylorvonK: checks
*** SHOW DOWN ***
DeepStack: shows [5d Td] (two pair, Tens and Fives)
Taylor_@TaylorvonK: shows [Kc Ac] (a pair of Aces)
DeepStack collected $1404 from pot
*** SUMMARY ***
Total pot $1404 | Rake $0
Board [Th As 5s Qh 7s]
Seat 1: DeepStack (big blind) showed [5d Td] and won ($1404) with two pair, Tens and Fives
Seat 2: Taylor_@TaylorvonK (button) (small blind) showed [Kc Ac] and lost with a pair of Aces

PokerStars Hand #9000300004: Tournament #4, Apr19_2017-at-18_16_29 Hold'em No Limit ($50/$100 USD) - 2017/04/19 20:16:32 ET
Table 'ACPC Match' 2-max Seat #1 is the button
Seat 1: DeepStack ($27913 in chips)
Seat 2: Taylor_@TaylorvonK ($12087 in chips)
DeepStack: posts small blind $50
Taylor_@TaylorvonK: posts big blind $100
*** HOLE CARDS ***
Dealt to DeepStack [8h 2c]
Dealt to Taylor_@TaylorvonK [4h 8c]
DeepStack: folds
Uncalled bet ($50) returned to Taylor_@TaylorvonK
Taylor_@TaylorvonK collected $100 from the pot
*** SUMMARY ***
Total pot $100 | Rake $0
Seat 1: DeepStack (button) (small blind) folded before the Flop
Seat 2: Taylor_@TaylorvonK (big blind) collected ($100)

PokerStars Hand #9000300005: Tournament #4, Apr19_2017-at-18_16_29 Hold'em No Limit ($50/$100 USD) - 2017/04/19 20:16:33 ET
Table 'ACPC Match' 2-max Seat #2 is the button
Seat 1: DeepStack ($27863 in chips)
Seat 2: Taylor_@TaylorvonK ($12137 in chips)
Taylor_@TaylorvonK: posts small blind $50
DeepStack: posts big blind $100
*** HOLE CARDS ***
Dealt to DeepStack [2c Td]
Dealt to Taylor_@TaylorvonK [4d 6s]
Taylor_@TaylorvonK: raises $245 to $345
DeepStack: folds
Uncalled bet ($245) returned to Taylor_@TaylorvonK
Taylor_@TaylorvonK collected $200 from the pot
*** SUMMARY ***
Total pot $200 | Rake $0
Seat 1: DeepStack (big blind) folded before the Flop
Seat 2: Taylor_@TaylorvonK (button) (small blind) collected ($200)

PokerStars Hand #9000300006: Tournament #4, Apr19_2017-at-18_16_29 Hold'em No Limit ($50/$100 USD) - 2017/04/19 20:16:34 ET
Table 'ACPC Match' 2-max Seat #1 is the button
Seat 1: DeepStack ($27763 in chips)
Seat 2: Taylor_@TaylorvonK ($12237 in chips)
DeepStack: posts small blind $50
Taylor_@TaylorvonK: posts big blind $100
*** HOLE CARDS ***
Dealt to DeepStack [9c 3h]
Dealt to Taylor_@TaylorvonK [Ts 5h]
DeepStack: folds
Uncalled bet ($50) returned to Taylor_@TaylorvonK
Taylor_@TaylorvonK collected $100 from the pot
*** SUMMARY ***
Total pot $100 | Rake $0
Seat 1: DeepStack (button) (small blind) folded before the Flop
Seat 2: Taylor_@TaylorvonK (big blind) collected ($100)

PokerStars Hand #9000300007: Tournament #4, Apr19_2017-at-18_16_29 Hold'em No Limit ($50/$100 USD) - 2017/04/19 20:16:35 ET
Table 'ACPC Match' 2-max Seat #2 is the button
Seat 1: DeepStack ($27713 in chips)
Seat 2: Taylor_@TaylorvonK ($12287 in chips)
Taylor_@TaylorvonK: posts small blind $50
DeepStack: posts big blind $100
*** HOLE CARDS ***
Dealt to DeepStack [Ks 8s]
Dealt to Taylor_@TaylorvonK [Kh 7s]
Taylor_@TaylorvonK: raises $344 to $444
DeepStack: calls $344
*** FLOP **** [Qc 7c 4s]
DeepStack: checks
Taylor_@TaylorvonK: raises $444 to $444
DeepStack: calls $444
*** TURN **** [Td]
DeepStack: checks
Taylor_@TaylorvonK: checks
*** RIVER **** [5s]
DeepStack: bets $888
Taylor_@TaylorvonK: calls $888
*** SHOW DOWN ***
DeepStack: shows [Ks 8s] (King high)
Taylor_@TaylorvonK: shows [Kh 7s] (a pair of Sevens)
Taylor_@TaylorvonK collected $3552 from pot
*** SUMMARY ***
Total pot $3552 | Rake $0
Board [Qc 7c 4s Td 5s]
Seat 1: DeepStack (big blind) showed [Ks 8s] and lost with King high
Seat 2: Taylor_@TaylorvonK (button) (small blind) showed [Kh 7s] and won ($3552) with a pair of Sevens

PokerStars Hand #9000300008: Tournament #4, Apr19_2017-at-18_16_29 Hold'em No Limit ($50/$100 USD) - 2017/04/19 20:16:36 ET
Table 'ACPC Match' 2-max Seat #1 is the button
Seat 1: DeepStack ($25937 in chips)
Seat 2: Taylor_@TaylorvonK ($14063 in chips)
DeepStack: posts small blind $50
Taylor_@TaylorvonK: posts big blind $100
*** HOLE CARDS ***
Dealt to DeepStack [6h Ad]
Dealt to Taylor_@TaylorvonK [As Tc]
DeepStack: raises $100 to $200
Taylor_@TaylorvonK: calls $100
*** FLOP **** [2d 7d Qc]
Taylor_@TaylorvonK: checks
DeepStack: raises $200 to $200
Taylor_@TaylorvonK: calls $200
*** TURN **** [Ts]
Taylor_@TaylorvonK: checks
DeepStack: raises $800 to $800
Taylor_@TaylorvonK: raises $2088 to $2888
DeepStack: folds
Uncalled bet ($2088) returned to Taylor_@TaylorvonK
Taylor_@TaylorvonK collected $2400 from the pot
*** SUMMARY ***
Total pot $2400 | Rake $0
Board [2d 7d Qc Ts]
Seat 1: DeepStack (button) (small blind) folded on the Turn
Seat 2: Taylor_@TaylorvonK (big blind) collected ($2400)

PokerStars Hand #9000300009: Tournament #4, Apr19_2017-at-18_16_29 Hold'em No Limit ($50/$100 USD) - 2017/04/19 20:16:37 ET
Table 'ACPC Match' 2-max Seat #2 is the button
Seat 1: DeepStack ($24737 in chips)
Seat 2: Taylor_@TaylorvonK ($15263 in chips)
Taylor_@TaylorvonK: posts small blind $50
DeepStack: posts big blind $100
*** HOLE CARDS ***
Dealt to DeepStack [9d 3h]
Dealt to Taylor_@TaylorvonK [Qs 4d]
Taylor_@TaylorvonK: raises $455 to $555
DeepStack: folds
Uncalled bet ($455) returned to Taylor_@TaylorvonK
Taylor_@TaylorvonK collected $200 from the pot
*** SUMMARY ***
Total pot $200 | Rake $0
Seat 1: DeepStack (big blind) folded before the Flop
Seat 2: Taylor_@TaylorvonK (button) (small blind) collected ($200)

PokerStars Hand #9000300010: Tournament #4, Apr19_2017-at-18_16_29 Hold'em No Limit ($50/$100 USD) - 2017/04/19 20:16:38 ET
Table 'ACPC Match' 2-max Seat #1 is the button
Seat 1: DeepStack ($24637 in chips)
Seat 2: Taylor_@TaylorvonK ($15363 in chips)
DeepStack: posts small blind $50
Taylor_@TaylorvonK: posts big blind $100
*** HOLE CARDS ***
Dealt to DeepStack [9d 5s]
Dealt to Taylor_@TaylorvonK [9c 7d]
DeepStack: calls $50
Taylor_@TaylorvonK: checks
*** FLOP **** [6s Jd 8h]
Taylor_@TaylorvonK: checks
DeepStack: raises $200 to $200
Taylor_@TaylorvonK: calls $200
*** TURN **** [Kh]
Taylor_@TaylorvonK: checks
DeepStack: checks
*** RIVER **** [3s]
Taylor_@TaylorvonK: bets $444
DeepStack: folds
Uncalled bet ($444) returned to Taylor_@TaylorvonK
Taylor_@TaylorvonK collected $600 from the pot
*** SUMMARY ***
Total pot $600 | Rake $0
Board [6s Jd 8h Kh 3s]
Seat 1: DeepStack (button) (small blind) folded on the River
Seat 2: Taylor_@TaylorvonK (big blind) collected ($600)

PokerStars Hand #9000300011: Tournament #4, Apr19_2017-at-18_16_29 Hold'em No Limit ($75/$150 USD) - 2017/04/19 20:16:39 ET
Table 'ACPC Match' 2-max Seat #2 is the button
Seat 1: DeepStack ($24337 in chips)
Seat 2: Taylor_@TaylorvonK ($15663 in chips)
Taylor_@TaylorvonK: posts small blind $75
DeepStack: posts big blind $150
*** HOLE CARDS ***
Dealt to DeepStack [4h 7s]
Dealt to Taylor_@TaylorvonK [Ts Td]
Taylor_@TaylorvonK: raises $150 to $300
DeepStack: calls $150
*** FLOP **** [9h 2d 5h]
DeepStack: checks
Taylor_@TaylorvonK: checks
*** TURN **** [3h]
DeepStack: bets $600
Taylor_@TaylorvonK: raises $1844 to $2444
DeepStack: folds
Uncalled bet ($1844) returned to Taylor_@TaylorvonK
Taylor_@TaylorvonK collected $1800 from the pot
*** SUMMARY ***
Total pot $1800 | Rake $0
Board [9h 2d 5h 3h]
Seat 1: DeepStack (big blind) folded on the Turn
Seat 2: Taylor_@TaylorvonK (button) (small blind) collected ($1800)

PokerStars Hand #9000300012: Tournament #4, Apr19_2017-at-18_16_29 Hold'em No Limit ($75/$150 USD) - 2017/04/19 20:16:40 ET
Table 'ACPC Match' 2-max Seat #1 is the button
Seat 1: DeepStack ($23437 in chips)
Seat 2: Taylor_@TaylorvonK ($16563 in chips)
DeepStack: posts small blind $75
Taylor_@TaylorvonK: posts big blind $150
*** HOLE CARDS ***
Dealt to DeepStack [Jc 9s]
Dealt to Taylor_@TaylorvonK [Ad Ks]
DeepStack: calls $75
Taylor_@TaylorvonK: raises $516 to $666
DeepStack: calls $516
*** FLOP **** [8h 6s 2d]
Taylor_@TaylorvonK: checks
DeepStack: checks
*** TURN **** [Qd]
Taylor_@TaylorvonK: bets $888
DeepStack: calls $888
*** RIVER **** [2h]
Taylor_@TaylorvonK: checks
DeepStack: checks
*** SHOW DOWN ***
Taylor_@TaylorvonK: shows [Ad Ks] (a pair of Deuces)
DeepStack: shows [Jc 9s] (a pair of Deuces)
Taylor_@TaylorvonK collected $3108 from pot
*** SUMMARY ***
Total pot $3108 | Rake $0
Board [8h 6s 2d Qd 2h]
Seat 1: DeepStack (button) (small blind) showed [Jc 9s] and lost with a pair of Deuces
Seat 2: Taylor_@TaylorvonK (big blind) showed [Ad Ks] and won ($3108) with a pair of Deuces

PokerStars Hand #9000300013: Tournament #4, Apr19_2017-at-18_16_29 Hold'em No Limit ($75/$150 USD) - 2017/04/19 20:16:41 ET
Table 'ACPC Match' 2-max Seat #2 is the button
Seat 1: DeepStack ($21883 in chips)
Seat 2: Taylor_@TaylorvonK ($18117 in chips)
Taylor_@TaylorvonK: posts small blind $75
DeepStack: posts big blind $150
*** HOLE CARDS ***
Dealt to DeepStack [2d 9h]
Dealt to Taylor_@TaylorvonK [3h Ad]
Taylor_@TaylorvonK: raises $405 to $555
DeepStack: folds
Uncalled bet ($405) returned to Taylor_@TaylorvonK
Taylor_@TaylorvonK collected $300 from the pot
*** SUMMARY ***
Total pot $300 | Rake $0
Seat 1: DeepStack (big blind) folded before the Flop
Seat 2: Taylor_@TaylorvonK (button) (small blind) collected ($300)

PokerStars Hand #9000300014: Tournament #4, Apr19_2017-at-18_16_29 Hold'em No Limit ($75/$150 USD) - 2017/04/19 20:16:42 ET
Table 'ACPC Match' 2-max Seat #1 is the button
Seat 1: DeepStack ($21733 in chips)
Seat 2: Taylor_@TaylorvonK ($18267 in chips)
DeepStack: posts small blind $75
Taylor_@TaylorvonK: posts big blind $150
*** HOLE CARDS ***
Dealt to DeepStack [Td Jd]
Dealt to Taylor_@TaylorvonK [8h 4s]
DeepStack: raises $300 to $450
Taylor_@TaylorvonK: folds
Uncalled bet ($300) returned to DeepStack
DeepStack collected $300 from the pot
*** SUMMARY ***
Total pot $300 | Rake $0
Seat 1: DeepStack (button) (small blind) collected ($300)
Seat 2: Taylor_@TaylorvonK (big blind) folded before the Flop

PokerStars Hand #9000300015: Tournament #4, Apr19_2017-at-18_16_29 Hold'em No Limit ($75/$150 USD) - 2017/04/19 20:16:43 ET
Table 'ACPC Match' 2-max Seat #2 is the button
Seat 1: DeepStack ($21883 in chips)
Seat 2: Taylor_@TaylorvonK ($18117 in chips)
Taylor_@TaylorvonK: posts small blind $75
DeepStack: posts big blind $150
*** HOLE CARDS ***
Dealt to DeepStack [5d 8c]
Dealt to Taylor_@TaylorvonK [Jh Td]
Taylor_@TaylorvonK: raises $405 to $555
DeepStack: folds
Uncalled bet ($405) returned to Taylor_@TaylorvonK
Taylor_@TaylorvonK collected $300 from the pot
*** SUMMARY ***
Total pot $300 | Rake $0
Seat 1: DeepStack (big blind) folded before the Flop
Seat 2: Taylor_@TaylorvonK (button) (small blind) collected ($300)

PokerStars Hand #9000300016: Tournament #4, Apr19_2017-at-18_16_29 Hold'em No Limit ($75/$150 USD) - 2017/04/19 20:16:44 ET
Table 'ACPC Match' 2-max Seat #1 is the button
Seat 1: DeepStack ($21733 in chips)
Seat 2: Taylor_@TaylorvonK ($18267 in chips)
DeepStack: posts small blind $75
Taylor_@TaylorvonK: posts big blind $150
*** HOLE CARDS ***
Dealt to DeepStack [Qd 4c]
Dealt to Taylor_@TaylorvonK [7h 4h]
DeepStack: raises $300 to $450
Taylor_@TaylorvonK: calls $300
*** FLOP **** [Ah 7s 6d]
Taylor_@TaylorvonK: checks
DeepStack: checks
*** TURN **** [9s]
Taylor_@TaylorvonK: checks
DeepStack: checks
*** RIVER **** [Ks]
Taylor_@TaylorvonK: checks
DeepStack: checks
*** SHOW DOWN ***
Taylor_@TaylorvonK: shows [7h 4h] (a pair of Sevens)
DeepStack: shows [Qd 4c] (Ace high)
Taylor_@TaylorvonK collected $900 from pot
*** SUMMARY ***
Total pot $900 | Rake $0
Board [Ah 7s 6d 9s Ks]
Seat 1: DeepStack (button) (small blind) showed [Qd 4c] and lost with Ace high
Seat 2: Taylor_@TaylorvonK (big blind) showed [7h 4h] and won ($900) with a pair of Sevens

PokerStars Hand #9000300017: Tournament #4, Apr19_2017-at-18_16_29 Hold'em No Limit ($75/$150 USD) - 2017/04/19 20:16:45 ET
Table 'ACPC Match' 2-max Seat #2 is the button
Seat 1: DeepStack ($21283 in chips)
Seat 2: Taylor_@TaylorvonK ($18717 in chips)
Taylor_@TaylorvonK: posts small blind $75
DeepStack: posts big blind $150
*** HOLE CARDS ***
Dealt to DeepStack [2s Th]
Dealt to Taylor_@TaylorvonK [3c 3s]
Taylor_@TaylorvonK: raises $150 to $300
DeepStack: folds
Uncalled bet ($150) returned to Taylor_@TaylorvonK
Taylor_@TaylorvonK collected $300 from the pot
*** SUMMARY ***
Total pot $300 | Rake $0
Seat 1: DeepStack (big blind) folded before the Flop
Seat 2: Taylor_@TaylorvonK (button) (small blind) collected ($300)

PokerStars Hand #9000300018: Tournament #4, Apr19_2017-at-18_16_29 Hold'em No Limit ($75/$150 USD) - 2017/04/19 20:16:46 ET
Table 'ACPC Match' 2-max Seat #1 is the button
Seat 1: DeepStack ($21133 in chips)
Seat 2: Taylor_@TaylorvonK ($18867 in chips)
DeepStack: posts small blind $75
Taylor_@TaylorvonK: posts big blind $150
*** HOLE CARDS ***
Dealt to DeepStack [5s Tc]
Dealt to Taylor_@TaylorvonK [Ah 6s]
DeepStack: calls $75
Taylor_@TaylorvonK: checks
*** FLOP **** [2h 9d 4h]
Taylor_@TaylorvonK: checks
DeepStack: checks
*** TURN **** [Kc]
Taylor_@TaylorvonK: checks
DeepStack: checks
*** RIVER **** [2d]
Taylor_@TaylorvonK: checks
DeepStack: checks
*** SHOW DOWN ***
Taylor_@TaylorvonK: shows [Ah 6s] (a pair of Deuces)
DeepStack: shows [5s Tc] (a pair of Deuces)
Taylor_@TaylorvonK collected $300 from pot
*** SUMMARY ***
Total pot $300 | Rake $0
Board [2h 9d 4h Kc 2d]
Seat 1: DeepStack (button) (small blind) showed [5s Tc] and lost with a pair of Deuces
Seat 2: Taylor_@TaylorvonK (big blind) showed [Ah 6s] and won ($300) with a pair of Deuces

PokerStars Hand #9000300019: Tournament #4, Apr19_2017-at-18_16_29 Hold'em No Limit ($75/$150 USD) - 2017/04/19 20:16:47 ET
Table 'ACPC Match' 2-max Seat #2 is the button
Seat 1: DeepStack ($20983 in chips)
Seat 2: Taylor_@TaylorvonK ($19017 in chips)
Taylor_@TaylorvonK: posts small blind $75
DeepStack: posts big blind $150
*** HOLE CARDS ***
Dealt to DeepStack [2c 8c]
Dealt to Taylor_@TaylorvonK [3h 7s]
Taylor_@TaylorvonK: folds
Uncalled bet ($75) returned to DeepStack
DeepStack collected $150 from the pot
*** SUMMARY ***
Total pot $150 | Rake $0
Seat 1: DeepStack (big blind) collected ($150)
Seat 2: Taylor_@TaylorvonK (button) (small blind) folded before the Flop

PokerStars Hand #9000300020: Tournament #4, Apr19_2017-at-18_16_29 Hold'em No Limit ($75/$150 USD) - 2017/04/19 20:16:48 ET
Table 'ACPC Match' 2-max Seat #1 is the button
Seat 1: DeepStack ($21058 in chips)
Seat 2: Taylor_@TaylorvonK ($18942 in chips)
DeepStack: posts small blind $75
Taylor_@TaylorvonK: posts big blind $150
*** HOLE CARDS ***
Dealt to DeepStack [Jh Ts]
Dealt to Taylor_@TaylorvonK [6c Td]
DeepStack: raises $300 to $450
Taylor_@TaylorvonK: folds
Uncalled bet ($300) returned to DeepStack
DeepStack collected $300 from the pot
*** SUMMARY ***
Total pot $300 | Rake $0
Seat 1: DeepStack (button) (small blind) collected ($300)
Seat 2: Taylor_@TaylorvonK (big blind) folded before the Flop

PokerStars Hand #9000300021: Tournament #4, Apr19_2017-at-18_16_29 Hold'em No Limit ($100/$200 USD) - 2017/04/19 20:16:49 ET
Table 'ACPC Match' 2-max Seat #2 is the button
Seat 1: DeepStack ($21208 in chips)
Seat 2: Taylor_@TaylorvonK ($18792 in chips)
Taylor_@TaylorvonK: posts small blind $100
DeepStack: posts big blind $200
*** HOLE CARDS ***
Dealt to DeepStack [Qh Kd]
Dealt to Taylor_@TaylorvonK [5c 7c]
Taylor_@TaylorvonK: raises $466 to $666
DeepStack: calls $466
*** FLOP **** [Jc Qc 9c]
DeepStack: checks
Taylor_@TaylorvonK: checks
*** TURN **** [9d]
DeepStack: checks
Taylor_@TaylorvonK: checks
*** RIVER **** [6s]
DeepStack: checks
Taylor_@TaylorvonK: raises $888 to $888
DeepStack: calls $888
*** SHOW DOWN ***
Taylor_@TaylorvonK: shows [5c 7c] (flush, Queen high)
DeepStack: shows [Qh Kd] (two pair, Queens and Nines)
Taylor_@TaylorvonK collected $3108 from pot
*** SUMMARY ***
Total pot $3108 | Rake $0
Board [Jc Qc 9c 9d 6s]
Seat 1: DeepStack (big blind) showed [Qh Kd] and lost with two pair, Queens and Nines
Seat 2: Taylor_@TaylorvonK (button) (small blind) showed [5c 7c] and won ($3108) with flush, Queen high

PokerStars Hand #9000300022: Tournament #4, Apr19_2017-at-18_16_29 Hold'em No Limit ($100/$200 USD) - 2017/04/19 20:16:50 ET
Table 'ACPC Match' 2-max Seat #1 is the button
Seat 1: DeepStack ($19654 in chips)
Seat 2: Taylor_@TaylorvonK ($20346 in chips)
DeepStack: posts small blind $100
Taylor_@TaylorvonK: posts big blind $200
*** HOLE CARDS ***
Dealt to DeepStack [Jh Tc]
Dealt to Taylor_@TaylorvonK [7c 6h]
DeepStack: raises $400 to $600
Taylor_@TaylorvonK: calls $400
*** FLOP **** [Th 8c 9d]
Taylor_@TaylorvonK: checks
DeepStack: raises $600 to $600
Taylor_@TaylorvonK: calls $600
*** TURN **** [5c]
Taylor_@TaylorvonK: checks
DeepStack: raises $2400 to $2400
Taylor_@TaylorvonK: calls $2400
*** RIVER **** [5h]
Taylor_@TaylorvonK: checks
DeepStack: checks
*** SHOW DOWN ***
Taylor_@TaylorvonK: shows [7c 6h] (straight, Ten high)
DeepStack: shows [Jh Tc] (two pair, Tens and Fives)
Taylor_@TaylorvonK collected $7200 from pot
*** SUMMARY ***
Total pot $7200 | Rake $0
Board [Th 8c 9d 5c 5h]
Seat 1: DeepStack (button) (small blind) showed [Jh Tc] and lost with two pair, Tens and Fives
Seat 2: Taylor_@TaylorvonK (big blind) showed [7c 6h] and won ($7200) with straight, Ten high

PokerStars Hand #9000300023: Tournament #4, Apr19_2017-at-18_16_29 Hold'em No Limit ($100/$200 USD) - 2017/04/19 20:16:51 ET
Table 'ACPC Match' 2-max Seat #2 is the button
Seat 1: DeepStack ($16054 in chips)
Seat 2: Taylor_@TaylorvonK ($23946 in chips)
Taylor_@TaylorvonK: posts small blind $100
DeepStack: posts big blind $200
*** HOLE CARDS ***
Dealt to DeepStack [7s 5h]
Dealt to Taylor_@TaylorvonK [2d 8h]
Taylor_@TaylorvonK: folds
Uncalled bet ($100) returned to DeepStack
DeepStack collected $200 from the pot
*** SUMMARY ***
Total pot $200 | Rake $0
Seat 1: DeepStack (big blind) collected ($200)
Seat 2: Taylor_@TaylorvonK (button) (small blind) folded before the Flop

PokerStars Hand #9000300024: Tournament #4, Apr19_2017-at-18_16_29 Hold'em No Limit ($100/$200 USD) - 2017/04/19 20:16:52 ET
Table 'ACPC Match' 2-max Seat #1 is the button
Seat 1: DeepStack ($16154 in chips)
Seat 2: Taylor_@TaylorvonK ($23846 in chips)
DeepStack: posts small blind $100
Taylor_@TaylorvonK: posts big blind $200
*** HOLE CARDS ***
Dealt to DeepStack [3s Jh]
Dealt to Taylor_@TaylorvonK [Ks 7c]
DeepStack: calls $100
Taylor_@TaylorvonK: checks
*** FLOP **** [Qs Qc 5c]
Taylor_@TaylorvonK: checks
DeepStack: raises $200 to $200
Taylor_@TaylorvonK: calls $200
*** TURN **** [Kh]
Taylor_@TaylorvonK: checks
DeepStack: checks
*** RIVER **** [6c]
Taylor_@TaylorvonK: checks
DeepStack: checks
*** SHOW DOWN ***
Taylor_@TaylorvonK: shows [Ks 7c] (two pair, Kings and Queens)
DeepStack: shows [3s Jh] (a pair of Queens)
Taylor_@TaylorvonK collected $800 from pot
*** SUMMARY ***
Total pot $800 | Rake $0
Board [Qs Qc 5c Kh 6c]
Seat 1: DeepStack (button) (small blind) showed [3s Jh] and lost with a pair of Queens
Seat 2: Taylor_@TaylorvonK (big blind) showed [Ks 7c] and won ($800) with two pair, Kings and Queens

PokerStars Hand #9000300025: Tournament #4, Apr19_2017-at-18_16_29 Hold'em No Limit ($100/$200 USD) - 2017/04/19 20:16:53 ET
Table 'ACPC Match' 2-max Seat #2 is the button
Seat 1: DeepStack ($15754 in chips)
Seat 2: Taylor_@TaylorvonK ($24246 in chips)
Taylor_@TaylorvonK: posts small blind $100
DeepStack: posts big blind $200
*** HOLE CARDS ***
Dealt to DeepStack [Ah 4d]
Dealt to Taylor_@TaylorvonK [9s 2h]
Taylor_@TaylorvonK: folds
Uncalled bet ($100) returned to DeepStack
DeepStack collected $200 from the pot
*** SUMMARY ***
Total pot $200 | Rake $0
Seat 1: DeepStack (big blind) collected ($200)
Seat 2: Taylor_@TaylorvonK (button) (small blind) folded before the Flop

PokerStars Hand #9000300026: Tournament #4, Apr19_2017-at-18_16_29 Hold'em No Limit ($100/$200 USD) - 2017/04/19 20:16:54 ET
Table 'ACPC Match' 2-max Seat #1 is the button
Seat 1: DeepStack ($15854 in chips)
Seat 2: Taylor_@TaylorvonK ($24146 in chips)
DeepStack: posts small blind $100
Taylor_@TaylorvonK: posts big blind $200
*** HOLE CARDS ***
Dealt to DeepStack [7s 9s]
Dealt to Taylor_@TaylorvonK [8c Kd]
DeepStack: calls $100
Taylor_@TaylorvonK: raises $799 to $999
DeepStack: calls $799
*** FLOP **** [9c 8s 4c]
Taylor_@TaylorvonK: checks
DeepStack: checks
*** TURN **** [3h]
Taylor_@TaylorvonK: checks
DeepStack: raises $1998 to $1998
Taylor_@TaylorvonK: calls $1998
*** RIVER **** [Kh]
Taylor_@TaylorvonK: checks
DeepStack: raises $2997 to $2997
Taylor_@TaylorvonK: raises $18152 to $21149 and is all-in
DeepStack: folds
Uncalled bet ($18152) returned to Taylor_@TaylorvonK
Taylor_@TaylorvonK collected $11988 from the pot
*** SUMMARY ***
Total pot $11988 | Rake $0
Board [9c 8s 4c 3h Kh]
Seat 1: DeepStack (button) (small blind) folded on the River
Seat 2: Taylor_@TaylorvonK (big blind) collected ($11988)

PokerStars Hand #9000300027: Tournament #4, Apr19_2017-at-18_16_29 Hold'em No Limit ($100/$200 USD) - 2017/04/19 20:16:55 ET
Table 'ACPC Match' 2-max Seat #2 is the button
Seat 1: DeepStack ($9860 in chips)
Seat 2: Taylor_@TaylorvonK ($30140 in chips)
Taylor_@TaylorvonK: posts small blind $100
DeepStack: posts big blind $200
*** HOLE CARDS ***
Dealt to DeepStack [2h 6d]
Dealt to Taylor_@TaylorvonK [Js 9s]
Taylor_@TaylorvonK: raises $355 to $555
DeepStack: folds
Uncalled bet ($355) returned to Taylor_@TaylorvonK
Taylor_@TaylorvonK collected $400 from the pot
*** SUMMARY ***
Total pot $400 | Rake $0
Seat 1: DeepStack (big blind) folded before the Flop
Seat 2: Taylor_@TaylorvonK (button) (small blind) collected ($400)

PokerStars Hand #9000300028: Tournament #4, Apr19_2017-at-18_16_29 Hold'em No Limit ($100/$200 USD) - 2017/04/19 20:16:56 ET
Table 'ACPC Match' 2-max Seat #1 is the button
Seat 1: DeepStack ($9660 in chips)
Seat 2: Taylor_@TaylorvonK ($30340 in chips)
DeepStack: posts small blind $100
Taylor_@TaylorvonK: posts big blind $200
*** HOLE CARDS ***
Dealt to DeepStack [9c Tc]
Dealt to Taylor_@TaylorvonK [8s Ad]
DeepStack: raises $200 to $400
Taylor_@TaylorvonK: raises $1488 to $1888
DeepStack: calls $1488
*** FLOP **** [Ts 4s Qc]
Taylor_@TaylorvonK: checks
DeepStack: checks
*** TURN **** [Jc]
Taylor_@TaylorvonK: bets $1888
DeepStack: calls $1888
*** RIVER **** [5h]
Taylor_@TaylorvonK: bets $26564 and is all-in
DeepStack: folds
Uncalled bet ($26564) returned to Taylor_@TaylorvonK
Taylor_@TaylorvonK collected $7552 from the pot
*** SUMMARY ***
Total pot $7552 | Rake $0
Board [Ts 4s Qc Jc 5h]
Seat 1: DeepStack (button) (small blind) folded on the River
Seat 2: Taylor_@TaylorvonK (big blind) collected ($7552)

PokerStars Hand #9000300029: Tournament #4, Apr19_2017-at-18_16_29 Hold'em No Limit ($100/$200 USD) - 2017/04/19 20:16:57 ET
Table 'ACPC Match' 2-max Seat #2 is the button
Seat 1: DeepStack ($5884 in chips)
Seat 2: Taylor_@TaylorvonK ($34116 in chips)
Taylor_@TaylorvonK: posts small blind $100
DeepStack: posts big blind $200
*** HOLE CARDS ***
Dealt to DeepStack [Ts Jh]
Dealt to Taylor_@TaylorvonK [Th Kd]
Taylor_@TaylorvonK: raises $355 to $555
DeepStack: calls $355
*** FLOP **** [Qs 2c As]
DeepStack: checks
Taylor_@TaylorvonK: raises $555 to $555
DeepStack: calls $555
*** TURN **** [2d]
DeepStack: checks
Taylor_@TaylorvonK: raises $1888 to $1888
DeepStack: folds
Uncalled bet ($1888) returned to Taylor_@TaylorvonK
Taylor_@TaylorvonK collected $2220 from the pot
*** SUMMARY ***
Total pot $2220 | Rake $0
Board [Qs 2c As 2d]
Seat 1: DeepStack (big blind) folded on the Turn
Seat 2: Taylor_@TaylorvonK (button) (small blind) collected ($2220)

PokerStars Hand #9000300030: Tournament #4, Apr19_2017-at-18_16_29 Hold'em No Limit ($100/$200 USD) - 2017/04/19 20:16:58 ET
Table 'ACPC Match' 2-max Seat #1 is the button
Seat 1: DeepStack ($4774 in chips)
Seat 2: Taylor_@TaylorvonK ($35226 in chips)
DeepStack: posts small blind $100
Taylor_@TaylorvonK: posts big blind $200
*** HOLE CARDS ***
Dealt to DeepStack [6d Th]
Dealt to Taylor_@TaylorvonK [Tc 7d]
DeepStack: calls $100
Taylor_@TaylorvonK: checks
*** FLOP **** [5d 3d 2c]
Taylor_@TaylorvonK: checks
DeepStack: raises $400 to $400
Taylor_@TaylorvonK: folds
Uncalled bet ($400) returned to DeepStack
DeepStack collected $400 from the pot
*** SUMMARY ***
Total pot $400 | Rake $0
Board [5d 3d 2c]
Seat 1: DeepStack (button) (small blind) collected ($400)
Seat 2: Taylor_@TaylorvonK (big blind) folded on the Flop

PokerStars Hand #9000300031: Tournament #4, Apr19_2017-at-18_16_29 Hold'em No Limit ($150/$300 USD) - 2017/04/19 20:16:59 ET
Table 'ACPC Match' 2-max Seat #2 is the button
Seat 1: DeepStack ($4974 in chips)
Seat 2: Taylor_@TaylorvonK ($35026 in chips)
Taylor_@TaylorvonK: posts small blind $150
DeepStack: posts big blind $300
*** HOLE CARDS ***
Dealt to DeepStack [5s Ac]
Dealt to Taylor_@TaylorvonK [Jh Th]
Taylor_@TaylorvonK: raises $300 to $600
DeepStack: calls $300
*** FLOP **** [7s Jc Js]
DeepStack: checks
Taylor_@TaylorvonK: checks
*** TURN **** [3d]
DeepStack: checks
Taylor_@TaylorvonK: raises $600 to $600
DeepStack: calls $600
*** RIVER **** [6h]
DeepStack: checks
Taylor_@TaylorvonK: raises $999 to $999
DeepStack: raises $2775 to $3774 and is all-in
Taylor_@TaylorvonK: calls $2775
*** SHOW DOWN ***
DeepStack: shows [5s Ac] (a pair of Jacks)
Taylor_@TaylorvonK: shows [Jh Th] (three of a kind, Jacks)
Taylor_@TaylorvonK collected $9948 from pot
*** SUMMARY ***
Total pot $9948 | Rake $0
Board [7s Jc Js 3d 6h]
Seat 1: DeepStack (big blind) showed [5s Ac] and lost with a pair of Jacks
Seat 2: Taylor_@TaylorvonK (button) (small blind) showed [Jh Th] and won ($9948) with three of a kind, Jacks
