PokerStars Hand #4000000001: Tournament #1, Apr5_2017-at-15_55_35 Hold'em No Limit ($50/$100 USD) - 2017/04/05 17:55:35 ET
Table 'ACPC Match' 2-max Seat #2 is the button
Seat 1: DeepStack ($20000 in chips)
Seat 2: Terrence_@tchanpoker ($20000 in chips)
Terrence_@tchanpoker: posts small blind $50
DeepStack: posts big blind $100
*** HOLE CARDS ***
Dealt to DeepStack [9c Tc]
Dealt to Terrence_@tchanpoker [4d Ah]
Terrence_@tchanpoker: raises $150 to $250
DeepStack: raises $500 to $750
Terrence_@tchanpoker: calls $500
*** FLOP **** [6h 3c 2d]
DeepStack: bets $750
Terrence_@tchanpoker: calls $750
*** TURN **** [8h]
DeepStack: bets $3000
Terrence_@tchanpoker: folds
Uncalled bet ($3000) returned to DeepStack
DeepStack collected $3000 from the pot
*** SUMMARY ***
Total pot $3000 | Rake $0
Board [6h 3c 2d 8h]
Seat 1: DeepStack (big blind) collected ($3000)
Seat 2: Terrence_@tchanpoker (button) (small blind) folded on the Turn

PokerStars Hand #4000000002: Tournament #1, Apr5_2017-at-15_55_35 Hold'em No Limit ($50/$100 USD) - 2017/04/05 17:55:36 ET
Table 'ACPC Match' 2-max Seat #1 is the button
Seat 1: DeepStack ($21500 in chips)
Seat 2: Terrence_@tchanpoker ($18500 in chips)
DeepStack: posts small blind $50
Terrence_@tchanpoker: posts big blind $100
*** HOLE CARDS ***
Dealt to DeepStack [2c Tc]
Dealt to Terrence_@tchanpoker [As Qd]
DeepStack: raises $100 to $200
Terrence_@tchanpoker: raises $450 to $650
DeepStack: folds
Uncalled bet ($450) returned to Terrence_@tchanpoker
Terrence_@tchanpoker collected $400 from the pot
*** SUMMARY ***
Total pot $400 | Rake $0
Seat 1: DeepStack (button) (small blind) folded before the Flop
Seat 2: Terrence_@tchanpoker (big blind) collected ($400)

PokerStars Hand #4000000003: Tournament #1, Apr5_2017-at-15_55_35 Hold'em No Limit ($50/$100 USD) - 2017/04/05 17:55:37 ET
Table 'ACPC Match' 2-max Seat #2 is the button
Seat 1: DeepStack ($21300 in chips)
Seat 2: Terrence_@tchanpoker ($18700 in chips)
Terrence_@tchanpoker: posts small blind $50
DeepStack: posts big blind $100
*** HOLE CARDS ***
Dealt to DeepStack [6h Jd]
Dealt to Terrence_@tchanpoker [3c Jh]
Terrence_@tchanpoker: raises $150 to $250
DeepStack: calls $150
*** FLOP **** [Qc Ks 7s]
DeepStack: checks
Terrence_@tchanpoker: checks
*** TURN **** [As]
DeepStack: checks
Terrence_@tchanpoker: checks
*** RIVER **** [Ad]
DeepStack: checks
Terrence_@tchanpoker: checks
*** SHOW DOWN ***
DeepStack: shows [6h Jd] (a pair of Aces)
Terrence_@tchanpoker: shows [3c Jh] (a pair of Aces)
DeepStack collected $250 from pot
Terrence_@tchanpoker collected $250 from pot
*** SUMMARY ***
Total pot $500 | Rake $0
Board [Qc Ks 7s As Ad]
Seat 1: DeepStack (big blind) showed [6h Jd] and won ($250) with a pair of Aces
Seat 2: Terrence_@tchanpoker (button) (small blind) showed [3c Jh] and won ($250) with a pair of Aces

PokerStars Hand #4000000004: Tournament #1, Apr5_2017-at-15_55_35 Hold'em No Limit ($50/$100 USD) - 2017/04/05 17:55:38 ET
Table 'ACPC Match' 2-max Seat #1 is the button
Seat 1: DeepStack ($21300 in chips)
Seat 2: Terrence_@tchanpoker ($18700 in chips)
DeepStack: posts small blind $50
Terrence_@tchanpoker: posts big blind $100
*** HOLE CARDS ***
Dealt to DeepStack [8h Js]
Dealt to Terrence_@tchanpoker [8c Ks]
DeepStack: raises $100 to $200
Terrence_@tchanpoker: calls $100
*** FLOP **** [3h Kc 4s]
Terrence_@tchanpoker: checks
DeepStack: checks
*** TURN **** [4d]
Terrence_@tchanpoker: bets $225
DeepStack: folds
Uncalled bet ($225) returned to Terrence_@tchanpoker
Terrence_@tchanpoker collected $400 from the pot
*** SUMMARY ***
Total pot $400 | Rake $0
Board [3h Kc 4s 4d]
Seat 1: DeepStack (button) (small blind) folded on the Turn
Seat 2: Terrence_@tchanpoker (big blind) collected ($400)

PokerStars Hand #4000000005: Tournament #1, Apr5_2017-at-15_55_35 Hold'em No Limit ($50/$100 USD) - 2017/04/05 17:55:39 ET
Table 'ACPC Match' 2-max Seat #2 is the button
Seat 1: DeepStack ($21100 in chips)
Seat 2: Terrence_@tchanpoker ($18900 in chips)
Terrence_@tchanpoker: posts small blind $50
DeepStack: posts big blind $100
*** HOLE CARDS ***
Dealt to DeepStack [Jh Kc]
Dealt to Terrence_@tchanpoker [6h 2s]
Terrence_@tchanpoker: folds
Uncalled bet ($50) returned to DeepStack
DeepStack collected $100 from the pot
*** SUMMARY ***
Total pot $100 | Rake $0
Seat 1: DeepStack (big blind) collected ($100)
Seat 2: Terrence_@tchanpoker (button) (small blind) folded before the Flop

PokerStars Hand #4000000006: Tournament #1, Apr5_2017-at-15_55_35 Hold'em No Limit ($50/$100 USD) - 2017/04/05 17:55:40 ET
Table 'ACPC Match' 2-max Seat #1 is the button
Seat 1: DeepStack ($21150 in chips)
Seat 2: Terrence_@tchanpoker ($18850 in chips)
DeepStack: posts small blind $50
Terrence_@tchanpoker: posts big blind $100
*** HOLE CARDS ***
Dealt to DeepStack [2c 7h]
Dealt to Terrence_@tchanpoker [Qd 6d]
DeepStack: folds
Uncalled bet ($50) returned to Terrence_@tchanpoker
Terrence_@tchanpoker collected $100 from the pot
*** SUMMARY ***
Total pot $100 | Rake $0
Seat 1: DeepStack (button) (small blind) folded before the Flop
Seat 2: Terrence_@tchanpoker (big blind) collected ($100)

PokerStars Hand #4000000007: Tournament #1, Apr5_2017-at-15_55_35 Hold'em No Limit ($50/$100 USD) - 2017/04/05 17:55:41 ET
Table 'ACPC Match' 2-max Seat #2 is the button
Seat 1: DeepStack ($21100 in chips)
Seat 2: Terrence_@tchanpoker ($18900 in chips)
Terrence_@tchanpoker: posts small blind $50
DeepStack: posts big blind $100
*** HOLE CARDS ***
Dealt to DeepStack [Ts 6c]
Dealt to Terrence_@tchanpoker [Ah 4s]
Terrence_@tchanpoker: raises $150 to $250
DeepStack: calls $150
*** FLOP **** [2h 9d Jh]
DeepStack: checks
Terrence_@tchanpoker: checks
*** TURN **** [Jc]
DeepStack: checks
Terrence_@tchanpoker: checks
*** RIVER **** [Kh]
DeepStack: checks
Terrence_@tchanpoker: checks
*** SHOW DOWN ***
DeepStack: shows [Ts 6c] (a pair of Jacks)
Terrence_@tchanpoker: shows [Ah 4s] (a pair of Jacks)
Terrence_@tchanpoker collected $500 from pot
*** SUMMARY ***
Total pot $500 | Rake $0
Board [2h 9d Jh Jc Kh]
Seat 1: DeepStack (big blind) showed [Ts 6c] and lost with a pair of Jacks
Seat 2: Terrence_@tchanpoker (button) (small blind) showed [Ah 4s] and won ($500) with a pair of Jacks

PokerStars Hand #4000000008: Tournament #1, Apr5_2017-at-15_55_35 Hold'em No Limit ($50/$100 USD) - 2017/04/05 17:55:42 ET
Table 'ACPC Match' 2-max Seat #1 is the button
Seat 1: DeepStack ($20850 in chips)
Seat 2: Terrence_@tchanpoker ($19150 in chips)
DeepStack: posts small blind $50
Terrence_@tchanpoker: posts big blind $100
*** HOLE CARDS ***
Dealt to DeepStack [Kc 7d]
Dealt to Terrence_@tchanpoker [Tc 2h]
DeepStack: raises $200 to $300
Terrence_@tchanpoker: folds
Uncalled bet ($200) returned to DeepStack
DeepStack collected $200 from the pot
*** SUMMARY ***
Total pot $200 | Rake $0
Seat 1: DeepStack (button) (small blind) collected ($200)
Seat 2: Terrence_@tchanpoker (big blind) folded before the Flop

PokerStars Hand #4000000009: Tournament #1, Apr5_2017-at-15_55_35 Hold'em No Limit ($50/$100 USD) - 2017/04/05 17:55:43 ET
Table 'ACPC Match' 2-max Seat #2 is the button
Seat 1: DeepStack ($20950 in chips)
Seat 2: Terrence_@tchanpoker ($19050 in chips)
Terrence_@tchanpoker: posts small blind $50
DeepStack: posts big blind $100
*** HOLE CARDS ***
Dealt to DeepStack [4s 6c]
Dealt to Terrence_@tchanpoker [7s 9s]
Terrence_@tchanpoker: raises $150 to $250
DeepStack: folds
Uncalled bet ($150) returned to Terrence_@tchanpoker
Terrence_@tchanpoker collected $200 from the pot
*** SUMMARY ***
Total pot $200 | Rake $0
Seat 1: DeepStack (big blind) folded before the Flop
Seat 2: Terrence_@tchanpoker (button) (small blind) collected ($200)

PokerStars Hand #4000000010: Tournament #1, Apr5_2017-at-15_55_35 Hold'em No Limit ($50/$100 USD) - 2017/04/05 17:55:44 ET
Table 'ACPC Match' 2-max Seat #1 is the button
Seat 1: DeepStack ($20850 in chips)
Seat 2: Terrence_@tchanpoker ($19150 in chips)
DeepStack: posts small blind $50
Terrence_@tchanpoker: posts big blind $100
*** HOLE CARDS ***
Dealt to DeepStack [7h 3c]
Dealt to Terrence_@tchanpoker [Jh 6h]
DeepStack: folds
Uncalled bet ($50) returned to Terrence_@tchanpoker
Terrence_@tchanpoker collected $100 from the pot
*** SUMMARY ***
Total pot $100 | Rake $0
Seat 1: DeepStack (button) (small blind) folded before the Flop
Seat 2: Terrence_@tchanpoker (big blind) collected ($100)

PokerStars Hand #4000000011: Tournament #1, Apr5_2017-at-15_55_35 Hold'em No Limit ($75/$150 USD) - 2017/04/05 17:55:45 ET
Table 'ACPC Match' 2-max Seat #2 is the button
Seat 1: DeepStack ($20800 in chips)
Seat 2: Terrence_@tchanpoker ($19200 in chips)
Terrence_@tchanpoker: posts small blind $75
DeepStack: posts big blind $150
*** HOLE CARDS ***
Dealt to DeepStack [7s 3h]
Dealt to Terrence_@tchanpoker [3c 2c]
Terrence_@tchanpoker: raises $225 to $375
DeepStack: folds
Uncalled bet ($225) returned to Terrence_@tchanpoker
Terrence_@tchanpoker collected $300 from the pot
*** SUMMARY ***
Total pot $300 | Rake $0
Seat 1: DeepStack (big blind) folded before the Flop
Seat 2: Terrence_@tchanpoker (button) (small blind) collected ($300)

PokerStars Hand #4000000012: Tournament #1, Apr5_2017-at-15_55_35 Hold'em No Limit ($75/$150 USD) - 2017/04/05 17:55:46 ET
Table 'ACPC Match' 2-max Seat #1 is the button
Seat 1: DeepStack ($20650 in chips)
Seat 2: Terrence_@tchanpoker ($19350 in chips)
DeepStack: posts small blind $75
Terrence_@tchanpoker: posts big blind $150
*** HOLE CARDS ***
Dealt to DeepStack [2c 7c]
Dealt to Terrence_@tchanpoker [3h 2h]
DeepStack: calls $75
Terrence_@tchanpoker: checks
*** FLOP **** [7h Tc 5d]
Terrence_@tchanpoker: checks
DeepStack: checks
*** TURN **** [8h]
Terrence_@tchanpoker: bets $250
DeepStack: calls $250
*** RIVER **** [9c]
Terrence_@tchanpoker: bets $725
DeepStack: folds
Uncalled bet ($725) returned to Terrence_@tchanpoker
Terrence_@tchanpoker collected $800 from the pot
*** SUMMARY ***
Total pot $800 | Rake $0
Board [7h Tc 5d 8h 9c]
Seat 1: DeepStack (button) (small blind) folded on the River
Seat 2: Terrence_@tchanpoker (big blind) collected ($800)

PokerStars Hand #4000000013: Tournament #1, Apr5_2017-at-15_55_35 Hold'em No Limit ($75/$150 USD) - 2017/04/05 17:55:47 ET
Table 'ACPC Match' 2-max Seat #2 is the button
Seat 1: DeepStack ($20250 in chips)
Seat 2: Terrence_@tchanpoker ($19750 in chips)
Terrence_@tchanpoker: posts small blind $75
DeepStack: posts big blind $150
*** HOLE CARDS ***
Dealt to DeepStack [9h 8s]
Dealt to Terrence_@tchanpoker [Kh Kd]
Terrence_@tchanpoker: raises $225 to $375
DeepStack: raises $750 to $1125
Terrence_@tchanpoker: raises $1700 to $2825
DeepStack: folds
Uncalled bet ($1700) returned to Terrence_@tchanpoker
Terrence_@tchanpoker collected $2250 from the pot
*** SUMMARY ***
Total pot $2250 | Rake $0
Seat 1: DeepStack (big blind) folded before the Flop
Seat 2: Terrence_@tchanpoker (button) (small blind) collected ($2250)

PokerStars Hand #4000000014: Tournament #1, Apr5_2017-at-15_55_35 Hold'em No Limit ($75/$150 USD) - 2017/04/05 17:55:48 ET
Table 'ACPC Match' 2-max Seat #1 is the button
Seat 1: DeepStack ($19125 in chips)
Seat 2: Terrence_@tchanpoker ($20875 in chips)
DeepStack: posts small blind $75
Terrence_@tchanpoker: posts big blind $150
*** HOLE CARDS ***
Dealt to DeepStack [9s 9d]
Dealt to Terrence_@tchanpoker [Tc 5c]
DeepStack: raises $300 to $450
Terrence_@tchanpoker: calls $300
*** FLOP **** [7d 2d 9c]
Terrence_@tchanpoker: checks
DeepStack: raises $900 to $900
Terrence_@tchanpoker: folds
Uncalled bet ($900) returned to DeepStack
DeepStack collected $900 from the pot
*** SUMMARY ***
Total pot $900 | Rake $0
Board [7d 2d 9c]
Seat 1: DeepStack (button) (small blind) collected ($900)
Seat 2: Terrence_@tchanpoker (big blind) folded on the Flop

PokerStars Hand #4000000015: Tournament #1, Apr5_2017-at-15_55_35 Hold'em No Limit ($75/$150 USD) - 2017/04/05 17:55:49 ET
Table 'ACPC Match' 2-max Seat #2 is the button
Seat 1: DeepStack ($19575 in chips)
Seat 2: Terrence_@tchanpoker ($20425 in chips)
Terrence_@tchanpoker: posts small blind $75
DeepStack: posts big blind $150
*** HOLE CARDS ***
Dealt to DeepStack [4s 9c]
Dealt to Terrence_@tchanpoker [Ah Qc]
Terrence_@tchanpoker: raises $225 to $375
DeepStack: folds
Uncalled bet ($225) returned to Terrence_@tchanpoker
Terrence_@tchanpoker collected $300 from the pot
*** SUMMARY ***
Total pot $300 | Rake $0
Seat 1: DeepStack (big blind) folded before the Flop
Seat 2: Terrence_@tchanpoker (button) (small blind) collected ($300)

PokerStars Hand #4000000016: Tournament #1, Apr5_2017-at-15_55_35 Hold'em No Limit ($75/$150 USD) - 2017/04/05 17:55:50 ET
Table 'ACPC Match' 2-max Seat #1 is the button
Seat 1: DeepStack ($19425 in chips)
Seat 2: Terrence_@tchanpoker ($20575 in chips)
DeepStack: posts small blind $75
Terrence_@tchanpoker: posts big blind $150
*** HOLE CARDS ***
Dealt to DeepStack [9s Ts]
Dealt to Terrence_@tchanpoker [5c Kd]
DeepStack: raises $300 to $450
Terrence_@tchanpoker: calls $300
*** FLOP **** [2s 5s Ad]
Terrence_@tchanpoker: checks
DeepStack: raises $450 to $450
Terrence_@tchanpoker: calls $450
*** TURN **** [8h]
Terrence_@tchanpoker: checks
DeepStack: raises $1800 to $1800
Terrence_@tchanpoker: folds
Uncalled bet ($1800) returned to DeepStack
DeepStack collected $1800 from the pot
*** SUMMARY ***
Total pot $1800 | Rake $0
Board [2s 5s Ad 8h]
Seat 1: DeepStack (button) (small blind) collected ($1800)
Seat 2: Terrence_@tchanpoker (big blind) folded on the Turn

PokerStars Hand #4000000017: Tournament #1, Apr5_2017-at-15_55_35 Hold'em No Limit ($75/$150 USD) - 2017/04/05 17:55:51 ET
Table 'ACPC Match' 2-max Seat #2 is the button
Seat 1: DeepStack ($20325 in chips)
Seat 2: Terrence_@tchanpoker ($19675 in chips)
Terrence_@tchanpoker: posts small blind $75
DeepStack: posts big blind $150
*** HOLE CARDS ***
Dealt to DeepStack [8h 3s]
Dealt to Terrence_@tchanpoker [Ts Ks]
Terrence_@tchanpoker: raises $225 to $375
DeepStack: folds
Uncalled bet ($225) returned to Terrence_@tchanpoker
Terrence_@tchanpoker collected $300 from the pot
*** SUMMARY ***
Total pot $300 | Rake $0
Seat 1: DeepStack (big blind) folded before the Flop
Seat 2: Terrence_@tchanpoker (button) (small blind) collected ($300)

PokerStars Hand #4000000018: Tournament #1, Apr5_2017-at-15_55_35 Hold'em No Limit ($75/$150 USD) - 2017/04/05 17:55:52 ET
Table 'ACPC Match' 2-max Seat #1 is the button
Seat 1: DeepStack ($20175 in chips)
Seat 2: Terrence_@tchanpoker ($19825 in chips)
DeepStack: posts small blind $75
Terrence_@tchanpoker: posts big blind $150
*** HOLE CARDS ***
Dealt to DeepStack [3h 4s]
Dealt to Terrence_@tchanpoker [6s 3c]
DeepStack: raises $150 to $300
Terrence_@tchanpoker: folds
Uncalled bet ($150) returned to DeepStack
DeepStack collected $300 from the pot
*** SUMMARY ***
Total pot $300 | Rake $0
Seat 1: DeepStack (button) (small blind) collected ($300)
Seat 2: Terrence_@tchanpoker (big blind) folded before the Flop

PokerStars Hand #4000000019: Tournament #1, Apr5_2017-at-15_55_35 Hold'em No Limit ($75/$150 USD) - 2017/04/05 17:55:53 ET
Table 'ACPC Match' 2-max Seat #2 is the button
Seat 1: DeepStack ($20325 in chips)
Seat 2: Terrence_@tchanpoker ($19675 in chips)
Terrence_@tchanpoker: posts small blind $75
DeepStack: posts big blind $150
*** HOLE CARDS ***
Dealt to DeepStack [4s 6s]
Dealt to Terrence_@tchanpoker [8d Tc]
Terrence_@tchanpoker: raises $225 to $375
DeepStack: calls $225
*** FLOP **** [Ks Ts 8h]
DeepStack: checks
Terrence_@tchanpoker: raises $562 to $562
DeepStack: calls $562
*** TURN **** [As]
DeepStack: checks
Terrence_@tchanpoker: checks
*** RIVER **** [3h]
DeepStack: checks
Terrence_@tchanpoker: raises $1150 to $1150
DeepStack: raises $8348 to $9498
Terrence_@tchanpoker: folds
Uncalled bet ($8348) returned to DeepStack
DeepStack collected $4174 from the pot
*** SUMMARY ***
Total pot $4174 | Rake $0
Board [Ks Ts 8h As 3h]
Seat 1: DeepStack (big blind) collected ($4174)
Seat 2: Terrence_@tchanpoker (button) (small blind) folded on the River

PokerStars Hand #4000000020: Tournament #1, Apr5_2017-at-15_55_35 Hold'em No Limit ($75/$150 USD) - 2017/04/05 17:55:54 ET
Table 'ACPC Match' 2-max Seat #1 is the button
Seat 1: DeepStack ($22412 in chips)
Seat 2: Terrence_@tchanpoker ($17588 in chips)
DeepStack: posts small blind $75
Terrence_@tchanpoker: posts big blind $150
*** HOLE CARDS ***
Dealt to DeepStack [Ks Qd]
Dealt to Terrence_@tchanpoker [7h 7s]
DeepStack: raises $150 to $300
Terrence_@tchanpoker: calls $150
*** FLOP **** [As 2h 6c]
Terrence_@tchanpoker: checks
DeepStack: raises $300 to $300
Terrence_@tchanpoker: calls $300
*** TURN **** [Qh]
Terrence_@tchanpoker: checks
DeepStack: raises $1200 to $1200
Terrence_@tchanpoker: folds
Uncalled bet ($1200) returned to DeepStack
DeepStack collected $1200 from the pot
*** SUMMARY ***
Total pot $1200 | Rake $0
Board [As 2h 6c Qh]
Seat 1: DeepStack (button) (small blind) collected ($1200)
Seat 2: Terrence_@tchanpoker (big blind) folded on the Turn

PokerStars Hand #4000000021: Tournament #1, Apr5_2017-at-15_55_35 Hold'em No Limit ($100/$200 USD) - 2017/04/05 17:55:55 ET
Table 'ACPC Match' 2-max Seat #2 is the button
Seat 1: DeepStack ($23012 in chips)
Seat 2: Terrence_@tchanpoker ($16988 in chips)
Terrence_@tchanpoker: posts small blind $100
DeepStack: posts big blind $200
*** HOLE CARDS ***
Dealt to DeepStack [Qh 6s]
Dealt to Terrence_@tchanpoker [Ks 4s]
Terrence_@tchanpoker: raises $300 to $500
DeepStack: calls $300
*** FLOP **** [Jd Td Ad]
DeepStack: checks
Terrence_@tchanpoker: raises $200 to $200
DeepStack: calls $200
*** TURN **** [5h]
DeepStack: checks
Terrence_@tchanpoker: checks
*** RIVER **** [2h]
DeepStack: bets $700
Terrence_@tchanpoker: folds
Uncalled bet ($700) returned to DeepStack
DeepStack collected $1400 from the pot
*** SUMMARY ***
Total pot $1400 | Rake $0
Board [Jd Td Ad 5h 2h]
Seat 1: DeepStack (big blind) collected ($1400)
Seat 2: Terrence_@tchanpoker (button) (small blind) folded on the River

PokerStars Hand #4000000022: Tournament #1, Apr5_2017-at-15_55_35 Hold'em No Limit ($100/$200 USD) - 2017/04/05 17:55:56 ET
Table 'ACPC Match' 2-max Seat #1 is the button
Seat 1: DeepStack ($23712 in chips)
Seat 2: Terrence_@tchanpoker ($16288 in chips)
DeepStack: posts small blind $100
Terrence_@tchanpoker: posts big blind $200
*** HOLE CARDS ***
Dealt to DeepStack [4c 2s]
Dealt to Terrence_@tchanpoker [6h Qd]
DeepStack: folds
Uncalled bet ($100) returned to Terrence_@tchanpoker
Terrence_@tchanpoker collected $200 from the pot
*** SUMMARY ***
Total pot $200 | Rake $0
Seat 1: DeepStack (button) (small blind) folded before the Flop
Seat 2: Terrence_@tchanpoker (big blind) collected ($200)

PokerStars Hand #4000000023: Tournament #1, Apr5_2017-at-15_55_35 Hold'em No Limit ($100/$200 USD) - 2017/04/05 17:55:57 ET
Table 'ACPC Match' 2-max Seat #2 is the button
Seat 1: DeepStack ($23612 in chips)
Seat 2: Terrence_@tchanpoker ($16388 in chips)
Terrence_@tchanpoker: posts small blind $100
DeepStack: posts big blind $200
*** HOLE CARDS ***
Dealt to DeepStack [Ah Js]
Dealt to Terrence_@tchanpoker [8d 2d]
Terrence_@tchanpoker: raises $300 to $500
DeepStack: raises $1000 to $1500
Terrence_@tchanpoker: folds
Uncalled bet ($1000) returned to DeepStack
DeepStack collected $1000 from the pot
*** SUMMARY ***
Total pot $1000 | Rake $0
Seat 1: DeepStack (big blind) collected ($1000)
Seat 2: Terrence_@tchanpoker (button) (small blind) folded before the Flop

PokerStars Hand #4000000024: Tournament #1, Apr5_2017-at-15_55_35 Hold'em No Limit ($100/$200 USD) - 2017/04/05 17:55:58 ET
Table 'ACPC Match' 2-max Seat #1 is the button
Seat 1: DeepStack ($24112 in chips)
Seat 2: Terrence_@tchanpoker ($15888 in chips)
DeepStack: posts small blind $100
Terrence_@tchanpoker: posts big blind $200
*** HOLE CARDS ***
Dealt to DeepStack [Td 2d]
Dealt to Terrence_@tchanpoker [7h 9d]
DeepStack: raises $200 to $400
Terrence_@tchanpoker: calls $200
*** FLOP **** [3d Ts 9h]
Terrence_@tchanpoker: checks
DeepStack: checks
*** TURN **** [Qh]
Terrence_@tchanpoker: checks
DeepStack: raises $400 to $400
Terrence_@tchanpoker: calls $400
*** RIVER **** [6c]
Terrence_@tchanpoker: checks
DeepStack: checks
*** SHOW DOWN ***
Terrence_@tchanpoker: shows [7h 9d] (a pair of Nines)
DeepStack: shows [Td 2d] (a pair of Tens)
DeepStack collected $1600 from pot
*** SUMMARY ***
Total pot $1600 | Rake $0
Board [3d Ts 9h Qh 6c]
Seat 1: DeepStack (button) (small blind) showed [Td 2d] and won ($1600) with a pair of Tens
Seat 2: Terrence_@tchanpoker (big blind) showed [7h 9d] and lost with a pair of Nines

PokerStars Hand #4000000025: Tournament #1, Apr5_2017-at-15_55_35 Hold'em No Limit ($100/$200 USD) - 2017/04/05 17:55:59 ET
Table 'ACPC Match' 2-max Seat #2 is the button
Seat 1: DeepStack ($24912 in chips)
Seat 2: Terrence_@tchanpoker ($15088 in chips)
Terrence_@tchanpoker: posts small blind $100
DeepStack: posts big blind $200
*** HOLE CARDS ***
Dealt to DeepStack [9h 6h]
Dealt to Terrence_@tchanpoker [3s As]
Terrence_@tchanpoker: raises $300 to $500
DeepStack: calls $300
*** FLOP **** [7d 5c Ac]
DeepStack: checks
Terrence_@tchanpoker: raises $600 to $600
DeepStack: calls $600
*** TURN **** [8d]
DeepStack: checks
Terrence_@tchanpoker: checks
*** RIVER **** [3d]
DeepStack: bets $1100
Terrence_@tchanpoker: calls $1100
*** SHOW DOWN ***
DeepStack: shows [9h 6h] (straight, Nine high)
Terrence_@tchanpoker: shows [3s As] (two pair, Aces and Threes)
DeepStack collected $4400 from pot
*** SUMMARY ***
Total pot $4400 | Rake $0
Board [7d 5c Ac 8d 3d]
Seat 1: DeepStack (big blind) showed [9h 6h] and won ($4400) with straight, Nine high
Seat 2: Terrence_@tchanpoker (button) (small blind) showed [3s As] and lost with two pair, Aces and Threes

PokerStars Hand #4000000026: Tournament #1, Apr5_2017-at-15_55_35 Hold'em No Limit ($100/$200 USD) - 2017/04/05 17:56:00 ET
Table 'ACPC Match' 2-max Seat #1 is the button
Seat 1: DeepStack ($27112 in chips)
Seat 2: Terrence_@tchanpoker ($12888 in chips)
DeepStack: posts small blind $100
Terrence_@tchanpoker: posts big blind $200
*** HOLE CARDS ***
Dealt to DeepStack [3s 3d]
Dealt to Terrence_@tchanpoker [8c 4c]
DeepStack: calls $100
Terrence_@tchanpoker: checks
*** FLOP **** [As 7d 5s]
Terrence_@tchanpoker: checks
DeepStack: checks
*** TURN **** [Ts]
Terrence_@tchanpoker: checks
DeepStack: checks
*** RIVER **** [8h]
Terrence_@tchanpoker: checks
DeepStack: checks
*** SHOW DOWN ***
Terrence_@tchanpoker: shows [8c 4c] (a pair of Eights)
DeepStack: shows [3s 3d] (a pair of Threes)
Terrence_@tchanpoker collected $400 from pot
*** SUMMARY ***
Total pot $400 | Rake $0
Board [As 7d 5s Ts 8h]
Seat 1: DeepStack (button) (small blind) showed [3s 3d] and lost with a pair of Threes
Seat 2: Terrence_@tchanpoker (big blind) showed [8c 4c] and won ($400) with a pair of Eights

PokerStars Hand #4000000027: Tournament #1, Apr5_2017-at-15_55_35 Hold'em No Limit ($100/$200 USD) - 2017/04/05 17:56:01 ET
Table 'ACPC Match' 2-max Seat #2 is the button
Seat 1: DeepStack ($26912 in chips)
Seat 2: Terrence_@tchanpoker ($13088 in chips)
Terrence_@tchanpoker: posts small blind $100
DeepStack: posts big blind $200
*** HOLE CARDS ***
Dealt to DeepStack [Td Js]
Dealt to Terrence_@tchanpoker [4s Tc]
Terrence_@tchanpoker: raises $300 to $500
DeepStack: raises $1000 to $1500
Terrence_@tchanpoker: folds
Uncalled bet ($1000) returned to DeepStack
DeepStack collected $1000 from the pot
*** SUMMARY ***
Total pot $1000 | Rake $0
Seat 1: DeepStack (big blind) collected ($1000)
Seat 2: Terrence_@tchanpoker (button) (small blind) folded before the Flop

PokerStars Hand #4000000028: Tournament #1, Apr5_2017-at-15_55_35 Hold'em No Limit ($100/$200 USD) - 2017/04/05 17:56:02 ET
Table 'ACPC Match' 2-max Seat #1 is the button
Seat 1: DeepStack ($27412 in chips)
Seat 2: Terrence_@tchanpoker ($12588 in chips)
DeepStack: posts small blind $100
Terrence_@tchanpoker: posts big blind $200
*** HOLE CARDS ***
Dealt to DeepStack [Tc 6d]
Dealt to Terrence_@tchanpoker [9c 7c]
DeepStack: raises $400 to $600
Terrence_@tchanpoker: calls $400
*** FLOP **** [7s As 7d]
Terrence_@tchanpoker: checks
DeepStack: checks
*** TURN **** [2d]
Terrence_@tchanpoker: checks
DeepStack: checks
*** RIVER **** [Ah]
Terrence_@tchanpoker: bets $800
DeepStack: folds
Uncalled bet ($800) returned to Terrence_@tchanpoker
Terrence_@tchanpoker collected $1200 from the pot
*** SUMMARY ***
Total pot $1200 | Rake $0
Board [7s As 7d 2d Ah]
Seat 1: DeepStack (button) (small blind) folded on the River
Seat 2: Terrence_@tchanpoker (big blind) collected ($1200)

PokerStars Hand #4000000029: Tournament #1, Apr5_2017-at-15_55_35 Hold'em No Limit ($100/$200 USD) - 2017/04/05 17:56:03 ET
Table 'ACPC Match' 2-max Seat #2 is the button
Seat 1: DeepStack ($26812 in chips)
Seat 2: Terrence_@tchanpoker ($13188 in chips)
Terrence_@tchanpoker: posts small blind $100
DeepStack: posts big blind $200
*** HOLE CARDS ***
Dealt to DeepStack [9d 3h]
Dealt to Terrence_@tchanpoker [Qh Th]
Terrence_@tchanpoker: raises $300 to $500
DeepStack: folds
Uncalled bet ($300) returned to Terrence_@tchanpoker
Terrence_@tchanpoker collected $400 from the pot
*** SUMMARY ***
Total pot $400 | Rake $0
Seat 1: DeepStack (big blind) folded before the Flop
Seat 2: Terrence_@tchanpoker (button) (small blind) collected ($400)

PokerStars Hand #4000000030: Tournament #1, Apr5_2017-at-15_55_35 Hold'em No Limit ($100/$200 USD) - 2017/04/05 17:56:04 ET
Table 'ACPC Match' 2-max Seat #1 is the button
Seat 1: DeepStack ($26612 in chips)
Seat 2: Terrence_@tchanpoker ($13388 in chips)
DeepStack: posts small blind $100
Terrence_@tchanpoker: posts big blind $200
*** HOLE CARDS ***
Dealt to DeepStack [7d 5s]
Dealt to Terrence_@tchanpoker [Th Jh]
DeepStack: raises $400 to $600
Terrence_@tchanpoker: calls $400
*** FLOP **** [Jd Qc Tc]
Terrence_@tchanpoker: checks
DeepStack: checks
*** TURN **** [Ah]
Terrence_@tchanpoker: checks
DeepStack: checks
*** RIVER **** [4d]
Terrence_@tchanpoker: bets $600
DeepStack: folds
Uncalled bet ($600) returned to Terrence_@tchanpoker
Terrence_@tchanpoker collected $1200 from the pot
*** SUMMARY ***
Total pot $1200 | Rake $0
Board [Jd Qc Tc Ah 4d]
Seat 1: DeepStack (button) (small blind) folded on the River
Seat 2: Terrence_@tchanpoker (big blind) collected ($1200)

PokerStars Hand #4000000031: Tournament #1, Apr5_2017-at-15_55_35 Hold'em No Limit ($150/$300 USD) - 2017/04/05 17:56:05 ET
Table 'ACPC Match' 2-max Seat #2 is the button
Seat 1: DeepStack ($26012 in chips)
Seat 2: Terrence_@tchanpoker ($13988 in chips)
Terrence_@tchanpoker: posts small blind $150
DeepStack: posts big blind $300
*** HOLE CARDS ***
Dealt to DeepStack [Kh 5d]
Dealt to Terrence_@tchanpoker [3h Kc]
Terrence_@tchanpoker: raises $477 to $777
DeepStack: calls $477
*** FLOP **** [2h 4d Ks]
DeepStack: checks
Terrence_@tchanpoker: raises $521 to $521
DeepStack: raises $1297 to $1818
Terrence_@tchanpoker: calls $1297
*** TURN **** [Qh]
DeepStack: checks
Terrence_@tchanpoker: checks
*** RIVER **** [4c]
DeepStack: bets $2595
Terrence_@tchanpoker: calls $2595
*** SHOW DOWN ***
DeepStack: shows [Kh 5d] (two pair, Kings and Fours)
Terrence_@tchanpoker: shows [3h Kc] (two pair, Kings and Fours)
DeepStack collected $5190 from pot
Terrence_@tchanpoker collected $5190 from pot
*** SUMMARY ***
Total pot $10380 | Rake $0
Board [2h 4d Ks Qh 4c]
Seat 1: DeepStack (big blind) showed [Kh 5d] and won ($5190) with two pair, Kings and Fours
Seat 2: Terrence_@tchanpoker (button) (small blind) showed [3h Kc] and won ($5190) with two pair, Kings and Fours

PokerStars Hand #4000000032: Tournament #1, Apr5_2017-at-15_55_35 Hold'em No Limit ($150/$300 USD) - 2017/04/05 17:56:06 ET
Table 'ACPC Match' 2-max Seat #1 is the button
Seat 1: DeepStack ($26012 in chips)
Seat 2: Terrence_@tchanpoker ($13988 in chips)
DeepStack: posts small blind $150
Terrence_@tchanpoker: posts big blind $300
*** HOLE CARDS ***
Dealt to DeepStack [7d 8d]
Dealt to Terrence_@tchanpoker [Td Ac]
DeepStack: calls $150
Terrence_@tchanpoker: raises $600 to $900
DeepStack: calls $600
*** FLOP **** [9s Qd 7c]
Terrence_@tchanpoker: bets $800
DeepStack: calls $800
*** TURN **** [Kc]
Terrence_@tchanpoker: checks
DeepStack: checks
*** RIVER **** [9h]
Terrence_@tchanpoker: checks
DeepStack: checks
*** SHOW DOWN ***
Terrence_@tchanpoker: shows [Td Ac] (a pair of Nines)
DeepStack: shows [7d 8d] (two pair, Nines and Sevens)
DeepStack collected $3400 from pot
*** SUMMARY ***
Total pot $3400 | Rake $0
Board [9s Qd 7c Kc 9h]
Seat 1: DeepStack (button) (small blind) showed [7d 8d] and won ($3400) with two pair, Nines and Sevens
Seat 2: Terrence_@tchanpoker (big blind) showed [Td Ac] and lost with a pair of Nines

PokerStars Hand #4000000033: Tournament #1, Apr5_2017-at-15_55_35 Hold'em No Limit ($150/$300 USD) - 2017/04/05 17:56:07 ET
Table 'ACPC Match' 2-max Seat #2 is the button
Seat 1: DeepStack ($27712 in chips)
Seat 2: Terrence_@tchanpoker ($12288 in chips)
Terrence_@tchanpoker: posts small blind $150
DeepStack: posts big blind $300
*** HOLE CARDS ***
Dealt to DeepStack [8h Ts]
Dealt to Terrence_@tchanpoker [3h 8s]
Terrence_@tchanpoker: folds
Uncalled bet ($150) returned to DeepStack
DeepStack collected $300 from the pot
*** SUMMARY ***
Total pot $300 | Rake $0
Seat 1: DeepStack (big blind) collected ($300)
Seat 2: Terrence_@tchanpoker (button) (small blind) folded before the Flop

PokerStars Hand #4000000034: Tournament #1, Apr5_2017-at-15_55_35 Hold'em No Limit ($150/$300 USD) - 2017/04/05 17:56:08 ET
Table 'ACPC Match' 2-max Seat #1 is the button
Seat 1: DeepStack ($27862 in chips)
Seat 2: Terrence_@tchanpoker ($12138 in chips)
DeepStack: posts small blind $150
Terrence_@tchanpoker: posts big blind $300
*** HOLE CARDS ***
Dealt to DeepStack [Js 3d]
Dealt to Terrence_@tchanpoker [5c Jc]
DeepStack: raises $300 to $600
Terrence_@tchanpoker: calls $300
*** FLOP **** [6h 2c Kh]
Terrence_@tchanpoker: checks
DeepStack: checks
*** TURN **** [6c]
Terrence_@tchanpoker: bets $467
DeepStack: folds
Uncalled bet ($467) returned to Terrence_@tchanpoker
Terrence_@tchanpoker collected $1200 from the pot
*** SUMMARY ***
Total pot $1200 | Rake $0
Board [6h 2c Kh 6c]
Seat 1: DeepStack (button) (small blind) folded on the Turn
Seat 2: Terrence_@tchanpoker (big blind) collected ($1200)

PokerStars Hand #4000000035: Tournament #1, Apr5_2017-at-15_55_35 Hold'em No Limit ($150/$300 USD) - 2017/04/05 17:56:09 ET
Table 'ACPC Match' 2-max Seat #2 is the button
Seat 1: DeepStack ($27262 in chips)
Seat 2: Terrence_@tchanpoker ($12738 in chips)
Terrence_@tchanpoker: posts small blind $150
DeepStack: posts big blind $300
*** HOLE CARDS ***
Dealt to DeepStack [2d 8s]
Dealt to Terrence_@tchanpoker [2c Th]
Terrence_@tchanpoker: folds
Uncalled bet ($150) returned to DeepStack
DeepStack collected $300 from the pot
*** SUMMARY ***
Total pot $300 | Rake $0
Seat 1: DeepStack (big blind) collected ($300)
Seat 2: Terrence_@tchanpoker (button) (small blind) folded before the Flop

PokerStars Hand #4000000036: Tournament #1, Apr5_2017-at-15_55_35 Hold'em No Limit ($150/$300 USD) - 2017/04/05 17:56:10 ET
Table 'ACPC Match' 2-max Seat #1 is the button
Seat 1: DeepStack ($27412 in chips)
Seat 2: Terrence_@tchanpoker ($12588 in chips)
DeepStack: posts small blind $150
Terrence_@tchanpoker: posts big blind $300
*** HOLE CARDS ***
Dealt to DeepStack [4d Qd]
Dealt to Terrence_@tchanpoker [Ts 8s]
DeepStack: calls $150
Terrence_@tchanpoker: raises $600 to $900
DeepStack: calls $600
*** FLOP **** [As Kd Td]
Terrence_@tchanpoker: bets $800
DeepStack: calls $800
*** TURN **** [4s]
Terrence_@tchanpoker: checks
DeepStack: checks
*** RIVER **** [7h]
Terrence_@tchanpoker: checks
DeepStack: checks
*** SHOW DOWN ***
Terrence_@tchanpoker: shows [Ts 8s] (a pair of Tens)
DeepStack: shows [4d Qd] (a pair of Fours)
Terrence_@tchanpoker collected $3400 from pot
*** SUMMARY ***
Total pot $3400 | Rake $0
Board [As Kd Td 4s 7h]
Seat 1: DeepStack (button) (small blind) showed [4d Qd] and lost with a pair of Fours
Seat 2: Terrence_@tchanpoker (big blind) showed [Ts 8s] and won ($3400) with a pair of Tens

PokerStars Hand #4000000037: Tournament #1, Apr5_2017-at-15_55_35 Hold'em No Limit ($150/$300 USD) - 2017/04/05 17:56:11 ET
Table 'ACPC Match' 2-max Seat #2 is the button
Seat 1: DeepStack ($25712 in chips)
Seat 2: Terrence_@tchanpoker ($14288 in chips)
Terrence_@tchanpoker: posts small blind $150
DeepStack: posts big blind $300
*** HOLE CARDS ***
Dealt to DeepStack [2s 7c]
Dealt to Terrence_@tchanpoker [Jc Ks]
Terrence_@tchanpoker: raises $454 to $754
DeepStack: folds
Uncalled bet ($454) returned to Terrence_@tchanpoker
Terrence_@tchanpoker collected $600 from the pot
*** SUMMARY ***
Total pot $600 | Rake $0
Seat 1: DeepStack (big blind) folded before the Flop
Seat 2: Terrence_@tchanpoker (button) (small blind) collected ($600)

PokerStars Hand #4000000038: Tournament #1, Apr5_2017-at-15_55_35 Hold'em No Limit ($150/$300 USD) - 2017/04/05 17:56:12 ET
Table 'ACPC Match' 2-max Seat #1 is the button
Seat 1: DeepStack ($25412 in chips)
Seat 2: Terrence_@tchanpoker ($14588 in chips)
DeepStack: posts small blind $150
Terrence_@tchanpoker: posts big blind $300
*** HOLE CARDS ***
Dealt to DeepStack [3h Ks]
Dealt to Terrence_@tchanpoker [Jc 8s]
DeepStack: calls $150
Terrence_@tchanpoker: raises $600 to $900
DeepStack: calls $600
*** FLOP **** [Ah Qs Jd]
Terrence_@tchanpoker: bets $820
DeepStack: calls $820
*** TURN **** [3s]
Terrence_@tchanpoker: checks
DeepStack: checks
*** RIVER **** [5s]
Terrence_@tchanpoker: checks
DeepStack: checks
*** SHOW DOWN ***
Terrence_@tchanpoker: shows [Jc 8s] (a pair of Jacks)
DeepStack: shows [3h Ks] (a pair of Threes)
Terrence_@tchanpoker collected $3440 from pot
*** SUMMARY ***
Total pot $3440 | Rake $0
Board [Ah Qs Jd 3s 5s]
Seat 1: DeepStack (button) (small blind) showed [3h Ks] and lost with a pair of Threes
Seat 2: Terrence_@tchanpoker (big blind) showed [Jc 8s] and won ($3440) with a pair of Jacks

PokerStars Hand #4000000039: Tournament #1, Apr5_2017-at-15_55_35 Hold'em No Limit ($150/$300 USD) - 2017/04/05 17:56:13 ET
Table 'ACPC Match' 2-max Seat #2 is the button
Seat 1: DeepStack ($23692 in chips)
Seat 2: Terrence_@tchanpoker ($16308 in chips)
Terrence_@tchanpoker: posts small blind $150
DeepStack: posts big blind $300
*** HOLE CARDS ***
Dealt to DeepStack [7c 5d]
Dealt to Terrence_@tchanpoker [3c 9h]
Terrence_@tchanpoker: folds
Uncalled bet ($150) returned to DeepStack
DeepStack collected $300 from the pot
*** SUMMARY ***
Total pot $300 | Rake $0
Seat 1: DeepStack (big blind) collected ($300)
Seat 2: Terrence_@tchanpoker (button) (small blind) folded before the Flop

PokerStars Hand #4000000040: Tournament #1, Apr5_2017-at-15_55_35 Hold'em No Limit ($150/$300 USD) - 2017/04/05 17:56:14 ET
Table 'ACPC Match' 2-max Seat #1 is the button
Seat 1: DeepStack ($23842 in chips)
Seat 2: Terrence_@tchanpoker ($16158 in chips)
DeepStack: posts small blind $150
Terrence_@tchanpoker: posts big blind $300
*** HOLE CARDS ***
Dealt to DeepStack [Jc 3d]
Dealt to Terrence_@tchanpoker [As Qs]
DeepStack: raises $300 to $600
Terrence_@tchanpoker: raises $1200 to $1800
DeepStack: folds
Uncalled bet ($1200) returned to Terrence_@tchanpoker
Terrence_@tchanpoker collected $1200 from the pot
*** SUMMARY ***
Total pot $1200 | Rake $0
Seat 1: DeepStack (button) (small blind) folded before the Flop
Seat 2: Terrence_@tchanpoker (big blind) collected ($1200)

PokerStars Hand #4000000041: Tournament #1, Apr5_2017-at-15_55_35 Hold'em No Limit ($200/$400 USD) - 2017/04/05 17:56:15 ET
Table 'ACPC Match' 2-max Seat #2 is the button
Seat 1: DeepStack ($23242 in chips)
Seat 2: Terrence_@tchanpoker ($16758 in chips)
Terrence_@tchanpoker: posts small blind $200
DeepStack: posts big blind $400
*** HOLE CARDS ***
Dealt to DeepStack [Kd Tc]
Dealt to Terrence_@tchanpoker [5c 7d]
Terrence_@tchanpoker: raises $499 to $899
DeepStack: calls $499
*** FLOP **** [Qc 5s 3h]
DeepStack: checks
Terrence_@tchanpoker: raises $500 to $500
DeepStack: calls $500
*** TURN **** [7c]
DeepStack: checks
Terrence_@tchanpoker: raises $1400 to $1400
DeepStack: folds
Uncalled bet ($1400) returned to Terrence_@tchanpoker
Terrence_@tchanpoker collected $2798 from the pot
*** SUMMARY ***
Total pot $2798 | Rake $0
Board [Qc 5s 3h 7c]
Seat 1: DeepStack (big blind) folded on the Turn
Seat 2: Terrence_@tchanpoker (button) (small blind) collected ($2798)

PokerStars Hand #4000000042: Tournament #1, Apr5_2017-at-15_55_35 Hold'em No Limit ($200/$400 USD) - 2017/04/05 17:56:16 ET
Table 'ACPC Match' 2-max Seat #1 is the button
Seat 1: DeepStack ($21843 in chips)
Seat 2: Terrence_@tchanpoker ($18157 in chips)
DeepStack: posts small blind $200
Terrence_@tchanpoker: posts big blind $400
*** HOLE CARDS ***
Dealt to DeepStack [7d 8h]
Dealt to Terrence_@tchanpoker [4h Kh]
DeepStack: calls $200
Terrence_@tchanpoker: raises $800 to $1200
DeepStack: calls $800
*** FLOP **** [Jc 5d 6d]
Terrence_@tchanpoker: checks
DeepStack: raises $1200 to $1200
Terrence_@tchanpoker: folds
Uncalled bet ($1200) returned to DeepStack
DeepStack collected $2400 from the pot
*** SUMMARY ***
Total pot $2400 | Rake $0
Board [Jc 5d 6d]
Seat 1: DeepStack (button) (small blind) collected ($2400)
Seat 2: Terrence_@tchanpoker (big blind) folded on the Flop

PokerStars Hand #4000000043: Tournament #1, Apr5_2017-at-15_55_35 Hold'em No Limit ($200/$400 USD) - 2017/04/05 17:56:17 ET
Table 'ACPC Match' 2-max Seat #2 is the button
Seat 1: DeepStack ($23043 in chips)
Seat 2: Terrence_@tchanpoker ($16957 in chips)
Terrence_@tchanpoker: posts small blind $200
DeepStack: posts big blind $400
*** HOLE CARDS ***
Dealt to DeepStack [Ts 3d]
Dealt to Terrence_@tchanpoker [Tc 2c]
Terrence_@tchanpoker: raises $400 to $800
DeepStack: calls $400
*** FLOP **** [Ah 6s 4h]
DeepStack: checks
Terrence_@tchanpoker: raises $800 to $800
DeepStack: folds
Uncalled bet ($800) returned to Terrence_@tchanpoker
Terrence_@tchanpoker collected $1600 from the pot
*** SUMMARY ***
Total pot $1600 | Rake $0
Board [Ah 6s 4h]
Seat 1: DeepStack (big blind) folded on the Flop
Seat 2: Terrence_@tchanpoker (button) (small blind) collected ($1600)

PokerStars Hand #4000000044: Tournament #1, Apr5_2017-at-15_55_35 Hold'em No Limit ($200/$400 USD) - 2017/04/05 17:56:18 ET
Table 'ACPC Match' 2-max Seat #1 is the button
Seat 1: DeepStack ($22243 in chips)
Seat 2: Terrence_@tchanpoker ($17757 in chips)
DeepStack: posts small blind $200
Terrence_@tchanpoker: posts big blind $400
*** HOLE CARDS ***
Dealt to DeepStack [3c Ts]
Dealt to Terrence_@tchanpoker [Qc Qd]
DeepStack: calls $200
Terrence_@tchanpoker: raises $800 to $1200
DeepStack: folds
Uncalled bet ($800) returned to Terrence_@tchanpoker
Terrence_@tchanpoker collected $800 from the pot
*** SUMMARY ***
Total pot $800 | Rake $0
Seat 1: DeepStack (button) (small blind) folded before the Flop
Seat 2: Terrence_@tchanpoker (big blind) collected ($800)

PokerStars Hand #4000000045: Tournament #1, Apr5_2017-at-15_55_35 Hold'em No Limit ($200/$400 USD) - 2017/04/05 17:56:19 ET
Table 'ACPC Match' 2-max Seat #2 is the button
Seat 1: DeepStack ($21843 in chips)
Seat 2: Terrence_@tchanpoker ($18157 in chips)
Terrence_@tchanpoker: posts small blind $200
DeepStack: posts big blind $400
*** HOLE CARDS ***
Dealt to DeepStack [3d Jc]
Dealt to Terrence_@tchanpoker [Ah 8h]
Terrence_@tchanpoker: raises $400 to $800
DeepStack: calls $400
*** FLOP **** [Jd Td Ts]
DeepStack: checks
Terrence_@tchanpoker: checks
*** TURN **** [Qd]
DeepStack: checks
Terrence_@tchanpoker: checks
*** RIVER **** [Th]
DeepStack: bets $800
Terrence_@tchanpoker: folds
Uncalled bet ($800) returned to DeepStack
DeepStack collected $1600 from the pot
*** SUMMARY ***
Total pot $1600 | Rake $0
Board [Jd Td Ts Qd Th]
Seat 1: DeepStack (big blind) collected ($1600)
Seat 2: Terrence_@tchanpoker (button) (small blind) folded on the River

PokerStars Hand #4000000046: Tournament #1, Apr5_2017-at-15_55_35 Hold'em No Limit ($200/$400 USD) - 2017/04/05 17:56:20 ET
Table 'ACPC Match' 2-max Seat #1 is the button
Seat 1: DeepStack ($22643 in chips)
Seat 2: Terrence_@tchanpoker ($17357 in chips)
DeepStack: posts small blind $200
Terrence_@tchanpoker: posts big blind $400
*** HOLE CARDS ***
Dealt to DeepStack [6c Td]
Dealt to Terrence_@tchanpoker [Jd 7s]
DeepStack: raises $400 to $800
Terrence_@tchanpoker: raises $1600 to $2400
DeepStack: folds
Uncalled bet ($1600) returned to Terrence_@tchanpoker
Terrence_@tchanpoker collected $1600 from the pot
*** SUMMARY ***
Total pot $1600 | Rake $0
Seat 1: DeepStack (button) (small blind) folded before the Flop
Seat 2: Terrence_@tchanpoker (big blind) collected ($1600)

PokerStars Hand #4000000047: Tournament #1, Apr5_2017-at-15_55_35 Hold'em No Limit ($200/$400 USD) - 2017/04/05 17:56:21 ET
Table 'ACPC Match' 2-max Seat #2 is the button
Seat 1: DeepStack ($21843 in chips)
Seat 2: Terrence_@tchanpoker ($18157 in chips)
Terrence_@tchanpoker: posts small blind $200
DeepStack: posts big blind $400
*** HOLE CARDS ***
Dealt to DeepStack [5h Td]
Dealt to Terrence_@tchanpoker [9c Qs]
Terrence_@tchanpoker: raises $400 to $800
DeepStack: calls $400
*** FLOP **** [5s 5d 4h]
DeepStack: bets $800
Terrence_@tchanpoker: calls $800
*** TURN **** [3d]
DeepStack: bets $1600
Terrence_@tchanpoker: folds
Uncalled bet ($1600) returned to DeepStack
DeepStack collected $3200 from the pot
*** SUMMARY ***
Total pot $3200 | Rake $0
Board [5s 5d 4h 3d]
Seat 1: DeepStack (big blind) collected ($3200)
Seat 2: Terrence_@tchanpoker (button) (small blind) folded on the Turn

PokerStars Hand #4000000048: Tournament #1, Apr5_2017-at-15_55_35 Hold'em No Limit ($200/$400 USD) - 2017/04/05 17:56:22 ET
Table 'ACPC Match' 2-max Seat #1 is the button
Seat 1: DeepStack ($23443 in chips)
Seat 2: Terrence_@tchanpoker ($16557 in chips)
DeepStack: posts small blind $200
Terrence_@tchanpoker: posts big blind $400
*** HOLE CARDS ***
Dealt to DeepStack [Qc 2c]
Dealt to Terrence_@tchanpoker [Kh 6h]
DeepStack: raises $400 to $800
Terrence_@tchanpoker: calls $400
*** FLOP **** [Qd Jc 9d]
Terrence_@tchanpoker: checks
DeepStack: checks
*** TURN **** [8d]
Terrence_@tchanpoker: bets $1200
DeepStack: calls $1200
*** RIVER **** [3c]
Terrence_@tchanpoker: bets $2800
DeepStack: calls $2800
*** SHOW DOWN ***
Terrence_@tchanpoker: shows [Kh 6h] (King high)
DeepStack: shows [Qc 2c] (a pair of Queens)
DeepStack collected $9600 from pot
*** SUMMARY ***
Total pot $9600 | Rake $0
Board [Qd Jc 9d 8d 3c]
Seat 1: DeepStack (button) (small blind) showed [Qc 2c] and won ($9600) with a pair of Queens
Seat 2: Terrence_@tchanpoker (big blind) showed [Kh 6h] and lost with King high

PokerStars Hand #4000000049: Tournament #1, Apr5_2017-at-15_55_35 Hold'em No Limit ($200/$400 USD) - 2017/04/05 17:56:23 ET
Table 'ACPC Match' 2-max Seat #2 is the button
Seat 1: DeepStack ($28243 in chips)
Seat 2: Terrence_@tchanpoker ($11757 in chips)
Terrence_@tchanpoker: posts small blind $200
DeepStack: posts big blind $400
*** HOLE CARDS ***
Dealt to DeepStack [9h Ah]
Dealt to Terrence_@tchanpoker [9d 3c]
Terrence_@tchanpoker: folds
Uncalled bet ($200) returned to DeepStack
DeepStack collected $400 from the pot
*** SUMMARY ***
Total pot $400 | Rake $0
Seat 1: DeepStack (big blind) collected ($400)
Seat 2: Terrence_@tchanpoker (button) (small blind) folded before the Flop

PokerStars Hand #4000000050: Tournament #1, Apr5_2017-at-15_55_35 Hold'em No Limit ($200/$400 USD) - 2017/04/05 17:56:24 ET
Table 'ACPC Match' 2-max Seat #1 is the button
Seat 1: DeepStack ($28443 in chips)
Seat 2: Terrence_@tchanpoker ($11557 in chips)
DeepStack: posts small blind $200
Terrence_@tchanpoker: posts big blind $400
*** HOLE CARDS ***
Dealt to DeepStack [7h 8h]
Dealt to Terrence_@tchanpoker [5h 5c]
DeepStack: calls $200
Terrence_@tchanpoker: raises $800 to $1200
DeepStack: calls $800
*** FLOP **** [9c Qh Jc]
Terrence_@tchanpoker: checks
DeepStack: checks
*** TURN **** [2c]
Terrence_@tchanpoker: checks
DeepStack: raises $1200 to $1200
Terrence_@tchanpoker: calls $1200
*** RIVER **** [6c]
Terrence_@tchanpoker: checks
DeepStack: raises $4800 to $4800
Terrence_@tchanpoker: folds
Uncalled bet ($4800) returned to DeepStack
DeepStack collected $4800 from the pot
*** SUMMARY ***
Total pot $4800 | Rake $0
Board [9c Qh Jc 2c 6c]
Seat 1: DeepStack (button) (small blind) collected ($4800)
Seat 2: Terrence_@tchanpoker (big blind) folded on the River

PokerStars Hand #4000000051: Tournament #1, Apr5_2017-at-15_55_35 Hold'em No Limit ($300/$600 USD) - 2017/04/05 17:56:25 ET
Table 'ACPC Match' 2-max Seat #2 is the button
Seat 1: DeepStack ($30843 in chips)
Seat 2: Terrence_@tchanpoker ($9157 in chips)
Terrence_@tchanpoker: posts small blind $300
DeepStack: posts big blind $600
*** HOLE CARDS ***
Dealt to DeepStack [5c 5s]
Dealt to Terrence_@tchanpoker [Ah 5h]
Terrence_@tchanpoker: raises $8557 to $9157 and is all-in
DeepStack: calls $8557
*** FLOP **** [Tc 3c 8d]
*** TURN **** [Kc]
*** RIVER **** [4d]
*** SHOW DOWN ***
Terrence_@tchanpoker: shows [Ah 5h] (Ace high)
DeepStack: shows [5c 5s] (a pair of Fives)
DeepStack collected $18314 from pot
*** SUMMARY ***
Total pot $18314 | Rake $0
Board [Tc 3c 8d Kc 4d]
Seat 1: DeepStack (big blind) showed [5c 5s] and won ($18314) with a pair of Fives
Seat 2: Terrence_@tchanpoker (button) (small blind) showed [Ah 5h] and lost with Ace high
